name,gender,ratio,females,males,total
Michael,M,100,1963,433277,435240
James,M,100,1391,342651,344042
David,M,100,1139,330092,331231
John,M,100,1095,320621,321716
Robert,M,100,1206,304120,305326
William,M,100,855,253873,254728
Christopher,M,100,878,212847,213725
Joseph,M,100,669,192446,193115
Daniel,M,100,709,184348,185057
Thomas,M,100,529,174112,174641
Mary,F,100,167932,499,168431
Richard,M,100,572,167707,168279
Matthew,M,100,468,166568,167036
Jennifer,F,100,150325,482,150807
Mark,M,100,452,141477,141929
Charles,M,100,632,140054,140686
Anthony,M,100,621,138616,139237
Joshua,M,100,480,135633,136113
Linda,F,100,132736,295,133031
Steven,M,100,457,132195,132652
Andrew,M,100,363,127442,127805
Kevin,M,100,502,124361,124863
Elizabeth,F,100,123412,360,123772
Brian,M,100,468,119256,119724
Timothy,M,100,437,111943,112380
Jason,M,100,502,108834,109336
Jessica,F,100,106044,313,106357
Jacob,M,100,211,105659,105870
Patricia,F,100,104588,307,104895
Susan,F,100,100703,227,100930
Jeffrey,M,100,386,100543,100929
Ryan,M,97,2596,98108,100704
Nicholas,M,100,277,97105,97382
Lisa,F,100,96700,306,97006
Eric,M,100,454,95885,96339
Paul,M,100,341,95899,96240
Kenneth,M,100,372,94889,95261
Sarah,F,100,94168,212,94380
Kimberly,F,100,92119,387,92506
Jonathan,M,100,314,92162,92476
Justin,M,100,389,89866,90255
Karen,F,100,89076,229,89305
Michelle,F,100,87901,343,88244
Amanda,F,100,86377,204,86581
Emily,F,100,85607,160,85767
Ashley,F,98,81686,1537,83223
Melissa,F,100,82734,274,83008
Stephen,M,100,259,80944,81203
Scott,M,100,255,79911,80166
Barbara,F,100,79228,176,79404
Ronald,M,100,283,78349,78632
Benjamin,M,100,223,77562,77785
Stephanie,F,100,77138,262,77400
Gary,M,100,267,76476,76743
Donald,M,100,260,75657,75917
Brandon,M,100,314,73764,74078
Alexander,M,99,452,73610,74062
Sandra,F,100,73239,212,73451
Gregory,M,100,255,72795,73050
Rebecca,F,100,70296,165,70461
Donna,F,100,69390,163,69553
Edward,M,100,289,69053,69342
Laura,F,100,69086,217,69303
Deborah,F,100,68494,151,68645
Samuel,M,100,209,68353,68562
Amy,F,100,68285,171,68456
Angela,F,100,67747,206,67953
Nancy,F,100,66087,204,66291
Cynthia,F,100,66089,198,66287
Patrick,M,100,270,65101,65371
Larry,M,100,318,64521,64839
Samantha,F,100,64544,129,64673
Tyler,M,98,1584,61980,63564
Nicole,F,100,62520,200,62720
George,M,99,329,61404,61733
Aaron,M,99,435,61209,61644
Brenda,F,100,61372,180,61552
Jordan,M,75,15181,45427,60608
Nathan,M,100,150,60302,60452
Kathleen,F,100,59223,119,59342
Sharon,F,100,58920,202,59122
Kelly,F,86,50103,8202,58305
Jose,M,99,406,57788,58194
Zachary,M,100,151,57865,58016
Adam,M,100,183,57742,57925
Pamela,F,100,56986,149,57135
Emma,F,100,57016,58,57074
Ethan,M,100,75,56910,56985
Olivia,F,100,56881,76,56957
Christine,F,100,53650,163,53813
Heather,F,100,53570,144,53714
Dennis,M,100,196,53409,53605
Lauren,F,99,52754,371,53125
Noah,M,99,271,52701,52972
Katherine,F,100,52784,130,52914
Rachel,F,100,52332,128,52460
Julie,F,100,52217,149,52366
Kyle,M,98,977,50661,51638
Carol,F,99,51177,275,51452
Christian,M,96,2184,48161,50345
Victoria,F,100,49663,121,49784
Maria,F,99,49297,339,49636
Christina,F,100,48702,181,48883
Douglas,M,100,145,48720,48865
Hannah,F,100,48526,69,48595
Sophia,F,100,48384,54,48438
Margaret,F,100,47155,113,47268
Anna,F,100,47109,119,47228
Terry,M,81,8949,38192,47141
Isabella,F,100,46476,57,46533
Jeremy,M,99,233,46197,46430
Megan,F,100,45972,99,46071
Peter,M,100,151,45300,45451
Abigail,F,100,45296,68,45364
Madison,F,99,44794,485,45279
Sean,M,99,272,44711,44983
Andrea,F,99,44361,561,44922
Brittany,F,100,44619,119,44738
Logan,M,94,2870,41440,44310
Taylor,F,73,32277,11985,44262
Alexis,F,85,37342,6800,44142
Diane,F,100,43317,105,43422
Dylan,M,96,1560,41839,43399
Jerry,M,98,717,42538,43255
Jack,M,100,82,43117,43199
Debra,F,100,42509,106,42615
Gabriel,M,98,788,41477,42265
Cheryl,F,100,41877,100,41977
Raymond,M,100,196,41682,41878
Catherine,F,100,41505,103,41608
Mason,M,99,323,40604,40927
Keith,M,100,195,39890,40085
Frank,M,100,155,39868,40023
Bryan,M,100,193,39701,39894
Teresa,F,100,39612,102,39714
Kayla,F,100,39514,44,39558
Austin,M,99,460,38872,39332
Cameron,M,91,3467,35636,39103
Amber,F,100,38714,98,38812
Janet,F,100,38641,87,38728
Tiffany,F,100,38477,129,38606
Natalie,F,100,38508,77,38585
Henry,M,100,161,38248,38409
Tammy,F,100,37990,170,38160
Shannon,F,86,32647,5220,37867
Lori,F,100,37744,102,37846
Elijah,M,100,123,37563,37686
Angel,M,72,10393,27076,37469
Alyssa,F,100,37328,51,37379
Sara,F,100,37166,113,37279
Tracy,F,85,31234,5678,36912
Juan,M,99,248,36573,36821
Jesse,M,97,1211,35288,36499
Jamie,F,76,27532,8714,36246
Denise,F,100,35973,117,36090
Danielle,F,99,35874,206,36080
Kathryn,F,100,35435,65,35500
Shawn,M,90,3501,31998,35499
Jacqueline,F,100,34940,106,35046
Carolyn,F,100,34948,79,35027
Caleb,M,100,70,34777,34847
Erin,F,97,33767,1039,34806
Kathy,F,100,34563,83,34646
Travis,M,100,172,34376,34548
Jayden,M,93,2578,31876,34454
Bradley,M,99,180,34161,34341
Ava,F,100,33911,31,33942
Julia,F,100,33690,100,33790
Lucas,M,100,50,33698,33748
Allison,F,99,33465,199,33664
Craig,M,100,109,33519,33628
Luke,M,100,58,33525,33583
Grace,F,100,33309,35,33344
Crystal,F,100,32821,115,32936
Leslie,F,82,26972,5872,32844
Liam,M,100,66,32518,32584
Randy,M,98,504,32038,32542
Isaac,M,100,68,32461,32529
Alan,M,100,113,32373,32486
Evan,M,99,424,31910,32334
Diana,F,100,32178,105,32283
Robin,F,88,27996,3941,31937
Bruce,M,100,93,31742,31835
Hunter,M,96,1300,30466,31766
Roger,M,100,125,31371,31496
Jackson,M,100,69,31295,31364
Courtney,F,92,28425,2368,30793
Dawn,F,100,30546,92,30638
Carlos,M,99,191,30162,30353
Luis,M,99,165,30081,30246
Tina,F,100,29924,92,30016
Aiden,M,99,221,29716,29937
Cody,M,98,507,29143,29650
Theresa,F,100,29489,92,29581
Mia,F,100,29534,34,29568
Adrian,M,94,1626,27935,29561
Vincent,M,100,104,29330,29434
Janice,F,100,29207,83,29290
Brianna,F,100,29141,34,29175
Chloe,F,100,28895,30,28925
Jasmine,F,99,28584,147,28731
Wendy,F,100,28395,116,28511
Derek,M,100,102,28093,28195
Phillip,M,100,138,27894,28032
Todd,M,100,95,27900,27995
Evelyn,F,100,27876,65,27941
Melanie,F,100,27808,79,27887
Morgan,F,85,23773,4094,27867
Charlotte,F,100,27822,44,27866
Danny,M,100,131,27458,27589
Nathaniel,M,100,97,27492,27589
Joel,M,99,212,27243,27455
Victor,M,100,133,27134,27267
Alex,M,97,884,26333,27217
Cindy,F,100,27089,75,27164
Ann,F,100,26745,68,26813
Ian,M,100,66,26711,26777
Carl,M,99,174,26479,26653
Lawrence,M,100,116,26438,26554
Johnny,M,99,245,26257,26502
Judy,F,100,26306,71,26377
Isaiah,M,100,55,26241,26296
Vanessa,F,100,26141,89,26230
April,F,100,26043,78,26121
Leah,F,100,25933,56,25989
Valerie,F,100,25863,86,25949
Shirley,F,99,25642,155,25797
Antonio,M,99,166,25396,25562
Joyce,F,100,25452,92,25544
Russell,M,100,96,25360,25456
Marcus,M,99,138,25261,25399
Gerald,M,99,136,25257,25393
Judith,F,100,25312,48,25360
Alexandra,F,100,25175,95,25270
Julian,M,99,318,24855,25173
Erica,F,100,24899,96,24995
Jeremiah,M,100,66,24771,24837
Dana,F,80,19820,4956,24776
Avery,F,74,18375,6394,24769
Philip,M,100,70,24608,24678
Wayne,M,100,81,24477,24558
Paula,F,100,24339,73,24412
Connor,M,100,116,24248,24364
Monica,F,100,24261,103,24364
Kristen,F,99,23896,224,24120
Riley,F,55,13102,10801,23903
Jesus,M,99,202,23634,23836
Chad,M,100,66,23719,23785
Betty,F,100,23645,68,23713
Walter,M,99,120,23473,23593
Martin,M,100,99,23353,23452
Gloria,F,100,23275,100,23375
Alicia,F,100,23139,55,23194
Willie,M,91,2183,20970,23153
Jeffery,M,99,136,22901,23037
Tony,M,99,232,22638,22870
Carter,M,97,661,22184,22845
Joe,M,98,432,22365,22797
Brooke,F,99,22570,215,22785
Jared,M,100,94,22661,22755
Dustin,M,99,131,22408,22539
Ricky,M,99,185,22333,22518
Martha,F,100,22412,77,22489
Ella,F,100,22435,32,22467
Michele,F,99,22226,233,22459
Gavin,M,100,32,22422,22454
Connie,F,99,22030,285,22315
Sherry,F,100,22086,78,22164
Bonnie,F,99,22025,133,22158
Blake,M,95,1181,20911,22092
Dale,M,92,1665,20387,22052
Owen,M,100,52,21834,21886
Sebastian,M,100,29,21847,21876
Audrey,F,100,21759,107,21866
Beverly,F,100,21754,105,21859
Jimmy,M,99,139,21716,21855
Billy,M,99,250,21588,21838
Landon,M,100,75,21733,21808
Lillian,F,100,21743,28,21771
Corey,M,96,884,20717,21601
Arthur,M,99,111,21476,21587
Debbie,F,100,21470,39,21509
Shane,M,98,325,21077,21402
Kristin,F,99,21187,181,21368
Rhonda,F,100,21283,45,21328
Rodney,M,99,113,21157,21270
Steve,M,100,67,21200,21267
Jane,F,100,21191,48,21239
Kim,F,88,18578,2492,21070
Troy,M,99,274,20690,20964
Katie,F,100,20882,43,20925
Chase,M,98,320,20602,20922
Curtis,M,99,140,20731,20871
Jill,F,100,20749,47,20796
Sheila,F,100,20696,50,20746
Bobby,M,97,533,20210,20743
Wyatt,M,100,36,20666,20702
Holly,F,100,20574,76,20650
Sydney,F,97,19992,540,20532
Hailey,F,100,20461,18,20479
Anne,F,100,20356,58,20414
Virginia,F,100,20312,56,20368
Caroline,F,100,20278,36,20314
Lynn,F,84,16914,3296,20210
Randall,M,99,125,19934,20059
Wesley,M,99,208,19831,20039
Casey,M,59,8122,11759,19881
Allen,M,99,113,19734,19847
Albert,M,100,92,19680,19772
Veronica,F,100,19598,73,19671
Levi,M,99,110,19418,19528
Amelia,F,100,19504,8,19512
Addison,F,94,18329,1148,19477
Miguel,M,99,115,19338,19453
Savannah,F,100,19436,17,19453
Roy,M,99,101,19349,19450
Alice,F,100,19026,26,19052
Stacy,F,89,16942,2081,19023
Lee,M,77,4291,14702,18993
Ruth,F,100,18917,53,18970
Dorothy,F,100,18853,58,18911
Suzanne,F,100,18851,39,18890
Dominic,M,99,113,18758,18871
Sofia,F,100,18742,16,18758
Mike,M,100,56,18700,18756
Louis,M,99,113,18596,18709
Cassandra,F,100,18562,37,18599
Chelsea,F,100,18551,38,18589
Seth,M,100,35,18458,18493
Kaitlyn,F,100,18469,18,18487
Lily,F,100,18405,15,18420
Claire,F,100,18317,29,18346
Jean,F,90,16388,1899,18287
Tara,F,100,18210,67,18277
Renee,F,99,18096,180,18276
Peyton,F,63,11463,6677,18140
Molly,F,100,17990,39,18029
Devin,M,89,2011,15947,17958
Chris,M,87,2354,15582,17936
Laurie,F,99,17825,96,17921
Erik,M,100,79,17796,17875
Rose,F,100,17780,60,17840
Cathy,F,100,17752,42,17794
Peggy,F,100,17624,39,17663
Harold,M,100,81,17570,17651
Joan,F,97,17042,604,17646
Marilyn,F,100,17611,30,17641
Brayden,M,99,118,17519,17637
Destiny,F,100,17500,55,17555
Carrie,F,100,17430,65,17495
Aubrey,F,91,15801,1616,17417
Colton,M,100,22,17360,17382
Trevor,M,100,73,17287,17360
Oliver,M,100,25,17316,17341
Jay,M,99,178,17144,17322
Marie,F,100,17243,74,17317
Eli,M,100,77,17159,17236
Brett,M,98,306,16929,17235
Wanda,F,100,17096,50,17146
Helen,F,100,16997,45,17042
Parker,M,86,2319,14533,16852
Zoe,F,100,16774,71,16845
Glenn,M,99,101,16713,16814
Xavier,M,100,74,16493,16567
Mackenzie,F,96,15725,717,16442
Stacey,F,92,15039,1382,16421
Kelsey,F,97,15905,493,16398
Kaylee,F,100,16361,24,16385
Ellen,F,100,16319,31,16350
Calvin,M,100,81,16151,16232
Ronnie,M,96,582,15584,16166
Haley,F,100,16032,78,16110
Gina,F,100,16038,54,16092
Faith,F,100,15969,49,16018
Sabrina,F,100,15963,40,16003
Jon,M,99,101,15890,15991
Gail,F,98,15688,261,15949
Derrick,M,99,92,15833,15925
Barry,M,100,75,15827,15902
Ralph,M,100,66,15810,15876
Beth,F,100,15839,32,15871
Regina,F,100,15805,58,15863
Madeline,F,100,15788,24,15812
Gabriella,F,100,15799,11,15810
Alejandro,M,99,106,15658,15764
Marc,M,100,67,15650,15717
Gabrielle,F,99,15634,79,15713
Paige,F,99,15590,105,15695
Heidi,F,100,15618,42,15660
Mitchell,M,99,94,15556,15650
Cole,M,100,49,15480,15529
Frederick,M,100,66,15454,15520
Alexa,F,100,15404,30,15434
Micheal,M,99,186,15241,15427
Garrett,M,100,49,15341,15390
Lindsey,F,97,14877,513,15390
Frances,F,99,15178,118,15296
Colleen,F,100,15249,35,15284
Vicki,F,100,15197,27,15224
Mario,M,99,98,15116,15214
Dean,M,99,127,15082,15209
Brent,M,99,82,15119,15201
Brooklyn,F,99,14969,193,15162
Oscar,M,100,67,15088,15155
Theodore,M,100,33,15057,15090
Terri,F,99,14982,99,15081
Autumn,F,100,15015,32,15047
Ricardo,M,100,60,14952,15012
Katelyn,F,100,14989,17,15006
Darlene,F,100,14915,39,14954
Rita,F,100,14899,48,14947
Eddie,M,97,406,14497,14903
Hayden,M,73,3953,10895,14848
Manuel,M,100,67,14730,14797
Kristina,F,100,14733,44,14777
Colin,M,100,60,14702,14762
Lydia,F,100,14729,22,14751
Stanley,M,100,65,14684,14749
Bailey,F,85,12475,2270,14745
Eugene,M,99,84,14633,14717
Carson,M,94,833,13857,14690
Carla,F,100,14645,43,14688
Josiah,M,100,32,14594,14626
Anita,F,100,14545,41,14586
Edwin,M,100,68,14477,14545
Jorge,M,99,76,14398,14474
Elaine,F,100,14419,33,14452
Cory,M,95,656,13766,14422
Annette,F,100,14335,44,14379
Bryce,M,98,310,13945,14255
Erika,F,100,14104,68,14172
Tamara,F,100,14036,42,14078
Eva,F,100,13960,39,13999
Leonard,M,100,58,13876,13934
Joanne,F,100,13878,30,13908
Tristan,M,96,569,13327,13896
Max,M,100,30,13858,13888
Melinda,F,100,13744,30,13774
Kylie,F,100,13689,50,13739
Francisco,M,99,91,13647,13738
Ariana,F,100,13691,23,13714
Jenna,F,100,13683,15,13698
Ruby,F,99,13554,88,13642
Darrell,M,99,95,13446,13541
Caitlin,F,100,13459,25,13484
Arianna,F,100,13460,13,13473
Tommy,M,99,167,13290,13457
Shelby,F,91,12289,1156,13445
Andre,M,99,175,13172,13347
Marvin,M,100,59,13255,13314
Zoey,F,100,13288,25,13313
Layla,F,100,13286,13,13299
Howard,M,100,54,13193,13247
Spencer,M,96,531,12636,13167
Makayla,F,100,13130,19,13149
Grant,M,100,27,13107,13134
Jeff,M,100,29,13095,13124
Harper,F,94,12345,765,13110
Ernest,M,99,79,12997,13076
Micah,M,90,1351,11684,13035
Jake,M,100,17,12960,12977
Deanna,F,100,12912,25,12937
Naomi,F,100,12839,12,12851
Ivan,M,100,59,12751,12810
Lucy,F,100,12783,13,12796
Lindsay,F,97,12365,403,12768
Harry,M,100,58,12709,12767
Carmen,F,94,11922,820,12742
Sylvia,F,100,12634,42,12676
Tonya,F,100,12636,36,12672
Nolan,M,100,38,12627,12665
Lance,M,100,41,12589,12630
Alison,F,100,12438,47,12485
Preston,M,99,72,12373,12445
Francis,M,91,1118,11235,12353
Jocelyn,F,100,12325,23,12348
Phyllis,F,100,12250,21,12271
Jackie,F,58,7137,5113,12250
Vivian,F,99,12181,62,12243
Tanya,F,100,12147,38,12185
Maxwell,M,100,53,12085,12138
Maya,F,100,12109,15,12124
Melvin,M,99,120,11960,12080
Maureen,F,100,12016,23,12039
Jaxon,M,100,44,11987,12031
Cooper,M,98,247,11757,12004
Sally,F,100,11915,39,11954
Dakota,M,68,3780,8157,11937
Miranda,F,100,11884,19,11903
Marissa,F,100,11788,29,11817
Darren,M,99,66,11714,11780
Diego,M,100,6,11750,11756
Grayson,M,96,475,11220,11695
Jaime,M,63,4342,7325,11667
Eduardo,M,99,62,11602,11664
Jessie,M,54,5352,6250,11602
Skylar,F,81,9379,2129,11508
Nora,F,100,11474,29,11503
Clayton,M,100,38,11413,11451
Yvonne,F,100,11408,41,11449
Madelyn,F,100,11440,0,11440
Ana,F,99,11322,73,11395
Ariel,F,83,9465,1876,11341
Trinity,F,98,11033,281,11314
Ayden,M,97,283,10982,11265
Melody,F,100,11242,16,11258
Kendall,F,67,7484,3742,11226
Mariah,F,100,11141,28,11169
Roberto,M,99,79,11075,11154
Javier,M,100,49,11100,11149
Payton,F,72,8065,3075,11140
Aaliyah,F,100,11052,11,11063
Charlie,M,77,2589,8449,11038
Tracey,F,93,10211,772,10983
Katrina,F,100,10951,18,10969
Isabel,F,99,10863,101,10964
Eileen,F,100,10916,18,10934
Leo,M,100,36,10896,10932
Adriana,F,100,10880,48,10928
Damian,M,100,39,10814,10853
Omar,M,100,45,10780,10825
Joy,F,99,10655,133,10788
Jo,F,99,10631,148,10779
Jaden,M,89,1221,9524,10745
Jerome,M,99,66,10674,10740
Ruben,M,99,77,10646,10723
Alexandria,F,100,10697,22,10719
Nevaeh,F,100,10689,22,10711
Hector,M,100,44,10663,10707
Christy,F,99,10576,108,10684
Fernando,M,100,51,10627,10678
Bethany,F,100,10644,23,10667
Kara,F,100,10633,26,10659
Kendra,F,100,10619,25,10644
Johnathan,M,100,18,10623,10641
Sophie,F,100,10623,6,10629
Brittney,F,100,10574,23,10597
Charlene,F,100,10537,25,10562
Yolanda,F,99,10483,71,10554
Brandy,F,98,10322,231,10553
Claudia,F,99,10420,63,10483
Fred,M,100,42,10439,10481
Brody,M,100,34,10437,10471
Stella,F,100,10456,13,10469
Jace,M,99,95,10363,10458
Kennedy,F,93,9720,737,10457
Kerry,M,51,5069,5300,10369
Edgar,M,100,40,10297,10337
Angelina,F,100,10303,5,10308
Jade,F,94,9654,652,10306
Sierra,F,100,10277,19,10296
Aidan,M,98,241,10044,10285
Vickie,F,100,10232,35,10267
Nicolas,M,100,21,10235,10256
Reginald,M,99,53,10200,10253
Tanner,M,98,229,9927,10156
Ashton,M,80,2051,8090,10141
Sadie,F,100,10136,5,10141
Whitney,F,96,9666,441,10107
Meghan,F,100,10042,26,10068
Brendan,M,100,30,10036,10066
Josephine,F,100,10049,7,10056
Annie,F,100,10025,21,10046
Joanna,F,100,10005,29,10034
Miles,M,100,34,9985,10019
Ray,M,99,123,9893,10016
Briana,F,100,9962,26,9988
Camila,F,100,9980,7,9987
Irene,F,100,9882,36,9918
Marsha,F,100,9876,27,9903
Jillian,F,100,9861,32,9893
Marcia,F,100,9866,21,9887
Kaleb,M,100,27,9857,9884
Joann,F,100,9762,41,9803
Natasha,F,100,9763,23,9786
Earl,M,99,59,9715,9774
Devon,M,75,2453,7316,9769
Toni,F,98,9607,152,9759
Brandi,F,100,9728,30,9758
Doris,F,99,9639,59,9698
Norman,M,99,68,9610,9678
Rosa,F,99,9567,61,9628
Bella,F,100,9594,15,9609
Jeanne,F,100,9591,18,9609
Elias,M,100,19,9585,9604
Nina,F,100,9575,22,9597
Darryl,M,99,92,9497,9589
Giovanni,M,99,84,9501,9585
Esther,F,100,9513,21,9534
Daisy,F,100,9500,31,9531
Eleanor,F,100,9523,0,9523
Monique,F,99,9472,51,9523
Tim,M,100,34,9488,9522
Jim,M,100,14,9504,9518
Priscilla,F,100,9437,29,9466
Brady,M,98,175,9290,9465
Alfred,M,99,51,9408,9459
Penny,F,100,9422,31,9453
Clifford,M,99,54,9392,9446
Scarlett,F,100,9426,0,9426
Genesis,F,98,9202,212,9414
Warren,M,100,44,9301,9345
Jeanette,F,100,9313,20,9333
Felicia,F,100,9293,27,9320
Jody,F,61,5626,3673,9299
Maurice,M,99,114,9169,9283
Kayden,M,88,1077,8202,9279
Clara,F,100,9238,18,9256
Andy,M,99,114,9141,9255
Gwendolyn,F,100,9205,20,9225
Collin,M,99,49,9156,9205
Clarence,M,99,64,9107,9171
Norma,F,99,9097,59,9156
Karla,F,100,9094,36,9130
Andres,M,100,35,9077,9112
Bentley,M,95,441,8651,9092
Becky,F,100,9051,12,9063
Lorraine,F,100,9037,16,9053
Angelica,F,100,9005,41,9046
Leon,M,99,58,8988,9046
Shelly,F,98,8887,152,9039
Emmanuel,M,100,36,9002,9038
Kelli,F,100,8993,40,9033
Khloe,F,100,9024,8,9032
Kristine,F,100,9009,17,9026
Drew,M,91,776,8247,9023
Bridget,F,100,9003,6,9009
Brad,M,100,31,8935,8966
Candace,F,100,8940,18,8958
Hope,F,100,8909,17,8926
Summer,F,100,8877,24,8901
Jenny,F,99,8824,52,8876
Gabriela,F,100,8834,28,8862
Don,M,99,58,8789,8847
Dalton,M,100,42,8801,8843
Abraham,M,100,22,8811,8833
Greg,M,100,14,8810,8824
Rosemary,F,100,8806,12,8818
Breanna,F,100,8805,5,8810
Roberta,F,99,8711,59,8770
Isabelle,F,100,8753,0,8753
Krista,F,100,8722,14,8736
Sue,F,100,8662,26,8688
Hudson,M,98,180,8504,8684
Bianca,F,100,8663,19,8682
Gianna,F,100,8682,0,8682
Kurt,M,100,19,8649,8668
Leonardo,M,100,25,8637,8662
Dwayne,M,99,61,8591,8652
Ellie,F,100,8588,37,8625
Tom,M,100,20,8561,8581
Desiree,F,100,8536,28,8564
Pedro,M,100,40,8505,8545
Serenity,F,100,8531,13,8544
Raul,M,99,48,8490,8538
Bryson,M,100,36,8495,8531
Shaun,M,96,344,8171,8515
Rafael,M,100,38,8473,8511
Glenda,F,100,8472,19,8491
Sergio,M,100,38,8444,8482
Alvin,M,99,53,8421,8474
Tyrone,M,99,78,8365,8443
Elena,F,100,8424,5,8429
Jodi,F,99,8326,98,8424
Erick,M,99,51,8338,8389
Cesar,M,100,32,8309,8341
Jordyn,F,91,7581,759,8340
Jonah,M,99,82,8235,8317
Misty,F,100,8286,20,8306
Sandy,F,92,7650,655,8305
Constance,F,100,8278,19,8297
Violet,F,100,8282,14,8296
Loretta,F,100,8266,25,8291
Harrison,M,100,30,8231,8261
Natalia,F,100,8234,5,8239
Duane,M,99,59,8174,8233
Neil,M,100,31,8199,8230
Santiago,M,100,5,8223,8228
Rachael,F,100,8204,19,8223
Quinn,F,53,4341,3876,8217
Kristi,F,100,8169,21,8190
Easton,M,99,114,8074,8188
Karl,M,99,73,8093,8166
Penelope,F,100,8156,0,8156
Bill,M,100,13,8140,8153
Juanita,F,100,8105,39,8144
Glen,M,99,42,8078,8120
Sherri,F,100,8078,24,8102
Rick,M,100,14,8075,8089
Bernard,M,100,34,8028,8062
Cecilia,F,100,8033,12,8045
Dianne,F,100,7946,0,7946
Kristy,F,100,7920,23,7943
Clinton,M,100,30,7901,7931
Skyler,M,59,3285,4642,7927
Annabelle,F,100,7925,0,7925
Jada,F,100,7877,24,7901
Roman,M,100,34,7864,7898
Franklin,M,99,51,7798,7849
Lois,F,99,7787,57,7844
Guadalupe,F,76,5943,1893,7836
London,F,84,6552,1271,7823
Marco,M,100,29,7792,7821
Shelley,F,99,7708,98,7806
Asher,M,98,128,7675,7803
Sawyer,M,82,1401,6396,7797
Candice,F,100,7776,19,7795
Marlene,F,100,7762,26,7788
Belinda,F,100,7759,24,7783
Leroy,M,99,62,7719,7781
Dan,M,100,25,7742,7767
Mckenzie,F,97,7533,230,7763
Rebekah,F,100,7740,17,7757
Meredith,F,98,7585,138,7723
Rylee,F,91,6918,714,7632
Lincoln,M,98,153,7453,7606
Miriam,F,100,7591,0,7591
Gage,M,100,20,7516,7536
Reagan,F,90,6759,767,7526
Gordon,M,100,16,7500,7516
Kate,F,100,7469,8,7477
Ryder,M,98,174,7303,7477
Jacquelyn,F,100,7441,14,7455
Mathew,M,100,22,7428,7450
Mya,F,100,7403,11,7414
Armando,M,100,32,7376,7408
Camille,F,99,7329,43,7372
Valeria,F,100,7359,11,7370
Liliana,F,100,7351,18,7369
Kaden,M,99,80,7274,7354
Gilbert,M,99,39,7314,7353
Jaxson,M,100,7,7303,7310
Kirk,M,100,33,7276,7309
Georgia,F,100,7294,11,7305
Terrence,M,99,56,7219,7275
Sheryl,F,100,7215,15,7230
Aria,F,99,7154,64,7218
Marshall,M,99,90,7120,7210
Camden,M,95,325,6853,7178
Jonathon,M,100,23,7115,7138
Elise,F,100,7117,5,7122
Dallas,M,81,1345,5696,7041
Rene,M,68,2215,4816,7031
Damien,M,100,18,6988,7006
Lonnie,M,94,389,6599,6988
Terrance,M,99,84,6894,6978
Caden,M,99,77,6871,6948
Israel,M,98,164,6783,6947
Lynda,F,100,6925,9,6934
Cheyenne,F,97,6681,236,6917
Nichole,F,100,6851,18,6869
Carly,F,100,6841,7,6848
Byron,M,100,20,6800,6820
Lewis,M,100,22,6781,6803
Braxton,M,99,84,6707,6791
Piper,F,100,6748,32,6780
Gracie,F,100,6773,0,6773
Juliana,F,100,6756,0,6756
Cassidy,F,95,6406,339,6745
Daniela,F,100,6710,18,6728
Maggie,F,100,6724,0,6724
Herbert,M,100,31,6691,6722
Dominique,F,62,4156,2554,6710
Jan,F,73,4920,1789,6709
Alana,F,100,6672,5,6677
Hazel,F,99,6629,47,6676
Cristian,M,98,128,6510,6638
Lilly,F,100,6608,0,6608
Everett,M,99,49,6540,6589
June,F,98,6482,106,6588
Cora,F,100,6579,5,6584
Daryl,M,94,418,6165,6583
Iris,F,100,6526,31,6557
Lorenzo,M,99,36,6520,6556
Trenton,M,100,6,6545,6551
Allan,M,100,19,6530,6549
Vernon,M,99,55,6468,6523
Sonya,F,100,6495,20,6515
Donovan,M,99,33,6474,6507
Louise,F,100,6457,30,6487
Krystal,F,100,6458,10,6468
Ramon,M,99,50,6399,6449
Julio,M,99,43,6404,6447
Kaitlin,F,100,6430,10,6440
Sonia,F,99,6375,37,6412
Tabitha,F,100,6390,19,6409
Karina,F,100,6379,22,6401
Kristopher,M,100,31,6369,6400
Reese,F,70,4472,1877,6349
Angelo,M,99,76,6270,6346
Ross,M,100,30,6316,6346
Joey,M,89,714,5619,6333
Traci,F,100,6292,28,6320
Robyn,F,98,6190,129,6319
Sidney,M,62,2389,3919,6308
Adrienne,F,99,6257,39,6296
Johnnie,M,74,1645,4642,6287
Damon,M,100,26,6249,6275
Kylee,F,99,6218,47,6265
Abby,F,100,6246,16,6262
Conner,M,99,49,6206,6255
Lloyd,M,100,26,6209,6235
Abel,M,100,12,6218,6230
Ezra,M,95,295,5932,6227
Kiara,F,99,6183,42,6225
Mikayla,F,100,6221,0,6221
Caitlyn,F,100,6220,0,6220
Aubree,F,100,6199,0,6199
Enrique,M,99,35,6151,6186
Kent,M,100,12,6169,6181
Yvette,F,100,6165,16,6181
Geraldine,F,100,6165,9,6174
Alberto,M,99,41,6110,6151
Wade,M,100,12,6118,6130
Weston,M,100,7,6094,6101
Gene,M,97,161,5930,6091
Perry,M,96,273,5810,6083
Dwight,M,100,23,6056,6079
Arlene,F,100,6057,13,6070
Alisha,F,100,6043,10,6053
Dillon,M,99,72,5972,6044
Allyson,F,100,6034,5,6039
Darius,M,99,32,6004,6036
Simon,M,100,6,6022,6028
Mateo,M,100,5,6020,6025
Josue,M,100,21,5979,6000
Felix,M,100,18,5971,5989
Sheri,F,100,5961,18,5979
Kaiden,M,97,191,5784,5975
Roxanne,F,100,5954,5,5959
Paisley,F,100,5951,6,5957
Janelle,F,100,5930,7,5937
Kari,F,99,5836,68,5904
Chance,M,98,129,5757,5886
Jude,M,95,277,5589,5866
Edith,F,100,5833,26,5859
Marjorie,F,100,5851,5,5856
Aurora,F,100,5855,0,5855
Rickey,M,99,60,5795,5855
Kai,M,86,802,5044,5846
Tucker,M,99,50,5794,5844
Noel,M,77,1370,4471,5841
Kellie,F,100,5814,25,5839
Angie,F,100,5817,19,5836
Gerardo,M,100,28,5784,5812
Bobbie,F,88,5124,670,5794
Alejandra,F,99,5723,59,5782
Malachi,M,100,25,5757,5782
Stuart,M,100,24,5751,5775
Donnie,M,96,242,5515,5757
Trent,M,100,6,5749,5755
Jimmie,M,90,557,5192,5749
Axel,M,100,16,5695,5711
Giselle,F,100,5702,5,5707
Kirsten,F,99,5667,34,5701
Tessa,F,100,5678,0,5678
Nelson,M,100,28,5641,5669
Celeste,F,100,5638,0,5638
Callie,F,100,5617,15,5632
Marion,F,59,3316,2315,5631
Eden,F,86,4829,800,5629
Ivy,F,97,5469,156,5625
Adrianna,F,100,5624,0,5624
Raquel,F,99,5581,30,5611
Makenzie,F,99,5568,28,5596
Zane,M,99,40,5538,5578
Kay,F,98,5475,85,5560
Julianna,F,100,5546,0,5546
Geoffrey,M,100,13,5502,5515
Aimee,F,100,5475,6,5481
Valentina,F,100,5469,0,5469
Guy,M,100,18,5450,5468
Dominick,M,100,17,5445,5462
Kenny,M,99,33,5427,5460
Arturo,M,100,16,5426,5442
Lynne,F,100,5405,21,5426
Mallory,F,98,5341,85,5426
Bryant,M,99,30,5395,5425
Marcos,M,100,13,5411,5424
Colby,M,92,459,4955,5414
Billie,F,85,4578,826,5404
Britney,F,100,5390,6,5396
Dianna,F,100,5388,0,5388
Kelvin,M,99,32,5353,5385
Sam,M,98,87,5295,5382
Cristina,F,99,5329,36,5365
Silas,M,100,5,5356,5361
Kelley,F,90,4794,560,5354
Lana,F,100,5345,0,5345
Elliot,M,89,603,4732,5335
Jayla,F,100,5316,0,5316
Elliott,M,90,547,4762,5309
Alfredo,M,99,38,5262,5300
Genevieve,F,100,5293,0,5293
Tyson,M,99,37,5256,5293
Alaina,F,100,5292,0,5292
Aliyah,F,100,5286,6,5292
Ezekiel,M,100,0,5286,5286
Ashlyn,F,100,5285,0,5285
Lacey,F,98,5194,89,5283
Esmeralda,F,100,5241,21,5262
Bennett,M,96,194,5067,5261
Delilah,F,100,5255,0,5255
Vicky,F,99,5218,37,5255
Graham,M,100,20,5228,5248
Eliana,F,100,5219,0,5219
Clyde,M,99,35,5179,5214
Dante,M,99,41,5150,5191
Alexia,F,100,5185,5,5190
Tricia,F,100,5152,12,5164
Alec,M,99,30,5123,5153
Floyd,M,99,40,5110,5150
Cayden,M,96,218,4917,5135
Emerson,F,55,2815,2313,5128
Frankie,M,70,1548,3580,5128
Beau,M,98,96,5024,5120
Cara,F,100,5120,0,5120
Harley,F,51,2583,2518,5101
Mila,F,100,5088,6,5094
Raven,F,93,4725,356,5081
Lila,F,100,5072,0,5072
Lena,F,100,5071,0,5071
Emmett,M,100,12,5052,5064
Alma,F,99,4988,69,5057
Corbin,M,99,65,4987,5052
Nadia,F,100,5023,6,5029
Brock,M,100,10,5014,5024
Declan,M,100,21,5003,5024
Myles,M,100,21,4996,5017
Julius,M,100,10,4998,5008
Jaclyn,F,100,4997,8,5005
Michaela,F,100,5000,0,5000
Ty,M,99,73,4921,4994
Jaylen,M,88,589,4402,4991
Keegan,M,91,426,4562,4988
Hayley,F,100,4981,5,4986
Braden,M,100,22,4959,4981
Dave,M,100,6,4973,4979
Rylan,M,85,734,4237,4971
Griffin,M,99,74,4887,4961
Laila,F,100,4950,0,4950
Jaiden,M,82,866,4082,4948
Jalen,M,95,224,4719,4943
Freddie,M,94,298,4641,4939
Hadley,F,96,4759,177,4936
Malcolm,M,100,10,4924,4934
Roland,M,100,14,4908,4922
Lyla,F,100,4899,0,4899
Lester,M,99,41,4843,4884
Josie,F,99,4840,39,4879
Zion,M,82,864,4014,4878
Ted,M,100,6,4843,4849
Selena,F,100,4837,6,4843
Maddox,M,97,155,4671,4826
Dolores,F,99,4774,50,4824
Dawson,M,98,104,4716,4820
Serena,F,100,4815,5,4820
Lane,M,92,400,4407,4807
Marianne,F,100,4802,0,4802
Brooklynn,F,100,4795,0,4795
Greyson,M,98,101,4691,4792
Shawna,F,100,4773,18,4791
Kasey,F,73,3487,1302,4789
Harvey,M,100,23,4752,4775
Gayle,F,97,4620,154,4774
Brielle,F,100,4771,0,4771
Shelia,F,100,4757,14,4771
Malik,M,99,46,4722,4768
Kameron,M,89,506,4260,4766
Chandler,M,84,771,3993,4764
Fabian,M,99,30,4728,4758
Milton,M,100,17,4736,4753
Eliza,F,100,4724,10,4734
Gretchen,F,100,4721,11,4732
Leigh,F,92,4350,367,4717
Patsy,F,98,4619,90,4709
Emanuel,M,100,11,4694,4705
Mindy,F,100,4666,7,4673
Orlando,M,99,34,4638,4672
Lucia,F,100,4644,9,4653
Fredrick,M,100,23,4619,4642
Jasmin,F,99,4583,55,4638
Carolina,F,100,4622,13,4635
Patty,F,100,4634,0,4634
Teri,F,100,4611,23,4634
Drake,M,100,14,4615,4629
Mckenna,F,100,4612,7,4619
Ali,M,72,1272,3341,4613
Pablo,M,100,12,4597,4609
Leticia,F,99,4562,36,4598
Delores,F,100,4585,11,4596
Kyla,F,100,4584,0,4584
Carole,F,100,4579,0,4579
Antoinette,F,100,4557,0,4557
Delaney,F,97,4435,116,4551
Jazmin,F,99,4524,26,4550
Anastasia,F,100,4531,5,4536
Jameson,M,98,112,4416,4528
Tami,F,100,4494,13,4507
Jana,F,100,4489,10,4499
Salvador,M,99,23,4473,4496
Marisa,F,100,4488,0,4488
Janie,F,100,4454,17,4471
Lucille,F,100,4450,10,4460
Meagan,F,100,4433,6,4439
Roderick,M,100,18,4411,4429
Emery,F,72,3196,1231,4427
Sasha,F,96,4248,178,4426
Alissa,F,100,4412,7,4419
Tammie,F,100,4400,19,4419
Lola,F,100,4418,0,4418
Rochelle,F,99,4392,24,4416
Ginger,F,100,4409,0,4409
Ramona,F,100,4395,11,4406
Johanna,F,100,4383,16,4399
Amaya,F,100,4391,0,4391
Yesenia,F,99,4361,28,4389
Mildred,F,100,4357,19,4376
Lukas,M,100,0,4369,4369
Elisa,F,100,4354,5,4359
Jase,M,100,21,4328,4349
Paris,F,79,3420,925,4345
Jayce,M,96,166,4172,4338
Noelle,F,100,4327,8,4335
Gerard,M,100,0,4334,4334
Brennan,M,94,244,4083,4327
Pauline,F,100,4312,14,4326
Bob,M,100,5,4310,4315
Mercedes,F,99,4283,30,4313
Desmond,M,99,22,4287,4309
Kingston,M,100,21,4287,4308
Stacie,F,100,4291,17,4308
Camryn,F,87,3757,548,4305
Allie,F,98,4209,85,4294
Arnold,M,100,19,4270,4289
Clifton,M,100,18,4268,4286
Ernesto,M,100,14,4272,4286
Jakob,M,100,0,4284,4284
Bernadette,F,100,4276,0,4276
Jazmine,F,100,4266,10,4276
Myra,F,100,4266,0,4266
Fatima,F,100,4259,5,4264
Tasha,F,100,4248,16,4264
Emilio,M,100,5,4254,4259
Rex,M,100,11,4246,4257
Shari,F,100,4250,6,4256
Jasper,M,98,90,4163,4253
Rowan,M,64,1548,2694,4242
Ben,M,100,16,4219,4235
Neal,M,100,5,4219,4224
Trisha,F,100,4212,8,4220
Reid,M,98,77,4141,4218
Toby,M,87,549,3667,4216
Elisabeth,F,100,4213,0,4213
Beatrice,F,100,4201,11,4212
Cedric,M,99,26,4183,4209
Trey,M,100,7,4201,4208
Izabella,F,100,4199,0,4199
Edna,F,100,4189,0,4189
Kimberley,F,100,4172,13,4185
Jermaine,M,98,88,4095,4183
Loren,M,67,1377,2801,4178
Laurel,F,99,4122,49,4171
Maryann,F,100,4162,5,4167
Lynette,F,100,4161,5,4166
Gustavo,M,100,15,4144,4159
Herman,M,99,34,4123,4157
Christie,F,99,4096,52,4148
Paulette,F,100,4145,0,4145
Kristie,F,100,4143,0,4143
Alina,F,100,4134,0,4134
Alondra,F,100,4112,18,4130
Amir,M,99,41,4065,4106
Darla,F,100,4088,11,4099
Leila,F,100,4096,0,4096
Hanna,F,100,4090,5,4095
Madeleine,F,100,4066,5,4071
Quentin,M,100,18,4053,4071
Athena,F,100,4063,0,4063
Mariana,F,100,4052,8,4060
Luca,M,97,134,3920,4054
Vera,F,100,4054,0,4054
Amari,M,56,1788,2254,4042
Rudy,M,98,75,3961,4036
Kyler,M,94,252,3774,4026
Ismael,M,100,5,4014,4019
Marley,F,86,3433,578,4011
Pam,F,100,3999,10,4009
Brantley,M,97,118,3877,3995
Nickolas,M,100,7,3981,3988
Lora,F,100,3964,7,3971
Cassie,F,99,3942,27,3969
Lillie,F,100,3945,15,3960
Nikki,F,98,3877,83,3960
Rory,M,79,818,3142,3960
Kayleigh,F,100,3957,0,3957
Willow,F,99,3928,27,3955
Randolph,M,100,12,3941,3953
Corinne,F,100,3945,0,3945
Lesley,F,92,3625,318,3943
Leilani,F,100,3931,0,3931
Alivia,F,100,3919,0,3919
Ebony,F,99,3870,48,3918
Tracie,F,99,3878,37,3915
Betsy,F,100,3895,0,3895
Stefanie,F,100,3894,0,3894
Kyra,F,100,3884,7,3891
Jayson,M,100,5,3885,3890
Garry,M,100,14,3875,3889
Alisa,F,100,3888,0,3888
Cecil,M,98,80,3808,3888
Saul,M,100,18,3868,3886
Tatiana,F,100,3876,6,3882
Ashlee,F,99,3859,21,3880
Makenna,F,100,3880,0,3880
Marisol,F,99,3836,43,3879
Kerri,F,99,3836,38,3874
Kira,F,100,3871,0,3871
Patrice,F,97,3760,106,3866
Ryker,M,99,53,3811,3864
Gladys,F,100,3855,5,3860
Latoya,F,100,3842,17,3859
Fiona,F,100,3846,0,3846
Macy,F,99,3799,46,3845
Emilia,F,100,3827,0,3827
Marian,F,99,3790,37,3827
Gregg,M,100,13,3808,3821
Patti,F,100,3810,7,3817
Marla,F,100,3807,5,3812
Dexter,M,100,12,3796,3808
Juliet,F,100,3806,0,3806
Demetrius,M,96,140,3665,3805
Maximus,M,100,0,3793,3793
Alayna,F,100,3781,0,3781
Janine,F,100,3777,0,3777
Cheri,F,100,3764,0,3764
Clarissa,F,100,3759,5,3764
Presley,F,88,3286,469,3755
Jennie,F,100,3727,6,3733
Terrell,M,95,169,3564,3733
Ron,M,100,7,3724,3731
Justine,F,94,3501,229,3730
Ryleigh,F,99,3695,34,3729
Marina,F,100,3719,5,3724
Arielle,F,100,3716,6,3722
August,M,86,526,3191,3717
Daphne,F,100,3710,0,3710
Diamond,F,94,3493,213,3706
Janis,F,99,3684,22,3706
Ximena,F,100,3696,6,3702
Cade,M,100,8,3677,3685
Keira,F,100,3684,0,3684
Mayra,F,99,3642,40,3682
Justice,M,51,1806,1874,3680
Chester,M,100,14,3663,3677
Doreen,F,100,3664,8,3672
Rachelle,F,100,3671,0,3671
Tia,F,100,3658,10,3668
Trina,F,100,3658,5,3663
Angelique,F,100,3661,0,3661
Harmony,F,100,3652,0,3652
Katelynn,F,100,3650,0,3650
Christa,F,100,3649,0,3649
Finley,F,63,2294,1353,3647
Marty,M,90,358,3288,3646
Clint,M,100,14,3621,3635
Daniella,F,100,3629,0,3629
Kinsley,F,100,3609,17,3626
Grady,M,99,35,3582,3617
Mandy,F,100,3601,5,3606
Leland,M,99,32,3560,3592
Clay,M,99,25,3562,3587
Clark,M,100,12,3574,3586
Rosalie,F,100,3569,0,3569
Esteban,M,100,0,3566,3566
Teagan,F,81,2886,670,3556
Kendrick,M,99,36,3502,3538
Bret,M,99,25,3511,3536
Aniyah,F,100,3535,0,3535
Nadine,F,100,3524,0,3524
Haylee,F,100,3519,0,3519
Tatum,F,76,2665,837,3502
Chelsey,F,100,3471,9,3480
Reed,M,98,79,3399,3478
Sammy,M,97,99,3377,3476
Jamal,M,99,34,3435,3469
Asia,F,99,3438,24,3462
Dane,M,99,33,3423,3456
Luna,F,100,3445,7,3452
King,M,100,0,3443,3443
Lorena,F,99,3412,29,3441
Ronda,F,100,3433,7,3440
Alonzo,M,99,19,3419,3438
Carlton,M,99,32,3403,3435
Tori,F,97,3318,116,3434
Brooks,M,95,164,3266,3430
Tiana,F,100,3426,0,3426
Dina,F,100,3410,15,3425
Sage,F,64,2197,1214,3411
Jeannette,F,100,3407,0,3407
Adalyn,F,100,3404,0,3404
Savanna,F,100,3404,0,3404
Hugh,M,100,5,3395,3400
Phoebe,F,100,3400,0,3400
Hillary,F,98,3341,58,3399
Jeannie,F,99,3381,17,3398
Dena,F,100,3396,0,3396
Kamryn,F,84,2862,530,3392
Zackary,M,100,0,3388,3388
Sonja,F,100,3387,0,3387
Mona,F,100,3384,0,3384
Lexi,F,100,3380,0,3380
Margie,F,100,3365,5,3370
Emiliano,M,100,0,3367,3367
Lea,F,99,3339,21,3360
Shayla,F,100,3360,0,3360
Xander,M,100,0,3342,3342
Wendell,M,99,28,3302,3330
Lara,F,100,3312,11,3323
Deandre,M,98,50,3261,3311
Joaquin,M,100,0,3309,3309
Londyn,F,98,3243,55,3298
Irma,F,100,3292,5,3297
Ciara,F,100,3294,0,3294
Nick,M,100,5,3282,3287
Norah,F,100,3271,5,3276
Isla,F,100,3275,0,3275
Shauna,F,100,3253,6,3259
Cruz,M,92,247,3009,3256
Alyson,F,100,3255,0,3255
Lamar,M,96,132,3123,3255
Talia,F,100,3245,0,3245
Francine,F,100,3232,6,3238
Rodolfo,M,100,15,3223,3238
Ashlynn,F,100,3232,0,3232
Cecelia,F,100,3230,0,3230
Shanna,F,100,3223,7,3230
Brynn,F,99,3183,44,3227
River,M,68,1026,2201,3227
Charity,F,100,3226,0,3226
Sherrie,F,100,3224,0,3224
Sienna,F,100,3222,0,3222
Adalynn,F,100,3217,0,3217
Kali,F,98,3137,80,3217
Salvatore,M,100,7,3210,3217
Kassandra,F,100,3216,0,3216
Celia,F,100,3209,5,3214
Robbie,M,62,1212,1997,3209
Margarita,F,99,3190,18,3208
Quinton,M,100,0,3207,3207
Landen,M,99,19,3187,3206
Blaine,M,96,123,3077,3200
Carissa,F,100,3186,0,3186
Claude,M,99,34,3150,3184
Heaven,F,99,3138,45,3183
Alfonso,M,100,11,3170,3181
Ken,M,100,10,3169,3179
Bertha,F,100,3162,6,3168
Zayden,M,99,21,3147,3168
Ashleigh,F,100,3167,0,3167
Francesca,F,100,3165,0,3165
Dora,F,100,3143,10,3153
Hugo,M,100,6,3146,3152
Moises,M,100,13,3137,3150
Karter,M,88,378,2771,3149
Bernice,F,99,3096,46,3142
Zachariah,M,100,10,3131,3141
Terence,M,100,6,3130,3136
Latasha,F,100,3124,10,3134
Kinley,F,99,3097,36,3133
Phoenix,M,60,1264,1865,3129
Susie,F,100,3129,0,3129
Juliette,F,100,3120,0,3120
Adeline,F,100,3115,0,3115
Lucinda,F,100,3111,0,3111
Rosemarie,F,100,3101,0,3101
Florence,F,100,3092,7,3099
Darnell,M,93,211,2885,3096
Zachery,M,100,0,3092,3092
Brenna,F,100,3084,0,3084
Guillermo,M,100,5,3072,3077
Elsa,F,100,3075,0,3075
Elaina,F,100,3071,0,3071
Bradford,M,100,0,3065,3065
Benny,M,99,34,3028,3062
Candy,F,100,3049,12,3061
Leanne,F,100,3058,0,3058
Elsie,F,100,3057,0,3057
Keri,F,99,3027,27,3054
Adan,M,100,15,3038,3053
Shana,F,100,3029,12,3041
Judah,M,97,82,2958,3040
Jolene,F,100,3027,0,3027
Ellis,M,84,473,2553,3026
Marlon,M,99,34,2990,3024
Moses,M,100,0,3022,3022
Darin,M,99,44,2968,3012
Randi,F,96,2886,118,3004
Blair,F,54,1633,1370,3003
Faye,F,100,2994,8,3002
Maci,F,100,2998,0,2998
Bonita,F,100,2991,0,2991
Brenden,M,100,0,2984,2984
Ida,F,100,2981,0,2981
Ada,F,100,2973,7,2980
Rosie,F,99,2962,18,2980
Holden,M,99,30,2946,2976
Quincy,M,85,438,2536,2974
Julianne,F,100,2972,0,2972
Anderson,M,97,100,2870,2970
Paxton,M,94,184,2786,2970
Malia,F,100,2964,0,2964
Lyle,M,99,41,2922,2963
Marcella,F,100,2957,5,2962
Timmy,M,99,21,2938,2959
Lauryn,F,100,2955,0,2955
Wilson,M,99,24,2928,2952
Wallace,M,100,12,2927,2939
Felipe,M,100,5,2932,2937
Maxine,F,100,2931,5,2936
Kailey,F,100,2928,0,2928
Jodie,F,92,2688,235,2923
Waylon,M,100,8,2912,2920
Elisha,F,55,1611,1304,2915
Joni,F,98,2854,58,2912
Thelma,F,100,2902,7,2909
Finn,M,99,40,2868,2908
Hilary,F,97,2812,94,2906
Randal,M,100,8,2896,2904
Sterling,M,90,293,2609,2902
Davis,M,97,92,2809,2901
Cali,F,99,2868,32,2900
Jarrod,M,100,5,2892,2897
Imani,F,96,2773,122,2895
Kristian,M,74,758,2131,2889
Katharine,F,100,2882,0,2882
Lyric,F,81,2333,547,2880
Pat,M,57,1242,1634,2876
Simone,F,98,2818,53,2871
Dorian,M,85,436,2432,2868
Heath,M,99,20,2841,2861
Cash,M,100,14,2842,2856
Ira,M,90,284,2570,2854
Arabella,F,100,2842,0,2842
Otis,M,99,30,2812,2842
Cherie,F,100,2830,0,2830
Maddison,F,100,2826,0,2826
Forrest,M,99,38,2786,2824
Rocky,M,99,33,2786,2819
Antoine,M,99,26,2789,2815
Jax,M,99,22,2788,2810
Caiden,M,98,49,2760,2809
Skye,F,88,2485,324,2809
Cierra,F,100,2798,8,2806
Tania,F,100,2780,10,2790
Wilma,F,100,2783,7,2790
Karin,F,100,2778,5,2783
Johnathon,M,100,0,2779,2779
Tristen,M,87,372,2406,2778
Zander,M,100,0,2775,2775
Maribel,F,99,2750,24,2774
Baylee,F,97,2696,73,2769
Darrin,M,100,12,2756,2768
Kenya,F,92,2557,208,2765
Branden,M,99,38,2725,2763
Cathleen,F,100,2763,0,2763
Luz,F,98,2697,61,2758
Julissa,F,100,2755,0,2755
Aileen,F,100,2753,0,2753
Marquis,M,98,56,2696,2752
Jayda,F,100,2733,6,2739
Ethel,F,100,2728,9,2737
Sheldon,M,99,38,2697,2735
Kris,M,53,1284,1449,2733
Solomon,M,100,0,2730,2730
Darcy,F,91,2472,257,2729
Blanca,F,99,2709,18,2727
Leanna,F,100,2724,0,2724
Staci,F,100,2718,5,2723
Evangeline,F,100,2720,0,2720
Maverick,M,99,20,2697,2717
Ericka,F,100,2701,11,2712
Keaton,M,95,146,2566,2712
Danna,F,99,2686,24,2710
Kenzie,F,98,2661,49,2710
Hallie,F,99,2676,26,2702
Cary,M,82,477,2222,2699
Deana,F,100,2699,0,2699
Taryn,F,97,2620,71,2691
Stephan,M,99,16,2673,2689
Morris,M,99,36,2652,2688
Titus,M,100,0,2683,2683
Nia,F,100,2681,0,2681
Rodrigo,M,100,0,2675,2675
Cadence,F,93,2469,199,2668
Debora,F,100,2663,5,2668
Viviana,F,100,2666,0,2666
Alanna,F,100,2662,0,2662
Antonia,F,92,2433,225,2658
Eve,F,100,2649,0,2649
Tomas,M,100,0,2646,2646
Kobe,M,98,51,2587,2638
Gunner,M,100,0,2637,2637
Gilberto,M,100,5,2631,2636
Jenifer,F,100,2631,0,2631
Walker,M,99,36,2594,2630
Mattie,F,100,2614,6,2620
Rogelio,M,100,5,2612,2617
Mollie,F,100,2616,0,2616
Reece,M,80,521,2095,2616
Bridgette,F,100,2604,0,2604
Jarrett,M,100,5,2596,2601
Mickey,M,83,435,2165,2600
Adelyn,F,100,2591,6,2597
Alessandra,F,100,2595,0,2595
Kyleigh,F,100,2589,0,2589
Ingrid,F,100,2583,0,2583
Helena,F,100,2582,0,2582
Emilee,F,100,2581,0,2581
Ayla,F,100,2574,0,2574
Janette,F,100,2565,5,2570
Larissa,F,100,2567,0,2567
Addyson,F,100,2550,10,2560
Therese,F,100,2559,0,2559
Kassidy,F,98,2510,46,2556
Paola,F,99,2538,17,2555
Elmer,M,99,26,2525,2551
Leann,F,100,2547,0,2547
Brianne,F,100,2538,6,2544
Lia,F,100,2544,0,2544
Kiley,F,95,2410,127,2537
Gael,M,99,35,2499,2534
Eloise,F,100,2520,0,2520
Myron,M,99,33,2484,2517
Kody,M,97,83,2433,2516
Armani,M,57,1069,1446,2515
Rolando,M,100,12,2502,2514
Clare,F,98,2458,55,2513
Madalyn,F,100,2510,0,2510
Beckett,M,96,100,2405,2505
Angelia,F,100,2497,5,2502
Tommie,M,74,660,1833,2493
Virgil,M,99,28,2465,2493
Aden,M,97,63,2427,2490
Chasity,F,100,2484,5,2489
Carey,M,55,1124,1362,2486
Lilliana,F,100,2486,0,2486
Jami,F,96,2380,105,2485
Royce,M,93,168,2312,2480
Jeanine,F,100,2474,5,2479
Remington,M,77,582,1897,2479
Dewayne,M,100,5,2471,2476
Raegan,F,99,2447,21,2468
Romeo,M,100,0,2468,2468
Emely,F,100,2462,5,2467
Kaydence,F,96,2375,90,2465
Annabella,F,100,2464,0,2464
Gwen,F,99,2444,18,2462
Earnest,M,98,49,2403,2452
Madilyn,F,100,2448,0,2448
Tate,M,95,131,2315,2446
Geneva,F,100,2445,0,2445
Macie,F,100,2442,0,2442
Leona,F,100,2437,0,2437
Bobbi,F,100,2434,0,2434
Braylon,M,99,17,2416,2433
Cortney,F,86,2079,347,2426
Delia,F,100,2421,5,2426
Doug,M,100,0,2425,2425
Jonas,M,100,0,2424,2424
Kaylie,F,100,2423,0,2423
Olga,F,100,2416,5,2421
Maritza,F,100,2406,10,2416
Colette,F,100,2415,0,2415
Noe,M,98,39,2370,2409
Nikolas,M,100,0,2407,2407
Tonia,F,100,2404,0,2404
Tiara,F,99,2388,15,2403
Bennie,M,91,218,2179,2397
Mauricio,M,100,0,2396,2396
Will,M,100,6,2390,2396
Alton,M,100,9,2386,2395
Aisha,F,100,2386,7,2393
Ramiro,M,100,0,2392,2392
Lizbeth,F,100,2386,0,2386
Rylie,F,94,2237,148,2385
Kiana,F,100,2380,0,2380
Freddy,M,100,10,2368,2378
Kaylin,F,97,2312,64,2376
Conor,M,100,5,2369,2374
Anya,F,100,2366,0,2366
Lionel,M,100,0,2366,2366
Pearl,F,99,2335,31,2366
Mara,F,100,2365,0,2365
Karissa,F,100,2363,0,2363
Kiera,F,100,2344,6,2350
Leonel,M,100,0,2346,2346
Issac,M,100,5,2335,2340
Greta,F,100,2338,0,2338
Audra,F,100,2337,0,2337
Rocco,M,100,0,2333,2333
Dixie,F,100,2315,10,2325
Jamison,M,92,190,2128,2318
Nathanael,M,100,0,2317,2317
Van,M,94,146,2170,2316
Nehemiah,M,96,81,2233,2314
Mikaela,F,100,2310,0,2310
Pete,M,100,0,2310,2310
Conrad,M,100,0,2308,2308
Camilla,F,100,2306,0,2306
Colt,M,100,0,2304,2304
Luther,M,100,7,2294,2301
Stevie,M,54,1062,1238,2300
Haven,F,79,1826,473,2299
Lamont,M,99,15,2276,2291
Noemi,F,99,2277,14,2291
Karson,M,90,225,2060,2285
Keisha,F,100,2278,5,2283
Cornelius,M,99,34,2248,2282
Gia,F,100,2272,0,2272
Ari,M,81,426,1842,2268
Lorie,F,99,2247,18,2265
Barrett,M,96,83,2179,2262
Jaqueline,F,99,2249,13,2262
Jett,M,98,54,2208,2262
Madisyn,F,100,2262,0,2262
Kade,M,99,31,2229,2260
Latonya,F,100,2247,7,2254
Milan,M,56,984,1270,2254
Sherman,M,99,12,2242,2254
Bryanna,F,100,2251,0,2251
Sarai,F,100,2249,0,2249
Marcy,F,99,2223,25,2248
Derick,M,100,0,2245,2245
Milo,M,99,25,2219,2244
Lacy,F,87,1948,293,2241
Stefan,M,100,0,2240,2240
Teddy,M,97,66,2162,2228
Nyla,F,100,2226,0,2226
Jayne,F,100,2217,5,2222
Darian,M,83,381,1840,2221
Rhett,M,100,9,2212,2221
Trudy,F,100,2219,0,2219
Tobias,M,100,0,2217,2217
Journey,F,92,2036,180,2216
Gemma,F,100,2202,0,2202
Christi,F,100,2192,5,2197
Della,F,100,2190,0,2190
Vance,M,100,0,2185,2185
Isiah,M,100,0,2183,2183
Matt,M,100,0,2181,2181
Brendon,M,100,0,2180,2180
Edmund,M,100,0,2176,2176
Vivienne,F,100,2170,0,2170
Ainsley,F,98,2125,41,2166
Stewart,M,99,12,2152,2164
Tabatha,F,100,2164,0,2164
Iker,M,100,0,2159,2159
Regan,F,80,1723,436,2159
Mckinley,F,73,1570,586,2156
Kellen,M,96,96,2059,2155
Mae,F,100,2143,8,2151
Willard,M,100,10,2133,2143
Emilie,F,100,2142,0,2142
Ahmad,M,100,0,2141,2141
Kelsie,F,99,2110,31,2141
Nayeli,F,100,2139,0,2139
Lilah,F,100,2135,0,2135
Cyrus,M,100,5,2126,2131
Darrel,M,99,16,2110,2126
Dion,M,93,151,1975,2126
Winston,M,100,0,2117,2117
India,F,100,2102,7,2109
Catalina,F,100,2107,0,2107
Jaylin,M,51,1033,1073,2106
Arya,F,88,1857,245,2102
Fernanda,F,100,2091,5,2096
Laurence,M,99,17,2075,2092
Mohamed,M,100,0,2092,2092
Jeri,F,98,2052,37,2089
Melina,F,100,2085,0,2085
Marguerite,F,100,2084,0,2084
Jewel,F,92,1907,167,2074
Danica,F,100,2073,0,2073
Susanne,F,100,2072,0,2072
Amie,F,100,2071,0,2071
Rena,F,99,2052,17,2069
Raphael,M,100,10,2057,2067
Madelynn,F,100,2063,0,2063
Adelaide,F,100,2058,0,2058
Jayceon,M,100,6,2046,2052
Shea,F,61,1243,809,2052
Sylvester,M,99,24,2025,2049
Tamika,F,99,2034,15,2049
Miracle,F,98,2002,43,2045
Aspen,F,90,1845,199,2044
Chanel,F,100,2038,5,2043
Unknown,M,51,999,1040,2039
Susana,F,99,2026,11,2037
Itzel,F,100,2028,6,2034
Janae,F,100,2034,0,2034
Keenan,M,98,44,1990,2034
Terrie,F,99,2008,26,2034
Uriel,M,99,24,2010,2034
Hilda,F,100,2024,8,2032
Everly,F,100,2023,5,2028
Yasmin,F,99,2016,11,2027
Brynlee,F,100,2021,5,2026
Maximilian,M,100,0,2026,2026
Perla,F,100,2016,5,2021
Elyse,F,100,2015,5,2020
Jefferson,M,100,0,2019,2019
Monte,M,98,47,1970,2017
Aleah,F,100,2011,0,2011
Colten,M,100,0,2011,2011
Khalil,M,99,17,1991,2008
Rudolph,M,100,0,2000,2000
Amiyah,F,100,1991,0,1991
Annika,F,100,1991,0,1991
Rusty,M,97,57,1932,1989
Katy,F,100,1983,5,1988
Gale,F,72,1424,558,1982
Javon,M,96,79,1903,1982
Orion,M,97,52,1928,1980
Araceli,F,99,1965,14,1979
Margo,F,100,1978,0,1978
Annmarie,F,100,1976,0,1976
Reuben,M,100,6,1967,1973
Thaddeus,M,100,5,1965,1970
Aniya,F,100,1969,0,1969
Anahi,F,100,1961,7,1968
Eunice,F,99,1944,23,1967
Melany,F,100,1964,0,1964
Chuck,M,100,0,1962,1962
Abbey,F,100,1958,0,1958
Precious,F,99,1943,15,1958
Katlyn,F,100,1957,0,1957
Melisa,F,100,1956,0,1956
Kourtney,F,95,1863,92,1955
Dulce,F,100,1954,0,1954
Kaelyn,F,100,1947,6,1953
Rosalind,F,100,1953,0,1953
Kimberlee,F,100,1951,0,1951
Silvia,F,100,1947,0,1947
Aron,M,99,27,1913,1940
Kaleigh,F,100,1939,0,1939
Hattie,F,100,1933,0,1933
Raelynn,F,100,1928,0,1928
Maura,F,100,1927,0,1927
Scarlet,F,100,1925,0,1925
Elliana,F,100,1922,0,1922
Lilian,F,100,1920,0,1920
Nathalie,F,100,1920,0,1920
Kurtis,M,100,0,1919,1919
Olive,F,100,1909,5,1914
Devan,M,69,601,1311,1912
Joselyn,F,100,1910,0,1910
Rashad,M,100,5,1905,1910
Nellie,F,100,1905,0,1905
Gideon,M,100,0,1902,1902
Ladonna,F,100,1902,0,1902
Bailee,F,98,1864,37,1901
Gillian,F,99,1883,18,1901
Abram,M,100,0,1900,1900
Liana,F,100,1898,0,1898
Jeannine,F,100,1891,0,1891
Lorrie,F,100,1886,0,1886
Archie,M,99,25,1860,1885
Cullen,M,99,17,1868,1885
Harriet,F,100,1885,0,1885
Jaelyn,F,92,1729,156,1885
Cohen,M,99,22,1861,1883
Sondra,F,100,1882,0,1882
Tanisha,F,100,1882,0,1882
Porter,M,97,64,1816,1880
Pierce,M,98,33,1846,1879
Destinee,F,100,1878,0,1878
Layne,M,77,440,1438,1878
Darwin,M,99,14,1862,1876
Nicolette,F,100,1876,0,1876
Jayme,F,78,1465,410,1875
Knox,M,99,11,1864,1875
Duncan,M,100,0,1870,1870
Reynaldo,M,100,0,1867,1867
Roosevelt,M,100,6,1860,1866
Vaughn,M,96,83,1783,1866
Efrain,M,100,0,1865,1865
Lexie,F,99,1844,16,1860
Charley,F,60,1110,749,1859
Jerald,M,99,11,1848,1859
Prince,M,99,15,1841,1856
Braydon,M,100,0,1855,1855
Amos,M,100,0,1852,1852
Kailyn,F,98,1820,29,1849
Charlee,F,97,1800,47,1847
Latisha,F,100,1847,0,1847
Kolton,M,100,0,1845,1845
Vicente,M,100,0,1844,1844
Zackery,M,100,0,1843,1843
Jordon,M,88,227,1614,1841
Irvin,M,100,0,1840,1840
Jazlyn,F,100,1840,0,1840
Leighton,F,58,1064,775,1839
Deshawn,M,93,124,1714,1838
Elle,F,100,1838,0,1838
Elissa,F,100,1835,0,1835
Valarie,F,100,1835,0,1835
Giuliana,F,100,1828,0,1828
Asa,M,92,139,1684,1823
Mack,M,100,0,1822,1822
Aubrie,F,100,1821,0,1821
Deon,M,93,122,1699,1821
Kaitlynn,F,100,1821,0,1821
Hollie,F,98,1788,31,1819
Bart,M,100,0,1815,1815
Brayan,M,100,0,1813,1813
Pierre,M,100,7,1803,1810
Chandra,F,100,1808,0,1808
Ahmed,M,100,0,1807,1807
Hailee,F,100,1804,0,1804
Miley,F,100,1803,0,1803
Paulina,F,100,1803,0,1803
Brycen,M,100,6,1793,1799
Muhammad,M,100,0,1798,1798
Messiah,M,93,125,1672,1797
Beatriz,F,100,1789,6,1795
Deirdre,F,100,1795,0,1795
Scotty,M,99,24,1769,1793
Jamar,M,100,5,1787,1792
Devyn,F,57,1027,763,1790
Kellan,M,96,64,1726,1790
Kieran,M,90,174,1615,1789
Willis,M,99,11,1773,1784
Amira,F,100,1782,0,1782
Shiloh,F,70,1239,539,1778
Malinda,F,100,1775,0,1775
Felicity,F,100,1774,0,1774
Agnes,F,100,1772,0,1772
Dusty,M,70,539,1233,1772
Rosalinda,F,100,1772,0,1772
Maximiliano,M,100,0,1771,1771
Yaretzi,F,100,1771,0,1771
Abbie,F,100,1766,0,1766
Nova,F,91,1608,157,1765
Humberto,M,100,0,1764,1764
Kareem,M,98,31,1732,1763
Lesly,F,97,1706,52,1758
Gunnar,M,100,0,1757,1757
Mohammad,M,100,5,1749,1754
Wilbert,M,99,11,1743,1754
Alexus,F,99,1732,19,1751
Anika,F,100,1748,0,1748
Maliyah,F,100,1745,0,1745
Carina,F,100,1733,8,1741
Mohammed,M,100,0,1741,1741
Marcel,M,94,98,1640,1738
Kierra,F,100,1732,5,1737
Reyna,F,100,1729,6,1735
Adele,F,100,1731,0,1731
Marta,F,100,1730,0,1730
Emory,M,61,681,1048,1729
Anton,M,100,0,1728,1728
Aylin,F,100,1727,0,1727
Esperanza,F,100,1727,0,1727
Curt,M,100,0,1724,1724
Rosalyn,F,100,1723,0,1723
Marlee,F,98,1692,30,1722
Archer,M,99,24,1697,1721
Viola,F,100,1721,0,1721
Denis,M,94,99,1614,1713
Velma,F,100,1711,0,1711
Horace,M,100,5,1704,1709
Isaias,M,100,0,1701,1701
Matteo,M,100,5,1695,1700
Janessa,F,100,1693,0,1693
Casandra,F,100,1688,0,1688
Kory,M,94,104,1583,1687
Madyson,F,100,1687,0,1687
Haleigh,F,100,1686,0,1686
Damion,M,100,5,1679,1684
Jarvis,M,100,7,1677,1684
Junior,M,100,0,1680,1680
Mariam,F,100,1680,0,1680
Braylen,M,95,88,1589,1677
Annabel,F,100,1675,0,1675
Renata,F,100,1669,6,1675
Markus,M,100,0,1674,1674
Donte,M,99,13,1659,1672
Kennedi,F,100,1672,0,1672
Moshe,M,100,0,1672,1672
Landyn,M,92,139,1532,1671
Maia,F,100,1666,0,1666
Nico,M,93,113,1550,1663
Lorna,F,100,1661,0,1661
Suzette,F,100,1661,0,1661
Ayanna,F,100,1660,0,1660
Camron,M,98,34,1624,1658
Carley,F,99,1645,12,1657
Myla,F,100,1656,0,1656
Annalise,F,100,1652,0,1652
Tammi,F,100,1651,0,1651
Aldo,M,100,5,1645,1650
Shayna,F,100,1645,0,1645
Louie,M,97,44,1600,1644
Polly,F,100,1644,0,1644
Santos,M,94,93,1548,1641
Wendi,F,100,1641,0,1641
Ervin,M,100,5,1634,1639
Jensen,M,82,295,1344,1639
Kaila,F,100,1637,0,1637
Alvaro,M,100,0,1636,1636
Braelyn,F,89,1447,188,1635
Liza,F,100,1635,0,1635
Ibrahim,M,100,0,1634,1634
Kiersten,F,100,1634,0,1634
Jimena,F,100,1633,0,1633
Rhiannon,F,100,1633,0,1633
Hubert,M,100,0,1632,1632
Sonny,M,95,77,1555,1632
Verna,F,99,1618,13,1631
Brice,M,98,33,1594,1627
Major,M,100,6,1621,1627
Nataly,F,100,1627,0,1627
Lorelei,F,100,1626,0,1626
Ignacio,M,100,0,1625,1625
Amani,F,83,1348,275,1623
Josh,M,100,0,1623,1623
Delbert,M,100,0,1621,1621
Izaiah,M,100,5,1616,1621
Ezequiel,M,100,0,1615,1615
Enzo,M,100,0,1614,1614
Estrella,F,100,1614,0,1614
Laverne,F,82,1316,297,1613
Stephany,F,100,1613,0,1613
Anaya,F,100,1612,0,1612
Sloane,F,97,1569,42,1611
Angeline,F,100,1610,0,1610
Skyla,F,100,1610,0,1610
Flora,F,100,1603,6,1609
Infant,M,50,796,812,1608
Terra,F,100,1608,0,1608
Kamila,F,100,1604,0,1604
Ivory,F,61,973,629,1602
Jayleen,F,99,1580,22,1602
Tyrell,M,100,6,1596,1602
Rodger,M,100,0,1598,1598
Shayne,M,81,304,1293,1597
Quintin,M,100,0,1593,1593
Cheyanne,F,100,1592,0,1592
Halle,F,100,1591,0,1591
Jamari,M,94,96,1495,1591
Tyree,M,95,83,1508,1591
Selina,F,100,1588,0,1588
Tamra,F,100,1587,0,1587
Alena,F,100,1586,0,1586
Donnell,M,94,95,1490,1585
Estella,F,100,1579,5,1584
Tess,F,100,1584,0,1584
Minnie,F,100,1575,6,1581
Deja,F,99,1568,12,1580
Elvis,M,100,0,1579,1579
Shania,F,100,1579,0,1579
Kane,M,100,5,1572,1577
Bryon,M,100,0,1573,1573
Dee,F,81,1269,304,1573
Nash,M,100,7,1566,1573
Marci,F,100,1572,0,1572
Deidre,F,100,1571,0,1571
Amina,F,100,1570,0,1570
Lowell,M,100,0,1570,1570
Brylee,F,94,1480,88,1568
Cristal,F,100,1568,0,1568
Adriel,M,93,105,1462,1567
Bessie,F,100,1560,5,1565
Libby,F,100,1563,0,1563
Maeve,F,100,1563,0,1563
Marcie,F,100,1562,0,1562
Susanna,F,100,1559,0,1559
Brisa,F,100,1557,0,1557
Lenora,F,100,1554,0,1554
Brook,F,76,1178,375,1553
Graciela,F,100,1547,6,1553
Chantel,F,100,1552,0,1552
Adelynn,F,100,1551,0,1551
Kason,M,100,0,1551,1551
Braeden,M,99,13,1537,1550
Rickie,M,89,173,1376,1549
Ronan,M,99,14,1534,1548
Dayna,F,100,1542,5,1547
Tamera,F,100,1546,0,1546
Mari,F,100,1540,5,1545
Jarred,M,100,0,1544,1544
Joelle,F,97,1492,51,1543
Davion,M,97,41,1500,1541
Janiyah,F,100,1541,0,1541
Meaghan,F,100,1538,0,1538
Amara,F,98,1512,24,1536
Magdalena,F,100,1536,0,1536
Millie,F,100,1536,0,1536
Renae,F,100,1536,0,1536
Tyra,F,99,1519,16,1535
Gianni,M,85,237,1296,1533
Lynnette,F,100,1532,0,1532
Lourdes,F,100,1519,6,1525
Brenton,M,100,0,1522,1522
Nanette,F,100,1522,0,1522
Ariella,F,100,1521,0,1521
Corina,F,100,1520,0,1520
Mckayla,F,100,1517,0,1517
Desirae,F,100,1515,0,1515
Carlie,F,97,1462,51,1513
Dahlia,F,100,1511,0,1511
Janell,F,100,1508,0,1508
Samara,F,100,1508,0,1508
Dayton,M,96,56,1451,1507
Jeffry,M,100,0,1507,1507
Jacklyn,F,100,1506,0,1506
Demarcus,M,100,0,1505,1505
Eugenia,F,100,1505,0,1505
Abbigail,F,100,1504,0,1504
Lyndsey,F,100,1504,0,1504
Agustin,M,100,0,1503,1503
Talon,M,96,55,1448,1503
Anabelle,F,100,1500,0,1500
Leeann,F,100,1498,0,1498
Ryland,M,94,83,1415,1498
Tianna,F,100,1496,0,1496
Garret,M,100,0,1495,1495
Averie,F,99,1475,19,1494
Dara,F,95,1422,72,1494
Isis,F,100,1493,0,1493
Kori,F,89,1322,169,1491
Jaycee,F,91,1347,141,1488
Laney,F,97,1445,42,1487
Deanne,F,100,1479,5,1484
Deloris,F,100,1484,0,1484
Channing,M,68,481,1001,1482
Chrystal,F,100,1482,0,1482
Liberty,F,99,1471,11,1482
Brandie,F,100,1481,0,1481
Janna,F,100,1479,0,1479
Bria,F,100,1478,0,1478
Chaya,F,100,1478,0,1478
Gracelyn,F,100,1477,0,1477
Lou,F,84,1240,236,1476
Scot,M,100,0,1473,1473
Deena,F,100,1472,0,1472
Kamden,M,96,63,1409,1472
Kendal,F,64,940,532,1472
Bo,M,94,84,1386,1470
Audrina,F,100,1469,0,1469
Chelsie,F,100,1465,0,1465
Kadence,F,90,1315,150,1465
Monty,M,99,19,1444,1463
Daleyza,F,100,1461,0,1461
Kailee,F,100,1455,6,1461
Kirby,M,79,305,1155,1460
Karlee,F,100,1459,0,1459
Princess,F,100,1459,0,1459
Rhys,M,94,87,1371,1458
Dayana,F,100,1457,0,1457
Gisselle,F,100,1457,0,1457
Bridgett,F,100,1455,0,1455
Adolfo,M,100,0,1454,1454
Jaylah,F,100,1454,0,1454
Jerri,F,99,1432,21,1453
Tierra,F,99,1441,11,1452
Antwan,M,99,16,1434,1450
Juana,F,100,1443,6,1449
Rocio,F,97,1411,38,1449
Tiffani,F,100,1448,0,1448
Brittani,F,100,1446,0,1446
Jolie,F,100,1446,0,1446
Korey,M,89,152,1294,1446
Karyn,F,100,1445,0,1445
Gerry,M,79,310,1134,1444
Davon,M,97,43,1400,1443
Martina,F,100,1436,0,1436
Kaylynn,F,100,1431,0,1431
Iliana,F,100,1429,0,1429
Uriah,M,93,93,1336,1429
Kathie,F,100,1424,0,1424
Trace,M,97,37,1387,1424
Carroll,M,79,297,1124,1421
Danika,F,100,1421,0,1421
Addisyn,F,100,1420,0,1420
Kacey,F,83,1183,237,1420
Ernestine,F,100,1419,0,1419
Kallie,F,100,1419,0,1419
Nasir,M,100,7,1409,1416
Cason,M,99,16,1398,1414
Atticus,M,99,9,1404,1413
Keely,F,100,1413,0,1413
Anissa,F,100,1411,0,1411
Ansley,F,98,1380,30,1410
Noreen,F,100,1408,0,1408
Kaia,F,100,1407,0,1407
Sky,F,69,967,436,1403
Marianna,F,100,1402,0,1402
Osvaldo,M,100,0,1400,1400
Jadyn,F,71,991,408,1399
Lina,F,100,1399,0,1399
Sammie,M,77,320,1079,1399
Deangelo,M,100,0,1397,1397
Kaley,F,100,1397,0,1397
Macey,F,99,1390,7,1397
Remy,M,60,559,838,1397
Christen,F,84,1174,221,1395
Alijah,M,92,115,1279,1394
Zara,F,100,1394,0,1394
Tamia,F,100,1393,0,1393
Chana,F,100,1392,0,1392
Nikita,F,75,1046,345,1391
Thalia,F,100,1390,0,1390
Willa,F,100,1390,0,1390
Adrianne,F,100,1383,5,1388
Kolby,M,88,162,1224,1386
Jacoby,M,99,11,1374,1385
Ace,M,100,5,1379,1384
Irving,M,100,0,1384,1384
Jeanie,F,100,1383,0,1383
Kamari,M,64,491,892,1383
Royal,M,78,303,1077,1380
Doyle,M,100,6,1370,1376
Hank,M,100,0,1376,1376
Ulises,M,100,5,1371,1376
Raelyn,F,100,1369,6,1375
Zariah,F,99,1358,17,1375
Rae,F,97,1334,37,1371
Celina,F,100,1369,0,1369
Damaris,F,96,1314,55,1369
Maricela,F,99,1358,11,1369
Bristol,F,95,1302,65,1367
Dionne,F,97,1323,44,1367
Lawson,M,96,60,1306,1366
Jarod,M,100,0,1365,1365
Alia,F,100,1364,0,1364
Galen,M,97,41,1323,1364
Rebeca,F,100,1364,0,1364
Zaiden,M,99,10,1352,1362
Aryanna,F,100,1351,0,1351
Corrine,F,100,1351,0,1351
Kaylyn,F,100,1351,0,1351
Cori,F,89,1204,145,1349
Aleena,F,100,1346,0,1346
Micaela,F,100,1345,0,1345
Jess,M,98,26,1318,1344
Kenley,F,90,1211,133,1344
Michel,M,73,359,985,1344
Matilda,F,100,1343,0,1343
Janel,F,100,1337,5,1342
Christin,F,91,1213,126,1339
Deven,M,87,174,1165,1339
Boyd,M,100,0,1336,1336
Coleman,M,100,5,1330,1335
Moriah,F,99,1324,11,1335
Cathryn,F,100,1334,0,1334
Johan,M,100,0,1329,1329
Lilia,F,100,1328,0,1328
Tayler,F,80,1060,268,1328
Carlee,F,99,1310,17,1327
Luciano,M,100,0,1327,1327
Trevon,M,100,0,1326,1326
Kacie,F,100,1325,0,1325
Cristopher,M,100,0,1323,1323
Georgina,F,100,1323,0,1323
Triston,M,98,22,1300,1322
Keagan,M,83,228,1092,1320
Harlan,M,97,38,1281,1319
Jaliyah,F,100,1318,0,1318
Tristin,M,81,250,1068,1318
Yasmine,F,100,1316,0,1316
Leia,F,100,1315,0,1315
Rohan,M,100,0,1313,1313
Lizette,F,100,1312,0,1312
Ernie,M,99,17,1294,1311
Kash,M,99,11,1299,1310
Julien,M,100,6,1303,1309
Shay,F,62,809,500,1309
Farrah,F,99,1301,7,1308
Tyrese,M,98,31,1277,1308
Marlin,M,90,131,1175,1306
Ronny,M,95,61,1242,1303
Roseann,F,100,1302,0,1302
Ulysses,M,100,0,1302,1302
Homer,M,100,6,1295,1301
Hans,M,100,0,1300,1300
Lauri,F,100,1300,0,1300
Helene,F,100,1298,0,1298
Augustus,M,100,0,1297,1297
Alonso,M,100,0,1291,1291
Yadira,F,100,1286,5,1291
America,F,100,1290,0,1290
Evie,F,100,1290,0,1290
Madilynn,F,100,1289,0,1289
Giovanna,F,100,1288,0,1288
Luciana,F,100,1286,0,1286
Nylah,F,100,1285,0,1285
Roxanna,F,100,1285,0,1285
Amya,F,100,1283,0,1283
Alberta,F,100,1281,0,1281
Jaylynn,F,95,1213,68,1281
Nigel,M,100,0,1281,1281
Phil,M,100,5,1274,1279
Alecia,F,100,1276,0,1276
Briella,F,100,1276,0,1276
Sunny,F,74,943,333,1276
Gay,F,97,1232,43,1275
Ally,F,100,1272,0,1272
Malaysia,F,100,1271,0,1271
Joslyn,F,100,1270,0,1270
Sharron,F,97,1236,34,1270
Denny,M,98,24,1245,1269
Charmaine,F,100,1262,6,1268
Lilyana,F,100,1267,0,1267
Percy,M,98,22,1245,1267
Anabel,F,99,1259,7,1266
Edmond,M,100,0,1266,1266
Vince,M,100,0,1265,1265
Ember,F,98,1242,22,1264
Lakeisha,F,99,1257,7,1264
Buddy,M,100,6,1257,1263
Mikel,M,93,91,1171,1262
Alden,M,94,80,1181,1261
Bruno,M,100,0,1257,1257
Blakely,F,87,1098,157,1255
Jaron,M,100,5,1249,1254
Saundra,F,100,1254,0,1254
Rosario,F,80,1001,252,1253
Mabel,F,100,1251,0,1251
Raina,F,100,1249,0,1249
Tameka,F,99,1240,9,1249
Chadwick,M,100,0,1248,1248
Nola,F,100,1248,0,1248
Cayla,F,100,1247,0,1247
Carlo,M,98,19,1227,1246
Annemarie,F,100,1245,0,1245
Roslyn,F,100,1244,0,1244
Sullivan,M,92,96,1148,1244
Donny,M,100,0,1243,1243
Kristal,F,100,1242,0,1242
Marlo,F,76,940,302,1242
Rufus,M,100,0,1242,1242
Dalia,F,100,1240,0,1240
Reina,F,100,1240,0,1240
Hana,F,100,1233,6,1239
Brinley,F,99,1221,17,1238
Eddy,M,98,24,1214,1238
Evelynn,F,100,1238,0,1238
Winter,F,94,1169,69,1238
Hassan,M,100,0,1236,1236
Jaelynn,F,98,1212,23,1235
Janiya,F,100,1235,0,1235
Kenna,F,99,1218,16,1234
Patience,F,99,1223,11,1234
Ayana,F,100,1233,0,1233
Denver,M,83,208,1025,1233
Adelina,F,100,1232,0,1232
Arjun,M,100,0,1232,1232
Maryam,F,100,1232,0,1232
Caryn,F,100,1230,0,1230
Caylee,F,100,1229,0,1229
Kian,M,99,12,1216,1228
Zechariah,M,100,0,1228,1228
Gino,M,100,6,1220,1226
Landry,M,54,558,668,1226
Natalee,F,100,1225,0,1225
Jaida,F,100,1223,0,1223
Reggie,M,98,28,1195,1223
Jena,F,100,1222,0,1222
Lainey,F,100,1221,0,1221
Myrna,F,100,1221,0,1221
Darien,M,89,132,1087,1219
Kathrine,F,100,1219,0,1219
Jovan,M,91,109,1107,1216
Wilbur,M,100,0,1216,1216
Zaria,F,100,1216,0,1216
Elian,M,99,13,1202,1215
Cortez,M,99,10,1203,1213
Zoie,F,100,1213,0,1213
Bronson,M,100,0,1211,1211
Addie,F,100,1205,5,1210
Brodie,M,97,42,1168,1210
Dewey,M,100,6,1204,1210
Jamel,M,96,43,1164,1207
Lesa,F,100,1206,0,1206
Joesph,M,100,0,1205,1205
Bert,M,99,12,1192,1204
Shaina,F,100,1204,0,1204
Valencia,F,100,1204,0,1204
Sincere,M,82,216,986,1202
Cari,F,100,1200,0,1200
Ciera,F,100,1200,0,1200
Erich,M,100,5,1195,1200
Benita,F,100,1198,0,1198
Rayna,F,100,1198,0,1198
Campbell,F,55,652,543,1195
Davin,M,98,25,1170,1195
Luisa,F,99,1187,8,1195
Ollie,F,51,611,584,1195
Rosetta,F,100,1195,0,1195
Freda,F,100,1194,0,1194
Karlie,F,100,1194,0,1194
Finnegan,M,99,13,1178,1191
Jadon,M,99,17,1174,1191
Boston,M,91,105,1085,1190
Aiyana,F,100,1189,0,1189
Rhea,F,99,1173,16,1189
Tenley,F,100,1189,0,1189
Celine,F,100,1188,0,1188
Claudette,F,100,1188,0,1188
Isabela,F,100,1188,0,1188
Ryann,F,93,1104,82,1186
Rigoberto,M,100,0,1184,1184
Lennon,M,59,486,696,1182
Selah,F,98,1160,22,1182
Cherish,F,100,1181,0,1181
Breanne,F,100,1179,0,1179
Chaz,M,98,24,1154,1178
Houston,M,96,42,1136,1178
Kaliyah,F,100,1178,0,1178
Jorden,M,76,279,898,1177
Lashawn,F,72,842,335,1177
Coleen,F,100,1176,0,1176
Thea,F,100,1175,0,1175
Mekhi,M,99,16,1158,1174
Sallie,F,100,1174,0,1174
Anabella,F,100,1173,0,1173
Mina,F,95,1107,64,1171
Breana,F,100,1169,0,1169
Octavio,M,100,0,1169,1169
Justina,F,99,1162,6,1168
Baby,M,53,550,617,1167
Oakley,M,57,506,658,1164
Otto,M,100,0,1164,1164
Myah,F,100,1163,0,1163
Aliya,F,100,1162,0,1162
Mitchel,M,100,0,1161,1161
Deidra,F,100,1160,0,1160
Kimber,F,97,1129,30,1159
Glenna,F,100,1158,0,1158
Madalynn,F,100,1157,0,1157
Louisa,F,100,1155,0,1155
Maranda,F,100,1155,0,1155
Deacon,M,100,0,1154,1154
Lakisha,F,100,1153,0,1153
Octavia,F,98,1132,20,1152
Ivette,F,100,1151,0,1151
Mira,F,100,1147,0,1147
Augustine,M,88,140,1004,1144
Benito,M,100,0,1144,1144
Saige,F,91,1037,107,1144
Lucian,M,100,5,1138,1143
Demetria,F,99,1136,6,1142
Jairo,M,100,0,1142,1142
Annamarie,F,100,1141,0,1141
Layton,M,92,89,1052,1141
Alysha,F,100,1140,0,1140
Arely,F,100,1140,0,1140
Gena,F,100,1140,0,1140
Korbin,M,99,10,1130,1140
Inez,F,97,1105,34,1139
Lela,F,100,1137,0,1137
Kasen,M,97,30,1106,1136
Katheryn,F,100,1136,0,1136
Karli,F,100,1135,0,1135
Scottie,M,88,131,1004,1135
Maryanne,F,100,1132,0,1132
Paloma,F,100,1132,0,1132
Alycia,F,100,1131,0,1131
Santana,M,53,532,598,1130
Brennen,M,98,24,1105,1129
Yahir,M,100,5,1124,1129
Dirk,M,100,0,1128,1128
Jaylene,F,99,1119,7,1126
Samson,M,100,0,1126,1126
Cleveland,M,100,0,1124,1124
Elvin,M,100,0,1124,1124
Darby,F,69,779,344,1123
Luann,F,100,1123,0,1123
Giana,F,100,1122,0,1122
Lupe,F,72,805,316,1121
Aliza,F,100,1120,0,1120
Ashly,F,98,1101,19,1120
Theo,M,96,45,1075,1120
Amalia,F,100,1117,0,1117
Benson,M,100,0,1116,1116
Margot,F,100,1116,0,1116
Alphonso,M,99,6,1108,1114
Daren,M,97,31,1083,1114
Demi,F,100,1114,0,1114
Karly,F,100,1114,0,1114
Matias,M,100,0,1114,1114
Roxana,F,100,1114,0,1114
Christiana,F,100,1113,0,1113
Dominik,M,98,17,1096,1113
Bradly,M,99,6,1106,1112
Antony,M,100,0,1111,1111
Catrina,F,100,1111,0,1111
Jazmyn,F,100,1111,0,1111
Belen,F,99,1102,7,1109
Denzel,M,99,6,1103,1109
Marisela,F,100,1109,0,1109
Killian,M,94,61,1047,1108
Rico,M,99,9,1099,1108
Cannon,M,99,10,1097,1107
Emmalyn,F,100,1107,0,1107
Fannie,F,100,1107,0,1107
Fletcher,M,100,0,1106,1106
Aida,F,100,1104,0,1104
Rosanne,F,100,1104,0,1104
Tevin,M,99,9,1095,1104
Yareli,F,100,1103,0,1103
Adrien,M,86,158,942,1100
Hollis,M,64,401,699,1100
Ilene,F,100,1100,0,1100
Lizeth,F,99,1091,9,1100
Jaylon,M,98,25,1074,1099
Maryellen,F,100,1099,0,1099
Carlene,F,100,1098,0,1098
Case,M,100,0,1098,1098
Paislee,F,100,1098,0,1098
Omari,M,96,39,1058,1097
Karsyn,F,83,906,188,1094
Liz,F,100,1093,0,1093
Miah,F,100,1092,0,1092
Mariela,F,100,1090,0,1090
Marquise,M,97,33,1056,1089
Danette,F,100,1086,0,1086
Nathanial,M,100,0,1086,1086
Reilly,F,53,578,507,1085
Siena,F,100,1085,0,1085
Tory,M,65,382,703,1085
Garland,M,96,46,1038,1084
Reba,F,100,1083,0,1083
Merle,M,79,226,856,1082
Briley,F,83,897,184,1081
Gannon,M,100,0,1081,1081
Maleah,F,100,1081,0,1081
Kaci,F,100,1075,5,1080
Bree,F,100,1078,0,1078
Coby,M,97,37,1040,1077
German,M,100,0,1075,1075
Marlena,F,100,1075,0,1075
Mitzi,F,100,1075,0,1075
Niko,M,96,44,1031,1075
Coy,M,96,43,1031,1074
Dario,M,100,0,1074,1074
Carmelo,M,100,0,1073,1073
Tegan,F,77,822,251,1073
Alessandro,M,100,0,1071,1071
Amiya,F,100,1071,0,1071
Milagros,F,100,1071,0,1071
Jaydon,M,96,39,1030,1069
Kelsi,F,100,1069,0,1069
Shantel,F,99,1056,13,1069
Debby,F,100,1068,0,1068
Litzy,F,99,1061,6,1067
Essence,F,100,1066,0,1066
Estelle,F,100,1066,0,1066
Ruthie,F,100,1066,0,1066
Lacie,F,100,1065,0,1065
Lisette,F,100,1065,0,1065
Marcelo,M,100,0,1065,1065
Zuri,F,95,1010,55,1065
Rosanna,F,100,1064,0,1064
Bryn,F,86,913,149,1062
Kathi,F,100,1062,0,1062
Lawanda,F,100,1061,0,1061
Cecily,F,100,1060,0,1060
Hal,M,100,0,1058,1058
Jaquan,M,100,5,1053,1058
Al,M,98,24,1033,1057
Latanya,F,100,1057,0,1057
Montana,F,70,742,313,1055
Brigitte,F,100,1054,0,1054
Carmela,F,100,1054,0,1054
Emersyn,F,98,1034,20,1054
Kenton,M,100,0,1053,1053
Lidia,F,100,1052,0,1052
Racheal,F,100,1052,0,1052
Gonzalo,M,100,0,1050,1050
Lula,F,100,1050,0,1050
Kyrie,M,57,449,600,1049
Tiffanie,F,100,1048,0,1048
Elvira,F,100,1047,0,1047
Gracelynn,F,100,1047,0,1047
Kylan,M,90,107,940,1047
Felecia,F,100,1046,0,1046
Robby,M,99,13,1033,1046
Harlow,F,92,959,86,1045
Santino,M,100,0,1045,1045
Zayne,M,98,26,1019,1045
Kayson,M,96,40,1004,1044
Melodie,F,100,1044,0,1044
Brant,M,100,0,1042,1042
Sariah,F,100,1042,0,1042
Ivanna,F,100,1041,0,1041
Althea,F,100,1040,0,1040
Elton,M,100,0,1040,1040
Kole,M,100,0,1040,1040
Xzavier,M,100,0,1039,1039
Ed,M,100,0,1038,1038
Jerrod,M,100,0,1038,1038
Leif,M,100,0,1038,1038
Monserrat,F,99,1028,8,1036
Nestor,M,100,0,1036,1036
Yusuf,M,100,0,1036,1036
Keyla,F,100,1035,0,1035
Valentin,M,100,0,1035,1035
Domingo,M,100,0,1034,1034
Azariah,F,58,599,433,1032
Raiden,M,97,29,1003,1032
Henrietta,F,100,1030,0,1030
Jaimie,F,91,940,90,1030
Kirstin,F,100,1029,0,1029
Sarina,F,100,1029,0,1029
Chaim,M,100,0,1028,1028
Jaidyn,F,60,614,414,1028
Sandi,F,100,1028,0,1028
Emelia,F,100,1027,0,1027
Mathias,M,100,0,1027,1027
Tatyana,F,100,1026,0,1026
Deann,F,100,1025,0,1025
Giovani,M,100,5,1020,1025
Samir,M,100,5,1019,1024
Sheena,F,100,1023,0,1023
Judson,M,100,0,1022,1022
Shyanne,F,100,1022,0,1022
Kristyn,F,100,1021,0,1021
Sloan,F,72,735,286,1021
Haylie,F,100,1020,0,1020
Latrice,F,100,1020,0,1020
Heriberto,M,100,0,1019,1019
Arden,F,62,633,385,1018
Kaya,F,95,966,51,1017
Salma,F,100,1017,0,1017
Semaj,M,77,230,786,1016
Alysia,F,100,1015,0,1015
Dangelo,M,100,0,1014,1014
Portia,F,100,1013,0,1013
Malakai,M,100,0,1012,1012
Maryjane,F,100,1012,0,1012
Randell,M,99,10,1002,1012
Ashanti,F,93,939,72,1011
Cale,M,99,8,1003,1011
Diann,F,100,1010,0,1010
Sydnee,F,100,1010,0,1010
Wilfredo,M,100,0,1010,1010
Braiden,M,98,16,993,1009
Josefina,F,100,1008,0,1008
Abril,F,100,1007,0,1007
Journee,F,99,992,15,1007
Starr,F,99,996,11,1007
Elbert,M,100,0,1006,1006
Mamie,F,100,1006,0,1006
Kaylen,F,85,856,149,1005
Alani,F,99,997,7,1004
Thiago,M,100,0,1004,1004
Callen,M,94,57,946,1003
Marybeth,F,100,1003,0,1003
Erma,F,100,1002,0,1002
Kale,M,97,27,974,1001
Kevon,M,99,6,995,1001
Monika,F,100,1000,0,1000
Nikolai,M,100,0,1000,1000
Dax,M,100,0,999,999
Kasandra,F,100,999,0,999
Misael,M,100,0,998,998
Shellie,F,98,979,18,997
Robbin,F,84,831,164,995
Kimora,F,100,994,0,994
Matthias,M,100,0,993,993
Adonis,M,100,0,991,991
Jaylee,F,99,984,7,991
Lilianna,F,100,991,0,991
Livia,F,100,990,0,990
Giancarlo,M,100,0,989,989
Broderick,M,100,0,988,988
Monroe,M,54,454,534,988
Cordell,M,100,0,986,986
Elana,F,100,985,0,985
Emmitt,M,100,0,985,985
Ivana,F,100,985,0,985
Katelin,F,100,985,0,985
May,F,97,960,25,985
Andria,F,99,979,5,984
Jamey,M,69,306,677,983
Coral,F,99,977,5,982
Karrie,F,100,981,0,981
Lennox,M,76,235,746,981
Denice,F,100,980,0,980
Emil,M,99,5,974,979
Emmalee,F,100,979,0,979
Sharlene,F,100,978,0,978
Aracely,F,100,977,0,977
Woodrow,M,100,0,975,975
Ashlie,F,100,973,0,973
Aja,F,99,963,9,972
Emmy,F,100,972,0,972
Roselyn,F,100,971,0,971
Aarav,M,100,0,969,969
Kristofer,M,100,0,969,969
Shaniqua,F,100,969,0,969
Daxton,M,100,0,967,967
Gertrude,F,100,967,0,967
Jazlynn,F,100,966,0,966
Justus,M,92,81,884,965
Blaise,M,91,91,873,964
Hamza,M,100,0,963,963
Keven,M,99,9,954,963
Remi,F,76,729,234,963
Rubi,F,99,954,8,962
Sherlyn,F,100,962,0,962
Madden,M,87,122,839,961
Austyn,M,54,443,516,959
Maegan,F,100,959,0,959
Lindy,F,88,847,111,958
Memphis,M,82,173,785,958
Cornell,M,99,10,947,957
Kaycee,F,97,930,27,957
Tisha,F,100,957,0,957
Jayde,F,96,913,43,956
Hayes,M,95,46,909,955
Dona,F,100,954,0,954
Jedidiah,M,100,0,954,954
Griselda,F,100,953,0,953
Sheree,F,100,953,0,953
Abdullah,M,100,0,952,952
Bernardo,M,100,0,952,952
Gayla,F,100,952,0,952
Georgette,F,100,952,0,952
Starla,F,100,952,0,952
Aryana,F,100,950,0,950
Dino,M,100,0,950,950
Jacques,M,97,32,918,950
Kinsey,F,97,917,33,950
Luka,M,95,43,906,949
Theron,M,100,0,949,949
Leyla,F,100,947,0,947
Tristian,M,94,54,893,947
Aurelia,F,100,946,0,946
Mandi,F,100,945,0,945
Amirah,F,100,944,0,944
Jamaal,M,99,5,939,944
Christal,F,100,943,0,943
Dani,F,89,840,103,943
Eliseo,M,100,0,941,941
Jacey,F,95,890,50,940
Jeanna,F,100,940,0,940
Vincenzo,M,100,0,937,937
Adela,F,100,936,0,936
Carmella,F,100,936,0,936
Dashawn,M,94,52,884,936
Keon,M,99,7,929,936
Lashonda,F,100,932,0,932
Yosef,M,100,0,932,932
Tana,F,100,931,0,931
Wilfred,M,100,0,931,931
Amelie,F,100,930,0,930
Kami,F,99,925,5,930
Enoch,M,100,0,928,928
Rayan,M,87,117,811,928
Ashtyn,F,80,742,185,927
Yael,M,53,438,489,927
Jaxton,M,100,0,926,926
Shelton,M,98,15,911,926
Fidel,M,100,0,925,925
Soren,M,96,40,885,925
Taliyah,F,100,925,0,925
Asha,F,100,924,0,924
Chantal,F,100,923,0,923
Rivka,F,100,923,0,923
Yazmin,F,100,923,0,923
Charli,F,99,912,10,922
Estevan,M,100,0,922,922
Petra,F,100,922,0,922
Stacia,F,100,922,0,922
Tera,F,100,922,0,922
Darrick,M,100,0,919,919
Dinah,F,100,919,0,919
Duke,M,100,0,919,919
Harris,M,99,5,914,919
Alayah,F,100,918,0,918
Ester,F,98,900,18,918
Josef,M,100,0,917,917
Kenia,F,100,917,0,917
Nicky,M,76,216,701,917
Destini,F,100,916,0,916
Etta,F,100,916,0,916
Edison,M,98,17,894,911
Lorene,F,100,911,0,911
Roxann,F,100,911,0,911
Holli,F,100,910,0,910
Britton,M,74,236,673,909
Misti,F,100,909,0,909
Consuelo,F,100,908,0,908
Daria,F,100,908,0,908
Rodrick,M,100,0,908,908
Arlo,M,97,26,881,907
Akira,F,85,771,135,906
Odin,M,100,0,906,906
Ursula,F,100,906,0,906
Blaze,M,92,74,831,905
Franco,M,100,0,905,905
Rey,M,100,0,905,905
Savanah,F,100,905,0,905
Trista,F,100,905,0,905
Stephon,M,100,0,904,904
Fay,F,96,866,37,903
Johnna,F,100,903,0,903
Maren,F,100,903,0,903
Giovanny,M,100,0,902,902
Kayley,F,100,902,0,902
Candi,F,100,901,0,901
Kianna,F,100,900,0,900
Davina,F,100,899,0,899
Karol,F,89,802,96,898
Laylah,F,100,898,0,898
Richelle,F,100,898,0,898
Natalya,F,100,897,0,897
Alexandrea,F,100,896,0,896
Calista,F,100,895,0,895
Whitley,F,95,854,41,895
Arian,M,79,191,702,893
Juniper,F,99,885,8,893
Truman,M,100,0,893,893
Xiomara,F,100,893,0,893
Beckham,M,99,11,881,892
Darrius,M,100,0,892,892
Lailah,F,100,892,0,892
Nathaly,F,100,892,0,892
Paityn,F,100,892,0,892
Shaniya,F,100,891,0,891
Cherry,F,99,884,6,890
Elin,F,97,860,30,890
Eldon,M,100,0,889,889
Lyndon,M,96,32,857,889
Lissette,F,100,886,0,886
Angelita,F,100,885,0,885
Braelynn,F,97,859,26,885
Gus,M,100,0,885,885
Chyna,F,100,884,0,884
Erwin,M,100,0,884,884
Unique,F,90,799,85,884
Aliana,F,100,883,0,883
Zain,M,95,41,842,883
Miya,F,100,882,0,882
Star,F,99,871,11,882
Venus,F,99,874,7,881
Astrid,F,100,880,0,880
Jaylyn,F,77,675,205,880
Rod,M,100,0,879,879
Jamil,M,97,30,847,877
Kerrie,F,100,877,0,877
Austen,M,88,103,772,875
Kaye,F,99,869,6,875
Suzanna,F,100,875,0,875
Antionette,F,100,874,0,874
Fabiola,F,99,867,7,874
Katarina,F,100,873,0,873
Rhoda,F,100,873,0,873
Dorothea,F,100,872,0,872
Tylor,M,95,46,825,871
Caren,F,100,870,0,870
Dania,F,100,870,0,870
Eliot,M,93,64,806,870
Shonda,F,100,869,0,869
Fallon,F,94,816,52,868
Linnea,F,100,868,0,868
Rian,M,62,332,536,868
Rob,M,100,0,868,868
Valentino,M,100,0,868,868
Azalea,F,100,867,0,867
Dimitri,M,99,10,857,867
Kamron,M,97,30,837,867
Lenore,F,100,867,0,867
Zaire,M,79,181,686,867
Kayleen,F,100,866,0,866
Quinten,M,100,0,866,866
Jakayla,F,100,864,0,864
Jocelynn,F,100,864,0,864
Laci,F,100,863,0,863
Norris,M,98,19,844,863
Gregorio,M,100,0,862,862
Lanny,M,99,5,857,862
Mireya,F,100,862,0,862
Brittni,F,100,861,0,861
Eryn,F,98,840,21,861
Hadassah,F,100,861,0,861
Alannah,F,100,860,0,860
Karon,F,60,518,342,860
Braylee,F,98,845,13,858
Mercy,F,98,844,14,858
Jordynn,F,97,829,27,856
Branson,M,100,0,855,855
Cindi,F,100,855,0,855
Jasiah,M,92,65,790,855
Kaiya,F,100,855,0,855
Malaya,F,100,855,0,855
Shyla,F,100,855,0,855
Tamela,F,100,855,0,855
Garrison,M,100,0,854,854
Bowen,M,98,21,832,853
Lenny,M,95,40,813,853
Maxim,M,99,6,846,852
Wiley,M,98,15,835,850
Elva,F,98,833,15,848
Noa,F,76,647,201,848
Cristy,F,99,842,5,847
Deonte,M,99,12,835,847
Dandre,M,99,6,840,846
Lorri,F,100,846,0,846
Amaris,F,96,812,33,845
Ami,F,94,798,47,845
Jacquelin,F,100,845,0,845
Leandro,M,100,0,845,845
Lylah,F,100,845,0,845
Yaritza,F,100,845,0,845
Evangelina,F,100,844,0,844
Simeon,M,99,5,839,844
Alexzander,M,100,0,843,843
Dereck,M,100,0,843,843
Noor,F,89,749,94,843
Ryley,M,59,348,495,843
Shamar,M,97,26,817,843
Carli,F,100,842,0,842
Charleigh,F,100,842,0,842
Francisca,F,99,836,6,842
Renita,F,100,842,0,842
Britany,F,100,840,0,840
Cleo,F,68,571,269,840
Averi,F,95,799,40,839
Letitia,F,100,839,0,839
Johana,F,100,838,0,838
Princeton,M,100,0,838,838
Siobhan,F,100,838,0,838
Akeem,M,100,0,837,837
Andreas,M,99,7,830,837
Devonte,M,100,0,837,837
Elyssa,F,100,837,0,837
Henley,F,84,706,131,837
Kenyon,M,98,18,819,837
Merry,F,100,837,0,837
Anders,M,100,0,836,836
Destiney,F,100,836,0,836
Domenic,M,100,0,836,836
Jamarion,M,100,0,836,836
Jalisa,F,100,835,0,835
Meadow,F,100,835,0,835
Jackeline,F,100,834,0,834
Melba,F,100,834,0,834
Raymundo,M,100,0,834,834
Sutton,F,54,447,387,834
Eliezer,M,100,0,833,833
Joana,F,100,833,0,833
Stormy,F,88,729,104,833
Andra,F,69,575,257,832
Efren,M,100,0,832,832
Michell,F,91,754,78,832
Carmine,M,97,22,809,831
Jordin,F,63,526,305,831
Isabell,F,100,830,0,830
Raleigh,M,66,280,550,830
Alesha,F,100,829,0,829
Aric,M,100,0,829,829
Britt,M,64,300,529,829
Donavan,M,100,0,829,829
Elianna,F,100,827,0,827
Saniyah,F,100,827,0,827
Addilyn,F,100,826,0,826
Draven,M,99,9,817,826
Legend,M,92,68,758,826
Jewell,F,85,700,125,825
Camdyn,M,62,316,508,824
Marcela,F,100,824,0,824
Ayaan,M,97,25,798,823
Benton,M,100,0,823,823
Kalyn,F,94,770,53,823
Rayne,F,87,715,108,823
Jed,M,100,0,822,822
Seamus,M,100,0,821,821
Danial,M,99,10,810,820
Mariano,M,100,0,820,820
Amare,M,95,37,782,819
Arron,M,98,17,802,819
Alesia,F,100,817,0,817
Jabari,M,100,0,817,817
Noelia,F,100,816,0,816
Holland,F,76,618,197,815
Judi,F,100,815,0,815
Tyron,M,100,0,814,814
Jemma,F,100,813,0,813
Jovani,M,98,20,793,813
Leigha,F,100,813,0,813
Ronin,M,99,9,804,813
Russel,M,100,0,813,813
Francesco,M,100,0,810,810
Camren,M,92,61,748,809
Lani,F,98,790,19,809
Allyssa,F,100,807,0,807
Yessenia,F,99,800,7,807
Lakesha,F,100,805,0,805
Lilith,F,100,805,0,805
Flor,F,98,786,18,804
Lucero,F,98,784,20,804
Katerina,F,100,803,0,803
Javion,M,99,6,796,802
Marques,M,100,0,802,802
Minerva,F,100,801,0,801
Shanda,F,100,800,0,800
Kensley,F,96,764,35,799
Chauncey,M,93,52,746,798
Sarahi,F,100,798,0,798
Azaria,F,98,778,18,796
Mika,F,84,667,129,796
Opal,F,100,796,0,796
Zaniyah,F,100,796,0,796
Briar,M,66,274,521,795
Shaylee,F,100,795,0,795
Elia,F,89,702,91,793
Sade,F,99,787,6,793
Daron,M,99,10,782,792
Karley,F,100,792,0,792
Davian,M,97,21,770,791
Jeana,F,100,790,0,790
Clarice,F,100,789,0,789
Montserrat,F,100,789,0,789
Aryan,M,89,84,704,788
Cordelia,F,100,788,0,788
Keeley,F,99,783,5,788
Jamir,M,99,5,782,787
Alysa,F,100,786,0,786
Darci,F,100,786,0,786
Kandice,F,100,786,0,786
Selene,F,100,786,0,786
Shanon,F,75,587,199,786
Valorie,F,100,785,0,785
Chastity,F,100,784,0,784
Cristobal,M,100,0,783,783
Samira,F,100,783,0,783
Jalyn,F,74,580,202,782
Leonidas,M,100,0,782,782
Raheem,M,100,0,782,782
Stefani,F,100,782,0,782
Tripp,M,100,0,782,782
Emerald,F,98,769,12,781
Julieta,F,100,781,0,781
Karma,F,97,760,20,780
Alyse,F,100,779,0,779
Forest,M,99,6,772,778
Jessa,F,100,778,0,778
Shakira,F,100,777,0,777
Turner,M,95,38,739,777
Cain,M,100,0,775,775
Kala,F,98,763,12,775
Kynlee,F,100,775,0,775
Yamileth,F,100,775,0,775
Burton,M,100,0,774,774
Keila,F,100,774,0,774
Mariyah,F,100,774,0,774
Nikole,F,100,774,0,774
Audriana,F,100,772,0,772
Charla,F,100,772,0,772
Khalid,M,100,0,772,772
Dannie,M,85,115,656,771
Federico,M,100,0,771,771
Carleigh,F,100,770,0,770
Nita,F,100,770,0,770
Ramsey,M,78,171,599,770
Cliff,M,100,0,768,768
Karmen,F,100,768,0,768
Sheridan,F,75,575,193,768
Ellison,F,74,569,198,767
Kayli,F,100,767,0,767
Vito,M,100,0,767,767
Winifred,F,97,745,21,766
Jaxen,M,99,6,759,765
Murray,M,98,12,753,765
Jael,F,61,466,298,764
Ayleen,F,100,763,0,763
Kenyatta,F,56,431,332,763
Makai,M,96,34,729,763
Violeta,F,100,762,0,762
Chace,M,99,6,755,761
Jessi,F,83,632,129,761
Stan,M,100,0,760,760
Zavier,M,100,0,759,759
Halie,F,100,757,0,757
Jamila,F,100,757,0,757
Miller,M,86,107,650,757
Arleen,F,100,756,0,756
Frida,F,100,756,0,756
Twila,F,100,756,0,756
Anais,F,98,741,14,755
Geri,F,100,755,0,755
Malissa,F,100,755,0,755
Ned,M,100,0,755,755
Saniya,F,100,755,0,755
Veda,F,100,755,0,755
Alexandro,M,100,0,754,754
Collette,F,100,754,0,754
Kia,F,99,748,6,754
Laken,F,72,543,211,754
Ariah,F,99,745,8,753
Katia,F,100,753,0,753
Muriel,F,99,745,8,753
Freya,F,100,752,0,752
Juliann,F,99,745,7,752
Tod,M,100,0,752,752
Hiram,M,100,0,751,751
Raylan,M,93,56,695,751
Destin,M,89,86,664,750
Jaeden,M,86,104,646,750
Pamala,F,100,749,0,749
Frederic,M,100,0,748,748
Hailie,F,100,748,0,748
Roscoe,M,100,0,748,748
Suzan,F,100,748,0,748
Aydin,M,97,21,726,747
Kassie,F,100,747,0,747
Kaylah,F,100,747,0,747
Nicola,F,67,502,245,747
Nixon,M,95,35,712,747
Rashawn,M,92,61,686,747
Keshawn,M,95,39,707,746
Amberly,F,100,745,0,745
Michal,F,51,377,368,745
Kendell,M,72,208,536,744
Anson,M,100,0,743,743
Koby,M,99,8,734,742
Westley,M,100,0,742,742
Bentlee,M,81,143,598,741
Dolly,F,100,741,0,741
Patrica,F,100,741,0,741
Danita,F,100,739,0,739
Kip,M,98,15,724,739
Alisson,F,100,738,0,738
Hezekiah,M,100,0,738,738
Lavonne,F,97,718,20,738
Danae,F,99,731,6,737
Hendrix,M,95,35,702,737
Ireland,F,99,731,6,737
Shae,F,75,554,183,737
Jagger,M,99,11,725,736
Sydni,F,100,736,0,736
Nelda,F,100,735,0,735
Barton,M,100,0,734,734
Bettie,F,100,734,0,734
Kyndall,F,97,709,25,734
Wren,F,87,639,95,734
Daquan,M,100,0,732,732
Leandra,F,100,732,0,732
Mariel,F,99,722,10,732
Marilynn,F,100,732,0,732
Jessika,F,100,731,0,731
Lillianna,F,100,731,0,731
Darion,M,97,25,705,730
Garth,M,100,0,730,730
Kingsley,M,84,116,614,730
Kolten,M,100,0,730,730
Rikki,F,91,661,69,730
Zainab,F,100,730,0,730
Adilene,F,100,729,0,729
Harlee,F,95,690,39,729
Myrtle,F,100,728,0,728
Abigayle,F,100,727,0,727
Baron,M,100,0,727,727
Estela,F,100,727,0,727
Isidro,M,100,0,726,726
Armand,M,100,0,725,725
Aydan,M,92,55,670,725
Grover,M,100,0,725,725
Kristan,F,91,657,68,725
Annalee,F,100,724,0,724
Avah,F,100,724,0,724
Dillan,M,95,37,687,724
Errol,M,100,0,724,724
Lon,M,99,5,719,724
Milena,F,100,724,0,724
Yamilet,F,100,724,0,724
Amia,F,100,723,0,723
Ean,M,100,0,723,723
Nelly,F,99,716,7,723
Nyah,F,100,723,0,723
Berenice,F,100,722,0,722
Denisse,F,100,722,0,722
Kandace,F,100,722,0,722
Susannah,F,100,722,0,722
Ward,M,100,0,722,722
Foster,M,97,23,698,721
Maximo,M,100,0,721,721
Moira,F,100,721,0,721
Nona,F,100,721,0,721
Evelin,F,100,720,0,720
Ginny,F,100,720,0,720
Jacque,F,73,529,191,720
Ophelia,F,100,720,0,720
Coty,M,90,75,644,719
Kennith,M,99,5,714,719
Tonja,F,100,719,0,719
Collins,F,62,443,275,718
Yousef,M,100,0,718,718
Kalani,F,67,479,238,717
Lyn,F,81,581,135,716
Zeke,M,100,0,716,716
Barney,M,99,5,710,715
Heidy,F,100,715,0,715
Nathalia,F,100,715,0,715
Bernadine,F,100,714,0,714
Marin,F,86,616,98,714
Marylou,F,100,714,0,714
Queen,F,100,714,0,714
Westin,M,100,0,714,714
Kyson,M,100,0,713,713
Missy,F,100,713,0,713
Valery,F,99,708,5,713
Makena,F,99,707,5,712
Hayleigh,F,100,710,0,710
Langston,M,93,52,658,710
Rihanna,F,100,710,0,710
Alyvia,F,100,709,0,709
Callan,M,82,127,582,709
Casen,M,99,6,702,708
Edwina,F,100,708,0,708
Keyon,M,98,12,696,708
Mayson,M,83,119,589,708
Niki,F,96,682,26,708
Shelli,F,100,708,0,708
Adina,F,100,707,0,707
Crosby,M,93,49,658,707
Ina,F,100,707,0,707
Gavyn,M,97,18,688,706
Gwyneth,F,100,706,0,706
Kylah,F,100,706,0,706
Lorelai,F,100,706,0,706
Tamar,F,83,583,123,706
Urijah,M,97,18,688,706
Alaysia,F,100,705,0,705
Juli,F,100,705,0,705
Lavon,M,61,276,429,705
Treasure,F,96,680,25,705
Abagail,F,100,704,0,704
Cailyn,F,100,704,0,704
Corrie,F,84,590,114,704
Jessy,M,69,217,487,704
Adriane,F,93,657,46,703
Karis,F,99,698,5,703
Linwood,M,100,0,703,703
Nicolle,F,100,703,0,703
Zack,M,100,0,703,703
Shante,F,97,681,21,702
Chantelle,F,100,701,0,701
Laureen,F,100,701,0,701
Camilo,M,100,0,700,700
Ephraim,M,100,0,700,700
Cedrick,M,100,0,699,699
Claudine,F,100,699,0,699
Nya,F,100,699,0,699
Abigale,F,100,698,0,698
Galilea,F,100,698,0,698
Jacky,M,83,118,580,698
Maisie,F,100,698,0,698
Priya,F,100,698,0,698
Antwon,M,100,0,697,697
Kisha,F,100,697,0,697
Mustafa,M,100,0,696,696
Riya,F,100,696,0,696
Kora,F,100,695,0,695
Lavern,M,55,316,379,695
Marietta,F,100,695,0,695
Vikki,F,100,695,0,695
Jovanni,M,99,7,687,694
Kyree,M,83,119,575,694
Brandt,M,99,6,687,693
Coraline,F,100,693,0,693
Iva,F,99,686,7,693
Kymani,M,80,135,557,692
Cassius,M,100,0,691,691
Emani,F,94,647,44,691
Richie,M,98,17,673,690
Mavis,F,100,689,0,689
Sybil,F,100,689,0,689
Areli,F,99,683,5,688
Zahra,F,100,688,0,688
Cataleya,F,100,687,0,687
Mac,M,100,0,687,687
Rowen,M,75,172,515,687
Travon,M,99,5,682,687
Aaden,M,100,0,686,686
Barbra,F,100,686,0,686
Kelton,M,100,0,686,686
Caleigh,F,100,685,0,685
Bodhi,M,98,11,673,684
Ivonne,F,99,677,7,684
Lucretia,F,100,684,0,684
Ellery,F,75,513,170,683
Isai,M,98,11,672,683
Maximillian,M,100,0,683,683
Saylor,F,92,626,57,683
Wynter,F,98,670,13,683
Danelle,F,100,682,0,682
Serina,F,100,682,0,682
Ayesha,F,100,681,0,681
Jerod,M,100,0,681,681
Maira,F,100,681,0,681
Winnie,F,100,681,0,681
Kirstie,F,100,679,0,679
Kitty,F,100,679,0,679
Naya,F,100,679,0,679
Sylas,M,100,0,679,679
Zariyah,F,100,679,0,679
Andi,F,88,599,79,678
Jai,M,83,116,562,678
Lars,M,100,0,678,678
Menachem,M,100,0,678,678
Annalisa,F,100,677,0,677
Alaya,F,100,676,0,676
Janeen,F,100,676,0,676
Jerrell,M,99,5,671,676
Kortney,F,91,617,59,676
Lyndsay,F,100,676,0,676
Demario,M,100,0,675,675
Jammie,F,64,433,242,675
Bambi,F,100,674,0,674
Bette,F,100,674,0,674
Cambria,F,100,674,0,674
Jenelle,F,100,674,0,674
Mable,F,100,674,0,674
Tosha,F,100,673,0,673
Yehuda,M,100,0,673,673
Jules,M,67,219,453,672
Anjali,F,100,671,0,671
Tobin,M,99,6,665,671
Baylor,M,73,178,492,670
Earnestine,F,100,670,0,670
Yoselin,F,100,670,0,670
Brigid,F,100,668,0,668
Alexi,F,75,498,169,667
Josette,F,100,667,0,667
Marva,F,100,667,0,667
Trever,M,100,0,667,667
Ameer,M,100,0,666,666
Rayden,M,95,36,630,666
Vladimir,M,100,0,666,666
Vonda,F,100,666,0,666
Brogan,M,84,105,560,665
Callum,M,100,0,665,665
Abner,M,100,0,664,664
Esme,F,100,664,0,664
Eboni,F,99,658,5,663
Emmaline,F,100,663,0,663
Magnolia,F,100,663,0,663
Aidyn,M,87,88,574,662
Domonique,F,72,476,186,662
Roxie,F,99,657,5,662
Shameka,F,100,662,0,662
Alyce,F,100,661,0,661
Annabell,F,100,661,0,661
Aya,F,100,661,0,661
Taya,F,100,661,0,661
Audrianna,F,100,660,0,660
Elvia,F,99,655,5,660
Ila,F,100,660,0,660
Jericho,M,91,57,603,660
Eloy,M,100,0,658,658
Marcellus,M,99,5,653,658
Ora,F,85,558,100,658
Shyann,F,100,658,0,658
Jadiel,M,100,0,657,657
Mitch,M,100,0,657,657
Kalvin,M,100,0,656,656
Luanne,F,100,656,0,656
Kraig,M,100,0,655,655
Nathen,M,100,0,655,655
Konnor,M,99,7,646,653
Marcelino,M,100,0,653,653
Corinna,F,100,652,0,652
Gauge,M,100,0,652,652
Kendyl,F,97,634,18,652
Lilyanna,F,100,652,0,652
Syed,M,100,0,652,652
Zelda,F,100,652,0,652
Edwardo,M,100,0,651,651
Genaro,M,100,0,651,651
Jasmyn,F,100,651,0,651
Thad,M,100,0,651,651
Krysta,F,100,650,0,650
Maryjo,F,100,650,0,650
Tawana,F,100,650,0,650
Carsyn,F,65,424,225,649
Karsen,M,65,228,421,649
Lazaro,M,100,0,649,649
Carrington,F,65,421,227,648
Evalyn,F,100,648,0,648
Johnpaul,M,100,0,648,648
Aleigha,F,100,647,0,647
Estefania,F,100,647,0,647
Marnie,F,100,647,0,647
Milana,F,100,647,0,647
Nakia,F,90,583,64,647
Palmer,M,67,212,435,647
Roseanne,F,100,647,0,647
Kamdyn,M,62,246,400,646
Sharla,F,100,646,0,646
Trystan,M,89,72,574,646
Edgardo,M,100,0,645,645
Garrick,M,100,0,645,645
Jacquline,F,100,645,0,645
Kaeden,M,96,25,620,645
Latosha,F,100,645,0,645
Lianna,F,100,645,0,645
Marcello,M,99,5,640,645
Clementine,F,100,644,0,644
Joleen,F,100,644,0,644
Kamilah,F,100,644,0,644
Marquita,F,100,644,0,644
Tariq,M,100,0,644,644
Vihaan,M,100,0,644,644
Bayleigh,F,100,643,0,643
Ronaldo,M,100,0,643,643
Roseanna,F,100,643,0,643
Taraji,F,97,623,20,643
Fisher,M,100,0,642,642
Mellissa,F,100,642,0,642
Yisroel,M,100,0,642,642
Konner,M,98,12,629,641
Dontae,M,100,0,640,640
Jaren,M,95,33,607,640
Teressa,F,100,640,0,640
Deandra,F,85,544,95,639
Dilan,M,99,6,633,639
Iman,F,82,523,116,639
Millicent,F,100,638,0,638
Pilar,F,93,596,42,638
Haiden,M,70,194,443,637
Kaela,F,100,637,0,637
Kaelynn,F,100,637,0,637
Marlen,F,92,587,49,636
Annelise,F,100,635,0,635
Berkley,F,76,481,154,635
Bryana,F,100,635,0,635
Sommer,F,100,635,0,635
Alfreda,F,100,634,0,634
Evette,F,100,634,0,634
Dalila,F,100,633,0,633
Jamya,F,100,633,0,633
Loraine,F,100,633,0,633
Murphy,M,80,126,507,633
Anneliese,F,100,632,0,632
Salina,F,100,632,0,632
Fern,F,98,618,13,631
Flynn,M,93,44,587,631
Reva,F,100,631,0,631
Soraya,F,100,631,0,631
Brigette,F,100,630,0,630
Abdul,M,100,0,629,629
Thurman,M,100,0,629,629
Vivien,F,100,629,0,629
Braylin,M,62,237,391,628
Dominque,F,53,334,294,628
Sanford,M,100,0,628,628
Bernie,M,91,57,570,627
Carsen,M,81,119,508,627
Eleni,F,100,627,0,627
Russ,M,100,0,627,627
Shira,F,100,627,0,627
Taj,M,92,50,577,627
Abdiel,M,100,0,626,626
Breann,F,100,626,0,626
Brecken,M,85,93,533,626
Derik,M,100,0,626,626
Jerimiah,M,100,0,626,626
Bettye,F,100,625,0,625
Odell,M,95,29,596,625
Shannan,F,95,592,33,625
Karim,M,98,13,611,624
Brea,F,100,623,0,623
Cornelia,F,100,623,0,623
Maliah,F,100,623,0,623
Stetson,M,100,0,623,623
Darcie,F,100,622,0,622
Gentry,M,59,258,364,622
Jailyn,F,86,533,89,622
Jaylan,M,83,103,519,622
Laquita,F,100,622,0,622
Lizzie,F,100,622,0,622
Demarco,M,100,0,621,621
Katlin,F,98,608,13,621
Sharonda,F,100,621,0,621
Chet,M,100,0,620,620
Darron,M,100,0,620,620
Joi,F,100,620,0,620
Kacy,F,88,544,76,620
Wilmer,M,98,10,610,620
Jair,M,100,0,619,619
Kairi,F,94,580,39,619
Tad,M,100,0,619,619
Vanesa,F,100,619,0,619
Essie,F,97,598,20,618
Jamarcus,M,100,0,618,618
Orville,M,100,0,618,618
Jazmyne,F,100,617,0,617
Nikhil,M,100,0,617,617
Slade,M,100,0,617,617
Aviana,F,100,616,0,616
Janay,F,100,616,0,616
Yuliana,F,100,616,0,616
Zakary,M,100,0,616,616
Kandi,F,100,614,0,614
Torrey,M,79,128,486,614
Loyd,M,100,0,613,613
Tatianna,F,100,613,0,613
Analia,F,100,612,0,612
Bridger,M,100,0,612,612
Iyanna,F,100,612,0,612
Farah,F,97,592,19,611
Malka,F,100,611,0,611
Neva,F,100,611,0,611
Rhianna,F,100,611,0,611
Tremaine,M,93,42,569,611
Deshaun,M,96,25,585,610
Kermit,M,100,0,610,610
Kyndal,F,97,593,17,610
Rosalia,F,100,610,0,610
Sami,M,80,125,485,610
Abrielle,F,100,609,0,609
Chanda,F,100,609,0,609
Charlize,F,100,609,0,609
Aubri,F,100,608,0,608
Chanelle,F,100,608,0,608
Ever,M,63,225,383,608
Gaige,M,97,17,591,608
Iyana,F,100,608,0,608
Kamille,F,100,608,0,608
Kya,F,100,608,0,608
Laron,M,97,21,587,608
Madisen,F,100,608,0,608
Alora,F,100,607,0,607
Kodi,F,54,329,278,607
Shon,M,94,36,571,607
Caitlynn,F,100,606,0,606
Ashely,F,99,600,5,605
Benedict,M,100,0,605,605
Charissa,F,100,605,0,605
Earlene,F,100,605,0,605
Jeramiah,M,100,0,605,605
Liv,F,100,605,0,605
Maison,M,85,88,517,605
Stone,M,99,6,599,605
Giada,F,100,604,0,604
Jerrold,M,100,0,604,604
Kalen,M,77,139,465,604
Marquez,M,99,5,599,604
Sydnie,F,100,604,0,604
Giavanna,F,100,603,0,603
Keshia,F,100,603,0,603
Sanaa,F,100,603,0,603
Savana,F,100,603,0,603
Merrill,M,71,175,427,602
Nanci,F,100,602,0,602
Kamren,M,91,52,549,601
Krystle,F,100,601,0,601
Tena,F,100,601,0,601
Alba,F,100,600,0,600
Dwain,M,100,0,600,600
Jaycob,M,100,0,600,600
Kalli,F,100,600,0,600
Basil,M,95,27,572,599
Belle,F,100,599,0,599
Danyelle,F,100,599,0,599
Mervin,M,100,0,599,599
Kaylan,F,86,516,82,598
Mauro,M,100,0,598,598
Meg,F,100,598,0,598
Adria,F,100,597,0,597
Everette,M,96,21,576,597
Promise,F,94,562,35,597
Felisha,F,100,596,0,596
Kailynn,F,100,596,0,596
Lexus,F,96,575,21,596
Shanika,F,100,596,0,596
Catharine,F,100,595,0,595
Immanuel,M,100,0,595,595
Jessenia,F,100,595,0,595
Kayle,F,85,504,91,595
Vida,F,100,595,0,595
Yasmeen,F,100,595,0,595
Bilal,M,100,0,594,594
Emmalynn,F,100,594,0,594
Adyson,F,98,584,9,593
Lorin,F,53,317,276,593
Bradyn,M,97,18,574,592
Ishaan,M,100,0,592,592
Lucca,M,86,81,511,592
Nichelle,F,100,592,0,592
Rosalee,F,100,592,0,592
Cinthia,F,100,591,0,591
Lesli,F,100,591,0,591
Lonny,M,98,12,579,591
Manuela,F,100,591,0,591
Reanna,F,100,591,0,591
Tai,M,55,264,327,591
Tyshawn,M,99,6,585,591
Aditya,M,100,0,590,590
Ileana,F,100,590,0,590
Jayna,F,100,589,0,589
Sabina,F,100,589,0,589
Tressa,F,100,589,0,589
Bode,M,100,0,588,588
Cydney,F,99,583,5,588
Stephenie,F,100,588,0,588
Trinidad,M,64,212,376,588
Bettina,F,100,587,0,587
Norbert,M,100,0,587,587
Racquel,F,100,587,0,587
Payten,F,84,492,94,586
Venessa,F,100,586,0,586
Aiyanna,F,100,585,0,585
Chrissy,F,100,585,0,585
Giuseppe,M,100,0,585,585
Melonie,F,100,585,0,585
Brandan,M,99,8,576,584
Hakeem,M,100,0,584,584
Blanche,F,100,583,0,583
Chevy,M,84,96,487,583
Ishmael,M,100,0,583,583
Terese,F,100,583,0,583
Arnulfo,M,100,0,582,582
Karleigh,F,100,582,0,582
Sherrill,F,88,510,72,582
Alexandre,M,98,13,568,581
Aliah,F,100,581,0,581
Dariel,M,92,46,535,581
Lucien,M,100,0,581,581
Twyla,F,100,581,0,581
Annaliese,F,100,580,0,580
Mordechai,M,100,0,580,580
Nevin,M,96,25,555,580
Nicki,F,96,558,22,580
Brentley,M,93,40,539,579
Garett,M,100,0,579,579
Jordy,M,98,9,570,579
Kyron,M,100,0,579,579
Lolita,F,100,579,0,579
Amiah,F,100,578,0,578
Isamar,F,96,555,23,578
Avis,F,93,539,38,577
Cami,F,100,577,0,577
Corrina,F,100,577,0,577
Crew,M,100,0,577,577
Johann,M,94,32,545,577
Avi,M,86,82,494,576
Gibson,M,99,8,568,576
Grey,M,80,115,461,576
Latricia,F,100,576,0,576
Tye,M,94,35,541,576
Iesha,F,100,575,0,575
Merlin,M,90,55,520,575
Charisse,F,100,574,0,574
Dariana,F,100,574,0,574
Dawna,F,100,574,0,574
Everleigh,F,100,574,0,574
Vienna,F,100,574,0,574
Damari,M,85,84,489,573
Kelby,M,73,153,419,572
Lanie,F,99,567,5,572
Nettie,F,100,572,0,572
Dejuan,M,99,5,566,571
Keyshawn,M,100,0,571,571
Lupita,F,100,571,0,571
Selma,F,100,571,0,571
Zaid,M,100,0,571,571
Finnley,M,64,203,367,570
Tayla,F,100,570,0,570
Jaedyn,F,52,298,271,569
Jevon,M,97,15,554,569
Kandy,F,99,564,5,569
Abrianna,F,100,568,0,568
Elayna,F,100,568,0,568
Maxx,M,97,19,549,568
Nyasia,F,100,567,0,567
Bryleigh,F,100,566,0,566
Imelda,F,100,566,0,566
Mikael,M,96,20,545,565
Ricki,F,66,373,192,565
Vickey,F,97,549,16,565
Deasia,F,100,564,0,564
Kalie,F,100,564,0,564
Samiyah,F,100,564,0,564
Germaine,F,58,324,238,562
Mimi,F,100,562,0,562
Alyssia,F,100,561,0,561
Jerrica,F,100,561,0,561
Avianna,F,100,560,0,560
Lottie,F,100,560,0,560
Neveah,F,100,560,0,560
Atlas,M,96,20,539,559
Lizabeth,F,100,559,0,559
Wes,M,100,0,559,559
Cayson,M,99,7,551,558
Codi,F,65,364,194,558
Deric,M,100,0,558,558
Jannie,F,100,558,0,558
Katalina,F,100,558,0,558
Blythe,F,95,527,30,557
Izabelle,F,100,557,0,557
Jalynn,F,92,514,43,557
Kwame,M,99,8,549,557
Shanice,F,100,556,0,556
Marleigh,F,100,555,0,555
Shoshana,F,100,555,0,555
Temperance,F,100,555,0,555
Aurelio,M,99,6,548,554
Clair,F,57,317,236,553
Dalilah,F,100,553,0,553
Madonna,F,100,553,0,553
Mariann,F,100,553,0,553
Treva,F,100,553,0,553
Dallin,M,100,0,552,552
Dasia,F,100,552,0,552
Ilana,F,100,552,0,552
Shanta,F,98,541,10,551
Deron,M,100,0,550,550
Elora,F,100,550,0,550
Greggory,M,100,0,550,550
Lemuel,M,100,0,550,550
Shlomo,M,100,0,550,550
Yaakov,M,100,0,550,550
Alva,F,54,296,253,549
Brittanie,F,100,549,0,549
Caydence,F,95,521,28,549
Lisbeth,F,100,549,0,549
Natali,F,100,549,0,549
Reyes,M,94,32,517,549
Delanie,F,100,548,0,548
Kadyn,M,73,149,399,548
Shamika,F,99,542,6,548
Aubrianna,F,100,547,0,547
Carleen,F,100,547,0,547
Keanu,M,96,20,527,547
Canaan,M,92,45,501,546
Estefany,F,100,546,0,546
Gisele,F,100,546,0,546
Jonna,F,100,546,0,546
Kaidence,F,92,504,42,546
Maribeth,F,100,546,0,546
Raylee,F,99,540,6,546
Xochitl,F,100,546,0,546
Alize,F,96,522,23,545
Charleen,F,100,545,0,545
Jakobe,M,100,0,545,545
Scarlette,F,100,545,0,545
Donell,M,89,58,486,544
Donn,M,99,7,537,544
Maiya,F,100,544,0,544
Melia,F,100,544,0,544
Dick,M,100,0,543,543
Gracyn,F,96,520,23,543
Jenni,F,100,543,0,543
Ariadne,F,100,542,0,542
Karie,F,100,542,0,542
Lucie,F,100,542,0,542
Tanesha,F,100,542,0,542
Grecia,F,100,541,0,541
Shreya,F,100,541,0,541
Aranza,F,100,540,0,540
Ashli,F,100,540,0,540
Cecile,F,100,540,0,540
Damarion,M,100,0,540,540
Goldie,F,100,540,0,540
Kalia,F,100,540,0,540
Mai,F,100,540,0,540
Shmuel,M,100,0,540,540
Brandee,F,100,539,0,539
Emmeline,F,100,539,0,539
Emmie,F,100,539,0,539
Jourdan,F,60,323,216,539
Honesty,F,100,538,0,538
Magaly,F,100,538,0,538
Symone,F,100,538,0,538
Weldon,M,100,0,538,538
Loni,F,97,523,14,537
Scout,F,74,396,141,537
Taniya,F,100,537,0,537
Maddie,F,100,536,0,536
Ofelia,F,100,536,0,536
Storm,M,63,197,339,536
Alexys,F,93,496,39,535
Barb,F,100,535,0,535
Bently,M,97,17,518,535
Beverley,F,100,535,0,535
Kelsea,F,100,535,0,535
Shantell,F,100,535,0,535
Edie,F,100,534,0,534
Fawn,F,100,534,0,534
Graysen,M,85,78,456,534
Odessa,F,99,529,5,534
Cristin,F,98,521,12,533
Gilda,F,100,533,0,533
Isela,F,100,533,0,533
Kailani,F,99,527,6,533
Latrell,M,91,48,485,533
Rosita,F,100,533,0,533
Windy,F,100,533,0,533
Yandel,M,100,0,533,533
Dori,F,100,532,0,532
Hernan,M,100,0,532,532
Leslee,F,97,515,17,532
Lucius,M,100,0,532,532
Shelbie,F,100,532,0,532
Luella,F,100,531,0,531
Maxton,M,100,0,531,531
Amar,M,92,43,487,530
Ford,M,100,0,530,530
Tawnya,F,100,530,0,530
Tristyn,M,53,248,282,530
Yuri,F,55,293,237,530
Azul,F,97,512,17,529
Dakotah,M,54,243,286,529
Elida,F,100,529,0,529
Jaquelin,F,100,529,0,529
Vernell,F,53,280,249,529
Yajaira,F,100,529,0,529
Aminah,F,100,528,0,528
Aries,M,64,190,338,528
Eleazar,M,100,0,528,528
Harriett,F,100,528,0,528
Kaylene,F,100,528,0,528
Marcell,M,89,56,472,528
Markell,M,94,32,496,528
Calli,F,100,527,0,527
Lyra,F,100,527,0,527
Oswaldo,M,100,0,527,527
Effie,F,100,526,0,526
Jasen,M,100,0,526,526
Leena,F,100,526,0,526
Leisa,F,100,526,0,526
Sol,F,58,306,219,525
Aven,M,52,250,274,524
Shelbi,F,100,524,0,524
Bishop,M,100,0,523,523
Carlotta,F,100,523,0,523
Jaimee,F,99,517,6,523
Jovany,M,100,0,523,523
Val,M,76,128,395,523
Jackelyn,F,100,522,0,522
Jaslyn,F,100,522,0,522
Neymar,M,99,5,517,522
Page,F,80,416,106,522
Brandyn,M,93,36,485,521
Chiquita,F,100,521,0,521
Donavon,M,100,0,521,521
Elina,F,100,520,0,520
Priscila,F,100,520,0,520
Shavon,F,96,500,20,520
Dudley,M,99,6,513,519
Elinor,F,100,519,0,519
Eula,F,100,519,0,519
Lathan,M,100,0,519,519
Latonia,F,100,519,0,519
Leola,F,100,519,0,519
Melva,F,100,519,0,519
Aubrielle,F,100,518,0,518
Cielo,F,99,511,7,518
Janiah,F,100,518,0,518
Jaydin,M,74,133,385,518
Makaila,F,100,518,0,518
Shalonda,F,100,518,0,518
Breonna,F,100,517,0,517
Dottie,F,100,517,0,517
Leilah,F,100,517,0,517
Roel,M,100,0,517,517
Shanell,F,100,517,0,517
Sunshine,F,100,517,0,517
Terrill,M,86,72,445,517
Trena,F,100,517,0,517
Anisa,F,100,516,0,516
Brittny,F,100,516,0,516
Elly,F,100,516,0,516
Salem,F,51,265,251,516
Shara,F,100,516,0,516
Sofie,F,100,516,0,516
Yara,F,100,516,0,516
Brannon,M,98,8,507,515
Laine,F,68,352,163,515
Bonny,F,97,500,14,514
Cathie,F,100,514,0,514
Deion,M,96,21,493,514
Keara,F,100,514,0,514
Lanette,F,100,514,0,514
Anisha,F,100,513,0,513
Cheryle,F,100,513,0,513
Antione,M,100,0,512,512
Ariyah,F,100,512,0,512
Cal,M,100,0,512,512
Jaci,F,100,512,0,512
Norberto,M,100,0,512,512
Brennon,M,100,0,511,511
Antonella,F,100,510,0,510
Claudio,M,98,10,500,510
Ethen,M,100,0,510,510
Kaidyn,M,65,176,334,510
Linsey,F,99,504,6,510
Montgomery,M,91,45,465,510
Judd,M,100,0,509,509
Kesha,F,100,509,0,509
Derrell,M,99,5,503,508
Jeromy,M,100,0,508,508
Merrick,M,94,31,477,508
Niya,F,100,508,0,508
Savion,M,100,0,508,508
Darleen,F,100,507,0,507
Dorene,F,100,507,0,507
Jelani,M,92,43,464,507
Joellen,F,100,507,0,507
Lucio,M,100,0,507,507
Misha,F,89,453,54,507
Shimon,M,100,0,507,507
Sylvie,F,100,507,0,507
Aleta,F,100,506,0,506
Brighton,M,61,196,310,506
Diya,F,100,506,0,506
Fredric,M,100,0,506,506
Keelan,M,90,52,454,506
Neha,F,100,506,0,506
Romina,F,100,506,0,506
Roxane,F,100,506,0,506
Stephani,F,100,506,0,506
Chiara,F,100,505,0,505
Kylen,M,86,69,436,505
Mellisa,F,100,505,0,505
Mikah,M,64,183,322,505
Naima,F,100,505,0,505
Katina,F,100,504,0,504
Malika,F,98,494,10,504
Shani,F,99,499,5,504
Jesenia,F,100,503,0,503
Kadin,M,98,10,493,503
Ladarius,M,100,0,503,503
Milania,F,100,503,0,503
Analise,F,100,502,0,502
Gerri,F,100,502,0,502
Isha,F,100,502,0,502
Desire,F,99,495,6,501
Izayah,M,100,0,501,501
Jullian,M,81,95,406,501
Rasheed,M,100,0,501,501
Blayne,M,87,63,437,500
Jeramy,M,100,0,500,500
Jovanny,M,100,0,500,500
Lenard,M,100,0,500,500
Magdalene,F,100,500,0,500
Oren,M,100,0,500,500
Torin,M,93,34,466,500
Arnav,M,100,0,499,499
Letha,F,100,499,0,499
Toney,M,95,23,476,499
Capri,F,100,498,0,498
China,F,100,498,0,498
Delmar,M,100,0,498,498
Desean,M,100,0,498,498
Levon,M,95,26,471,497
Ely,M,87,64,432,496
Isa,F,51,252,244,496
Kiarra,F,100,496,0,496
Marlyn,F,88,434,62,496
Thor,M,100,0,496,496
Trevin,M,100,0,496,496
Cathrine,F,100,495,0,495
Celestine,F,100,495,0,495
Douglass,M,100,0,495,495
Elan,M,76,118,377,495
Jonnie,F,66,325,170,495
Lillyana,F,100,495,0,495
Markel,M,98,12,483,495
Melony,F,100,495,0,495
Alessia,F,100,494,0,494
Hasan,M,100,0,494,494
Lashanda,F,100,494,0,494
Rio,M,66,170,324,494
Rylen,M,82,88,406,494
Aundrea,F,97,476,17,493
Briggs,M,100,0,492,492
Brionna,F,100,492,0,492
Jerold,M,100,0,492,492
Kaysen,M,86,71,421,492
Kye,M,93,33,459,492
Leopoldo,M,100,0,492,492
Cassondra,F,100,491,0,491
Laniyah,F,100,491,0,491
Marti,F,96,473,18,491
Zaira,F,100,491,0,491
Alek,M,99,7,483,490
Blaire,F,99,485,5,490
Daylen,M,91,44,446,490
Jolynn,F,100,490,0,490
Merritt,M,56,215,275,490
Vivianna,F,100,490,0,490
Carolynn,F,100,489,0,489
Geovanni,M,100,0,489,489
Isaak,M,100,0,489,489
Malina,F,100,489,0,489
Nalani,F,100,489,0,489
Barron,M,100,0,488,488
Joziah,M,100,0,488,488
Alli,F,100,487,0,487
Colter,M,100,0,487,487
Emmet,M,100,0,487,487
Jacobi,M,94,28,459,487
Jacquelynn,F,100,487,0,487
Candis,F,100,486,0,486
Keren,F,100,486,0,486
Marilee,F,100,486,0,486
Melani,F,100,486,0,486
Alanah,F,100,485,0,485
Apollo,M,100,0,485,485
Arianne,F,100,485,0,485
Carin,F,100,485,0,485
Casie,F,99,479,6,485
Sariyah,F,100,485,0,485
Schuyler,M,73,129,356,485
Shiela,F,100,485,0,485
Allegra,F,100,484,0,484
Antonette,F,100,484,0,484
Arlette,F,100,484,0,484
Marlie,F,100,484,0,484
Porsha,F,100,484,0,484
Sarita,F,100,484,0,484
Sharyn,F,100,484,0,484
Gigi,F,100,483,0,483
Jasmyne,F,100,483,0,483
Nikko,M,95,22,461,483
Titan,M,100,0,483,483
Braulio,M,100,0,482,482
Corie,F,79,380,102,482
Elysia,F,99,475,7,482
Johnie,M,88,58,424,482
Justen,M,100,0,482,482
Krystina,F,100,482,0,482
Leora,F,100,482,0,482
Samual,M,100,0,482,482
Shanelle,F,100,482,0,482
Theodora,F,100,482,0,482
Mykel,M,85,73,408,481
Pattie,F,100,481,0,481
Clement,M,100,0,480,480
Dedra,F,100,480,0,480
Freeman,M,100,0,480,480
Harmoni,F,100,480,0,480
Janene,F,100,480,0,480
Jesica,F,100,480,0,480
Kati,F,100,480,0,480
Lakeshia,F,100,480,0,480
Noble,M,98,11,469,480
Ridge,M,100,0,480,480
Saanvi,F,100,480,0,480
Tarah,F,100,480,0,480
Johnson,M,100,0,479,479
Khadijah,F,100,479,0,479
Analisa,F,100,478,0,478
Corine,F,100,478,0,478
Erinn,F,94,449,29,478
Mikhail,M,98,10,468,478
Shaila,F,100,478,0,478
Teena,F,100,478,0,478
Ajay,M,100,0,477,477
Ariane,F,100,477,0,477
Dedrick,M,100,0,477,477
Joseluis,M,100,0,477,477
Kiran,M,60,192,285,477
Pricilla,F,100,477,0,477
Roni,F,83,398,79,477
Ailyn,F,100,476,0,476
Beulah,F,100,476,0,476
Britni,F,100,476,0,476
Rana,F,97,462,14,476
Sherie,F,100,476,0,476
Tyesha,F,100,476,0,476
Yoel,M,100,0,476,476
Braedon,M,100,0,475,475
Micaiah,M,65,167,308,475
Monet,F,100,475,0,475
Raymon,M,100,0,475,475
Ruthann,F,100,475,0,475
Citlali,F,100,474,0,474
Crista,F,100,474,0,474
Elwood,M,100,0,474,474
Hadleigh,F,100,474,0,474
Harleigh,F,100,474,0,474
Joycelyn,F,100,474,0,474
Charis,F,100,473,0,473
Dayne,M,96,21,452,473
Gray,M,84,76,397,473
Aanya,F,100,472,0,472
Bodie,M,100,0,472,472
Dorthy,F,100,472,0,472
Fran,F,92,433,39,472
Jaleah,F,100,472,0,472
Tawny,F,100,472,0,472
Ayan,M,79,100,371,471
Cameryn,F,78,369,102,471
Darrion,M,96,18,453,471
Gaye,F,100,471,0,471
Joanie,F,100,471,0,471
Pyper,F,100,471,0,471
Rona,F,100,471,0,471
Arlen,M,85,69,401,470
Arman,M,100,0,470,470
Donita,F,100,470,0,470
Jamia,F,100,470,0,470
Nannette,F,100,470,0,470
Tre,M,100,0,470,470
Yahaira,F,100,470,0,470
Delano,M,99,5,464,469
Everardo,M,100,0,469,469
Corban,M,100,0,468,468
Demond,M,100,0,468,468
Quiana,F,100,468,0,468
Thatcher,M,100,0,468,468
Blane,M,100,0,467,467
Charisma,F,100,467,0,467
Estefani,F,100,467,0,467
Krish,M,99,5,462,467
Leana,F,100,467,0,467
Malaki,M,100,0,467,467
Raya,F,100,467,0,467
Adrain,M,88,58,408,466
Brookelynn,F,100,466,0,466
Cherise,F,100,466,0,466
Constantine,M,100,0,466,466
Kaleah,F,100,466,0,466
Malak,F,93,434,32,466
Samaria,F,100,466,0,466
Aedan,M,100,0,465,465
Ariya,F,100,465,0,465
Cael,M,99,5,460,465
Jacie,F,100,465,0,465
Vada,F,98,454,11,465
Cristofer,M,100,0,464,464
Krysten,F,100,464,0,464
Masen,M,97,15,449,464
Salena,F,100,464,0,464
Torey,M,65,162,302,464
Von,M,92,39,425,464
Avraham,M,100,0,463,463
Caesar,M,100,0,463,463
Cailey,F,100,463,0,463
Elicia,F,100,463,0,463
Emerie,F,100,463,0,463
Ryne,M,100,0,463,463
Delvin,M,100,0,462,462
Jacy,F,81,376,86,462
Josey,F,75,346,116,462
Maite,F,100,462,0,462
Pranav,M,100,0,462,462
Tresa,F,100,462,0,462
Lynsey,F,100,461,0,461
Makhi,M,99,6,455,461
Shasta,F,100,461,0,461
Alianna,F,100,460,0,460
Yitzchok,M,100,0,460,460
Angus,M,100,0,459,459
Brain,M,100,0,459,459
Carmel,F,90,411,48,459
Daisha,F,100,459,0,459
Egypt,F,88,406,53,459
Julisa,F,100,459,0,459
Khadija,F,100,459,0,459
Nailah,F,100,459,0,459
Pennie,F,100,459,0,459
Rhyan,F,64,292,167,459
Anniston,F,100,458,0,458
Aubriana,F,100,458,0,458
Jurnee,F,100,458,0,458
Marko,M,100,0,458,458
Milani,F,100,458,0,458
Soleil,F,100,458,0,458
Fredy,M,100,0,457,457
Jaymie,F,88,401,56,457
Jayvion,M,100,0,457,457
Jerel,M,100,0,457,457
Mallorie,F,100,457,0,457
Rishi,M,100,0,457,457
Izabel,F,100,456,0,456
Mindi,F,100,456,0,456
Aline,F,100,455,0,455
Aubry,F,84,383,72,455
Carmelita,F,100,455,0,455
Christophe,M,100,0,455,455
Jenesis,F,99,450,5,455
Jannette,F,100,454,0,454
Kalel,M,100,0,454,454
Magnus,M,100,0,454,454
Tyrus,M,100,0,454,454
Adolph,M,100,0,453,453
Ayva,F,100,453,0,453
Brissa,F,100,453,0,453
Cristiano,M,100,0,453,453
Holley,F,99,448,5,453
Jaleel,M,98,7,446,453
Jazzlyn,F,100,453,0,453
Karolina,F,100,453,0,453
Makenzi,F,100,453,0,453
Nahla,F,100,453,0,453
Zoya,F,100,453,0,453
Deontae,M,100,0,452,452
Jerica,F,100,452,0,452
Justyn,M,100,0,452,452
Mechelle,F,100,452,0,452
Preslee,F,98,443,9,452
Rayshawn,M,95,22,430,452
Sahara,F,100,452,0,452
Shawnee,F,96,434,18,452
Annetta,F,100,451,0,451
Dameon,M,100,0,451,451
Koen,M,100,0,451,451
Myranda,F,100,451,0,451
Socorro,F,94,422,29,451
Stevan,M,100,0,451,451
Cristine,F,100,450,0,450
Gaven,M,100,0,450,450
Jory,M,82,79,371,450
Juancarlos,M,100,0,450,450
Korbyn,M,82,79,371,450
Martez,M,100,0,450,450
Hamilton,M,100,0,449,449
Rileigh,F,100,449,0,449
Yair,M,100,0,449,449
Delois,F,100,448,0,448
Frieda,F,100,448,0,448
Horacio,M,100,0,448,448
Keily,F,100,448,0,448
Keller,M,86,63,385,448
Kloe,F,100,448,0,448
Alfonzo,M,100,0,447,447
Hali,F,99,442,5,447
Janeth,F,100,447,0,447
Kegan,M,94,25,422,447
Lachlan,M,96,19,428,447
Migdalia,F,100,447,0,447
Amayah,F,100,446,0,446
Anastacia,F,100,446,0,446
Joselin,F,100,446,0,446
Pearlie,F,98,435,11,446
Sana,F,100,446,0,446
Gareth,M,100,0,445,445
Joslynn,F,100,445,0,445
Lillyanna,F,100,445,0,445
Magali,F,100,445,0,445
Torrance,M,93,31,414,445
Adalberto,M,100,0,444,444
Aretha,F,100,444,0,444
Booker,M,100,0,444,444
Carlin,M,52,212,232,444
Jaydan,M,85,66,378,444
Keli,F,100,444,0,444
Leela,F,100,444,0,444
Rowdy,M,100,0,444,444
Shaelyn,F,100,444,0,444
Earline,F,100,443,0,443
Hadlee,F,100,443,0,443
Kiya,F,100,443,0,443
Linette,F,100,443,0,443
Lisha,F,100,443,0,443
Meryl,F,99,436,6,442
Nell,F,100,442,0,442
Abbygail,F,100,441,0,441
Alea,F,100,441,0,441
Alix,F,77,341,100,441
Carolann,F,100,441,0,441
Doretha,F,100,441,0,441
Dylon,M,100,0,441,441
Jarret,M,100,0,441,441
Malena,F,100,441,0,441
Miguelangel,M,100,0,441,441
Samiya,F,100,441,0,441
Shad,M,100,0,441,441
Adison,F,86,378,62,440
Ananya,F,100,440,0,440
Anjelica,F,100,440,0,440
Deondre,M,100,0,440,440
Leeanna,F,100,440,0,440
Marielle,F,100,440,0,440
Nate,M,91,41,399,440
Winfred,M,96,17,423,440
Darell,M,100,0,439,439
Debi,F,100,439,0,439
Aditi,F,100,438,0,438
Alisia,F,100,438,0,438
Andie,F,95,418,20,438
Devorah,F,100,438,0,438
Harlie,F,98,429,9,438
Ines,F,93,409,29,438
Keziah,F,99,433,5,438
Mica,F,79,347,91,438
Millard,M,100,0,438,438
Nala,F,100,438,0,438
Risa,F,100,438,0,438
Cyril,M,100,0,437,437
Delphine,F,100,437,0,437
Fermin,M,100,0,437,437
Heavenly,F,100,437,0,437
Kohen,M,97,13,424,437
Linus,M,100,0,437,437
Timmothy,M,100,0,437,437
Zyaire,M,81,83,354,437
Krishna,M,54,202,234,436
Rina,F,100,436,0,436
Ronna,F,100,436,0,436
Seneca,M,55,197,239,436
Toya,F,100,436,0,436
Zev,M,100,0,436,436
Ares,M,97,15,420,435
Dru,M,62,167,268,435
Eamon,M,100,0,435,435
Gil,M,100,0,435,435
Jacalyn,F,100,435,0,435
Jaycie,F,99,430,5,435
Karsten,M,98,10,425,435
Kellee,F,100,435,0,435
Sabastian,M,100,0,435,435
Sebastien,M,100,0,435,435
Tavon,M,97,13,422,435
Tinsley,F,100,435,0,435
Alta,F,100,434,0,434
Baylie,F,99,429,5,434
Emi,F,100,434,0,434
Glory,F,100,434,0,434
Kalea,F,100,434,0,434
Rilee,F,91,394,40,434
Venita,F,100,434,0,434
Allisson,F,100,433,0,433
Cailin,F,100,433,0,433
Dhruv,M,100,0,433,433
Georgiana,F,100,433,0,433
Jeremias,M,100,0,433,433
Lissa,F,100,433,0,433
Lorinda,F,100,433,0,433
Teegan,F,55,236,197,433
Tiera,F,100,433,0,433
Tyanna,F,100,433,0,433
Acacia,F,100,432,0,432
Ammon,M,100,0,432,432
Codie,M,60,173,259,432
Janaya,F,100,432,0,432
Jeremie,M,99,5,427,432
Leta,F,100,432,0,432
Maddux,M,94,24,408,432
Mariella,F,100,432,0,432
Olin,M,100,0,432,432
Debrah,F,100,431,0,431
Franchesca,F,100,431,0,431
Geralyn,F,100,431,0,431
Jamiyah,F,100,431,0,431
Linden,M,59,175,256,431
Raeann,F,100,431,0,431
Leesa,F,100,430,0,430
Nan,F,100,430,0,430
Ellianna,F,100,429,0,429
Coen,M,100,0,428,428
Henri,M,94,26,402,428
Ivey,F,77,329,99,428
Maylee,F,100,427,0,427
Ariyana,F,100,426,0,426
Celena,F,100,426,0,426
Colbie,F,86,366,60,426
Cris,M,72,121,305,426
Karolyn,F,100,426,0,426
Montrell,M,98,10,416,426
Dorinda,F,100,425,0,425
Karri,F,100,425,0,425
Obed,M,100,0,425,425
Shanae,F,100,425,0,425
Stefany,F,100,425,0,425
Xavi,M,100,0,425,425
Yulissa,F,100,425,0,425
Arie,F,55,234,190,424
Arin,F,56,238,186,424
Deonna,F,100,424,0,424
Elma,F,99,418,6,424
Malcom,M,100,0,424,424
Paulo,M,100,0,424,424
Samatha,F,100,424,0,424
Stephaine,F,100,424,0,424
Axton,M,100,0,423,423
Jayvon,M,100,0,423,423
Jerad,M,100,0,423,423
Margret,F,100,423,0,423
Mirna,F,100,423,0,423
Pasquale,M,100,0,423,423
Stanton,M,100,0,423,423
Aleksander,M,100,0,422,422
Jaya,F,100,422,0,422
Jermiah,M,98,10,412,422
Jessalyn,F,100,422,0,422
Kentrell,M,99,6,416,422
Mahogany,F,100,422,0,422
Arnoldo,M,100,0,421,421
Anish,M,100,0,420,420
Kadeem,M,100,0,420,420
Kenisha,F,100,420,0,420
Kinslee,F,100,420,0,420
Musa,M,100,0,420,420
Tamie,F,100,420,0,420
Tierney,F,100,420,0,420
Valentine,M,69,129,291,420
Bethanie,F,100,419,0,419
Georgianna,F,100,419,0,419
Kimberli,F,100,419,0,419
Loriann,F,100,419,0,419
Myka,F,88,370,49,419
Trae,M,100,0,419,419
Wylie,M,90,43,376,419
Cyndi,F,100,418,0,418
Echo,F,95,399,19,418
Kannon,M,98,10,408,418
Karan,F,67,279,139,418
Luc,M,100,0,418,418
Mackenna,F,100,418,0,418
Marshal,M,98,7,411,418
Miyah,F,100,418,0,418
Patricio,M,100,0,418,418
Stanford,M,100,0,418,418
Dionna,F,100,417,0,417
Kahlil,M,100,0,417,417
Treyvon,M,100,0,417,417
Dayanara,F,100,416,0,416
Katlynn,F,100,416,0,416
Lorenza,M,56,182,234,416
Makaylah,F,100,416,0,416
Sapphire,F,100,416,0,416
Graeme,M,100,0,415,415
Irwin,M,100,0,415,415
Kamiyah,F,100,415,0,415
Lelia,F,100,415,0,415
Parris,M,53,195,220,415
Rosendo,M,100,0,415,415
Adelle,F,100,414,0,414
Alethea,F,100,414,0,414
Amyah,F,100,414,0,414
Anakin,M,100,0,414,414
Barbie,F,100,414,0,414
Emme,F,100,414,0,414
Peighton,F,97,402,12,414
Winona,F,100,414,0,414
Addilynn,F,100,413,0,413
Cherri,F,100,413,0,413
Donta,M,97,13,400,413
Emalee,F,100,413,0,413
Kalynn,F,100,413,0,413
Sharee,F,100,413,0,413
Corwin,M,100,0,412,412
Delana,F,100,412,0,412
Jedediah,M,100,0,412,412
Kael,M,100,0,412,412
Kooper,M,90,42,370,412
Sheyla,F,100,412,0,412
Tinley,F,100,412,0,412
Boden,M,100,0,411,411
Bradlee,M,94,25,386,411
Chassidy,F,100,411,0,411
Kanisha,F,100,411,0,411
Kasie,F,100,411,0,411
Marlowe,F,77,316,95,411
Mylah,F,100,411,0,411
Williams,M,99,5,406,411
Yaneli,F,100,411,0,411
Afton,F,90,367,43,410
Christofer,M,100,0,410,410
Dayanna,F,100,410,0,410
Deegan,M,100,0,410,410
Harlem,M,74,106,304,410
Neriah,F,99,405,5,410
Zaniya,F,100,410,0,410
Carnell,M,96,15,394,409
Cy,M,100,0,409,409
Leander,M,100,0,409,409
Louann,F,100,409,0,409
Oralia,F,100,409,0,409
Sherita,F,100,409,0,409
Aarush,M,100,0,408,408
Adamaris,F,100,408,0,408
Del,M,89,45,363,408
Divine,F,56,230,178,408
Jered,M,100,0,408,408
Kase,M,100,0,408,408
Nydia,F,100,408,0,408
Lona,F,100,407,0,407
Maycee,F,100,407,0,407
Retha,F,100,407,0,407
Daniele,F,83,335,71,406
Denton,M,100,0,406,406
Derwin,M,100,0,406,406
Gian,M,100,0,406,406
Napoleon,M,100,0,406,406
Renea,F,100,406,0,406
Suri,F,100,406,0,406
Allyn,F,51,206,199,405
Darrian,M,89,46,359,405
Eloisa,F,100,405,0,405
Meghann,F,100,405,0,405
Viridiana,F,100,405,0,405
Zyon,M,81,75,330,405
Evelina,F,100,404,0,404
Nedra,F,100,404,0,404
Wilhelmina,F,100,404,0,404
Kaylani,F,100,403,0,403
Nickie,F,75,302,101,403
Nikola,M,83,70,333,403
Ola,F,96,387,16,403
Robb,M,100,0,403,403
Sequoia,F,91,366,37,403
Britta,F,100,402,0,402
Calla,F,100,402,0,402
Dasha,F,100,402,0,402
Jersey,F,93,373,29,402
Kyara,F,100,402,0,402
Nechama,F,100,402,0,402
Nila,F,100,402,0,402
Vern,M,95,19,383,402
Buck,M,100,0,401,401
Emile,M,89,45,356,401
Freida,F,100,401,0,401
Jocelyne,F,100,401,0,401
Konrad,M,100,0,401,401
Nada,F,100,401,0,401
Art,M,100,0,400,400
Haden,M,94,24,376,400
Hilton,M,97,11,389,400
Kimberlyn,F,100,400,0,400
Liane,F,100,400,0,400
Mylee,F,100,400,0,400
Brysen,M,100,0,399,399
Jamiya,F,100,399,0,399
Kenji,M,98,8,391,399
Aris,M,63,147,251,398
Jaleesa,F,100,398,0,398
Kenan,M,99,5,393,398
Yolonda,F,100,398,0,398
Avani,F,97,387,10,397
Corbyn,M,90,38,359,397
Dyllan,M,86,55,342,397
Jalissa,F,100,397,0,397
Jarett,M,100,0,397,397
Jerilyn,F,100,397,0,397
Kain,M,100,0,397,397
Karah,F,100,397,0,397
Rich,M,100,0,397,397
Jordana,F,100,396,0,396
Kinlee,F,100,396,0,396
Manny,M,100,0,396,396
Nena,F,100,396,0,396
Sanjuanita,F,100,396,0,396
Azucena,F,100,395,0,395
Demetri,M,99,5,390,395
Jefferey,M,100,0,395,395
Jeremey,M,100,0,395,395
Demetris,M,78,87,307,394
Denisha,F,100,394,0,394
Fritz,M,100,0,394,394
Shianne,F,100,394,0,394
Yessica,F,100,394,0,394
Augusta,F,82,324,69,393
Blessing,F,92,362,31,393
Citlalli,F,100,393,0,393
Dannielle,F,100,393,0,393
Gisela,F,100,393,0,393
Jesiah,M,93,27,366,393
Poppy,F,100,393,0,393
Rachell,F,100,393,0,393
Siddharth,M,100,0,393,393
Tahj,M,98,8,385,393
Henrik,M,100,0,392,392
Len,M,97,13,379,392
Rashaad,M,100,0,392,392
Yadiel,M,100,0,392,392
Angelic,F,100,391,0,391
Kenzi,F,100,391,0,391
Kindra,F,100,391,0,391
Ocean,F,50,196,195,391
Rianna,F,100,391,0,391
Rilynn,F,95,370,21,391
Yarely,F,100,391,0,391
Breeanna,F,100,390,0,390
Kalina,F,100,390,0,390
Randa,F,100,390,0,390
Danya,F,100,389,0,389
Dezmond,M,100,0,389,389
Eugenio,M,100,0,389,389
Isreal,M,97,10,379,389
Jamin,M,96,17,372,389
Kamya,F,100,389,0,389
Kathryne,F,100,389,0,389
Keyonna,F,100,389,0,389
Reinaldo,M,100,0,389,389
Sanai,F,99,384,5,389
Artis,M,92,32,356,388
Avalynn,F,100,388,0,388
Dior,F,71,276,112,388
Lilyann,F,100,388,0,388
Malorie,F,100,388,0,388
Raylene,F,100,388,0,388
Ria,F,100,388,0,388
Chevelle,F,94,362,25,387
Elnora,F,100,387,0,387
Keyana,F,100,387,0,387
Luigi,M,100,0,387,387
Zahir,M,100,0,387,387
Izzabella,F,100,386,0,386
Janey,F,100,386,0,386
Josselyn,F,100,386,0,386
Karoline,F,100,386,0,386
Odalys,F,100,386,0,386
Taylin,F,80,308,78,386
Avalyn,F,100,385,0,385
Buffy,F,100,385,0,385
Kalee,F,97,375,10,385
Maynard,M,100,0,385,385
Shonna,F,100,385,0,385
Cinda,F,100,384,0,384
Jaslene,F,100,384,0,384
Oriana,F,100,384,0,384
Taniyah,F,100,384,0,384
Alanis,F,100,383,0,383
Enrico,M,100,0,383,383
Jacinda,F,100,383,0,383
Lili,F,100,383,0,383
Rain,F,75,287,96,383
Spenser,M,88,45,338,383
Tremayne,M,98,6,377,383
Zandra,F,100,383,0,383
Brayson,M,100,0,382,382
Concetta,F,100,382,0,382
Ema,F,100,382,0,382
Kaytlin,F,100,382,0,382
Kensington,F,96,368,14,382
Marni,F,100,382,0,382
Tanika,F,100,382,0,382
Tarik,M,100,0,382,382
Veronika,F,100,382,0,382
Warner,M,100,0,382,382
Charly,F,65,249,132,381
Kiah,F,95,362,19,381
Leonor,F,100,381,0,381
Nicholaus,M,100,0,381,381
Rochel,F,100,381,0,381
Youssef,M,100,0,381,381
Abelardo,M,100,0,380,380
Ambrose,M,100,0,380,380
Chelsi,F,100,380,0,380
Gerson,M,100,0,380,380
Hershel,M,100,0,380,380
Jakari,M,92,29,351,380
Juelz,M,95,18,362,380
Kimberlie,F,100,380,0,380
Rowena,F,100,380,0,380
Shaniyah,F,100,380,0,380
Tracee,F,100,380,0,380
Audree,F,100,379,0,379
Cormac,M,100,0,379,379
Tawanna,F,100,379,0,379
Brittaney,F,100,378,0,378
Carie,F,100,378,0,378
Caron,F,73,277,101,378
Daryn,M,72,104,274,378
Korie,F,84,316,62,378
Laniya,F,100,378,0,378
Leighann,F,100,378,0,378
Mohamad,M,100,0,378,378
Rahul,M,100,0,378,378
Brookelyn,F,100,377,0,377
Ismail,M,100,0,377,377
Janee,F,100,377,0,377
Jeniffer,F,100,377,0,377
Keyanna,F,100,377,0,377
Makiyah,F,99,372,5,377
Maricruz,F,100,377,0,377
Rosella,F,100,377,0,377
Charlette,F,100,376,0,376
Nicklaus,M,100,0,376,376
Viktor,M,100,0,376,376
Alain,M,100,0,375,375
Jonatan,M,100,0,375,375
Kevan,M,100,0,375,375
Kristoffer,M,100,0,375,375
Magen,F,100,375,0,375
Meera,F,100,375,0,375
Shanita,F,100,375,0,375
Wilton,M,100,0,375,375
Alise,F,100,374,0,374
Anayah,F,100,374,0,374
Ariyanna,F,100,374,0,374
Sherilyn,F,100,374,0,374
Tabetha,F,100,374,0,374
Zaida,F,100,374,0,374
Zena,F,100,374,0,374
Cammie,F,99,368,5,373
Chante,F,98,365,8,373
Evin,M,84,60,313,373
Honor,F,74,275,98,373
Ike,M,100,0,373,373
Katya,F,100,373,0,373
Kyran,M,95,18,355,373
Paolo,M,100,0,373,373
Shirlene,F,100,373,0,373
Zavion,M,100,0,373,373
Bud,M,100,0,372,372
Daylin,M,60,150,222,372
Hoyt,M,100,0,372,372
Javen,M,97,10,362,372
Keanna,F,100,372,0,372
Londynn,F,100,372,0,372
Shavonne,F,100,372,0,372
Sherryl,F,100,372,0,372
Stormie,F,100,372,0,372
Avalon,F,97,360,11,371
Ayah,F,100,371,0,371
Brittnee,F,100,371,0,371
Bronwyn,F,100,371,0,371
Hussein,M,100,0,371,371
Isadora,F,100,371,0,371
Laina,F,100,371,0,371
Tawanda,F,100,371,0,371
Chantell,F,100,370,0,370
Dakoda,M,78,83,287,370
Devante,M,100,0,370,370
Evalynn,F,100,370,0,370
Keandre,M,100,0,370,370
Latesha,F,100,370,0,370
Marleen,F,100,370,0,370
Suzy,F,100,370,0,370
Burke,M,97,12,357,369
Dajuan,M,100,0,369,369
Devlin,M,94,23,346,369
Said,M,100,0,369,369
Suzie,F,100,369,0,369
Axl,M,100,0,368,368
Boone,M,100,0,368,368
Boris,M,100,0,368,368
Demarion,M,100,0,368,368
Karena,F,100,368,0,368
Khaleesi,F,100,368,0,368
Lilli,F,100,368,0,368
Shemar,M,100,0,368,368
Tanna,F,100,368,0,368
Braedyn,M,90,36,331,367
Dollie,F,100,367,0,367
Halley,F,100,367,0,367
Sabra,F,100,367,0,367
Tylan,M,96,14,353,367
Amariah,F,100,366,0,366
Fatimah,F,100,366,0,366
Latifah,F,100,366,0,366
Lucky,M,87,47,319,366
Roxy,F,98,357,9,366
Ryanne,F,100,366,0,366
Sailor,F,90,331,35,366
Brieanna,F,100,365,0,365
Concepcion,F,81,296,69,365
Jeanetta,F,100,365,0,365
Love,F,90,328,37,365
Quinlan,M,74,96,269,365
Rueben,M,100,0,365,365
Treyton,M,100,0,365,365
Tyquan,M,100,0,365,365
Cian,M,100,0,364,364
Dione,F,82,297,67,364
Haydee,F,100,364,0,364
Jarrell,M,100,0,364,364
Kelcie,F,98,358,6,364
Marita,F,100,364,0,364
Reymundo,M,100,0,364,364
Deedee,F,100,363,0,363
Ellyn,F,100,363,0,363
Kameryn,F,72,261,102,363
Kamiya,F,100,363,0,363
Margery,F,100,363,0,363
Mikala,F,100,363,0,363
Neel,M,100,0,363,363
Spring,F,100,363,0,363
Tayden,M,93,25,338,363
Vianey,F,100,363,0,363
Zakiya,F,100,363,0,363
Caprice,F,97,351,11,362
Fonda,F,100,362,0,362
Gizelle,F,100,362,0,362
Hagen,M,95,18,344,362
Kyan,M,97,12,350,362
Mikal,M,82,64,298,362
Nariah,F,100,362,0,362
Orin,M,100,0,362,362
Rogers,M,99,5,357,362
Triniti,F,100,362,0,362
Tzvi,M,100,0,362,362
Anibal,M,100,0,361,361
Evonne,F,100,361,0,361
Franklyn,M,100,0,361,361
Gabe,M,100,0,361,361
Imran,M,100,0,361,361
Larisa,F,100,361,0,361
Octavius,M,99,5,356,361
Persephone,F,100,361,0,361
Tiarra,F,100,361,0,361
Waverly,F,67,241,120,361
Creighton,M,100,0,360,360
Gwenyth,F,100,360,0,360
Hosea,M,100,0,360,360
Jacelyn,F,100,360,0,360
Kalin,M,53,169,191,360
Kirt,M,100,0,360,360
Luana,F,100,360,0,360
Mercedez,F,100,360,0,360
Rania,F,100,360,0,360
Talya,F,100,360,0,360
Zephaniah,M,89,39,321,360
Aislinn,F,100,359,0,359
Christianna,F,100,359,0,359
Danilo,M,100,0,359,359
Dennise,F,97,348,11,359
Edson,M,100,0,359,359
Hilario,M,100,0,359,359
Lavonda,F,100,359,0,359
Leeland,M,97,10,349,359
Meir,M,100,0,359,359
Merissa,F,100,359,0,359
Reem,F,100,359,0,359
Romona,F,100,359,0,359
Tangela,F,100,359,0,359
Adaline,F,100,358,0,358
Aleisha,F,100,358,0,358
Brigham,M,100,0,358,358
Dell,M,74,94,264,358
Dian,F,98,350,8,358
Malayah,F,100,358,0,358
Suzann,F,100,358,0,358
Tramaine,M,74,94,264,358
Trenten,M,100,0,358,358
Vidal,M,100,0,358,358
Brynne,F,100,357,0,357
Gracen,F,64,228,129,357
Jerrie,F,94,336,21,357
Joseline,F,100,357,0,357
Layna,F,100,357,0,357
Leyton,M,85,52,305,357
Brien,M,100,0,356,356
Carlyn,F,100,356,0,356
Colson,M,100,0,356,356
Dash,M,99,5,351,356
Javonte,M,100,0,356,356
Randel,M,100,0,356,356
Syreeta,F,100,356,0,356
Zulema,F,100,356,0,356
Anamaria,F,100,355,0,355
Annamaria,F,100,355,0,355
Aubriella,F,100,355,0,355
Audrie,F,100,355,0,355
Damarcus,M,100,0,355,355
Delisa,F,100,355,0,355
Jacki,F,100,355,0,355
Jenessa,F,100,355,0,355
Kallen,M,91,32,323,355
Maile,F,100,355,0,355
Mickie,F,83,296,59,355
Nichol,F,100,355,0,355
Rayyan,M,92,28,327,355
Rosalina,F,100,355,0,355
Adalee,F,100,354,0,354
Brynley,F,100,354,0,354
Burt,M,100,0,354,354
Sabine,F,100,354,0,354
Destany,F,100,353,0,353
Dorcas,F,100,353,0,353
Kamora,F,100,353,0,353
Kelis,F,98,347,6,353
Lita,F,100,353,0,353
Raine,F,87,308,45,353
Taytum,F,82,290,63,353
Ania,F,100,352,0,352
Britny,F,100,352,0,352
Caelyn,F,100,352,0,352
Davonte,M,100,0,352,352
Dequan,M,100,0,352,352
Desi,M,74,92,260,352
Jayse,M,99,5,347,352
Luiz,M,100,0,352,352
Arleth,F,100,351,0,351
Augustin,M,100,0,351,351
Brynna,F,100,351,0,351
Cherrie,F,100,351,0,351
Christel,F,100,351,0,351
Jennah,F,100,351,0,351
Joshuah,M,100,0,351,351
Kit,M,62,133,218,351
Massimo,M,100,0,351,351
Quenton,M,100,0,351,351
Sedrick,M,100,0,351,351
Coleton,M,100,0,350,350
Courtland,M,96,15,335,350
Enid,F,100,350,0,350
Kenleigh,F,100,350,0,350
Larkin,F,59,207,143,350
Lluvia,F,100,350,0,350
Makala,F,100,350,0,350
Zakaria,M,84,56,294,350
Ariela,F,100,349,0,349
Cloe,F,100,349,0,349
Damani,M,79,75,274,349
Davida,F,100,349,0,349
Debbra,F,100,349,0,349
Jolee,F,100,349,0,349
Madelin,F,100,349,0,349
Nereida,F,100,349,0,349
Omer,M,100,0,349,349
Pia,F,100,349,0,349
Saira,F,100,349,0,349
Amethyst,F,100,348,0,348
Demetra,F,100,348,0,348
Glynn,M,95,17,331,348
Herschel,M,100,0,348,348
Homero,M,100,0,348,348
Jaysen,M,100,0,348,348
Jeramie,M,100,0,348,348
Kierstin,F,100,348,0,348
Lexis,F,100,348,0,348
Margaux,F,100,348,0,348
Ramses,M,100,0,348,348
Sari,F,98,342,6,348
Skylynn,F,100,348,0,348
Trayvon,M,100,0,348,348
Zayd,M,100,0,348,348
Favian,M,100,0,347,347
Haidyn,F,80,277,70,347
Pepper,F,94,325,22,347
Rachele,F,100,347,0,347
Simran,F,93,324,23,347
Tomeka,F,100,347,0,347
Aniah,F,100,346,0,346
Araya,F,100,346,0,346
Armaan,M,100,0,346,346
Caryl,F,96,331,15,346
Erlinda,F,100,346,0,346
Julieann,F,100,346,0,346
Justyce,F,77,268,78,346
Kylin,M,58,147,199,346
Latavia,F,100,346,0,346
Lazarus,M,100,0,346,346
Michale,M,90,35,311,346
Rubin,M,100,0,346,346
Yanira,F,100,346,0,346
Angella,F,100,345,0,345
Annaleigh,F,100,345,0,345
Benjamen,M,100,0,345,345
Brantlee,M,87,46,299,345
Canyon,M,96,15,330,345
Eliyahu,M,100,0,345,345
Jodee,F,98,339,6,345
Mayte,F,100,345,0,345
Tenisha,F,100,345,0,345
Trudi,F,100,345,0,345
Autum,F,100,344,0,344
Beck,M,100,0,344,344
Creed,M,100,0,344,344
Deandrea,F,70,242,102,344
Izaac,M,100,0,344,344
Jacobo,M,100,0,344,344
Kaylea,F,100,344,0,344
Kinleigh,F,100,344,0,344
Lanita,F,100,344,0,344
Rami,M,94,19,325,344
Rashaun,M,94,20,324,344
Sameer,M,100,0,344,344
Tamatha,F,100,344,0,344
Amit,M,92,26,317,343
Berry,M,93,24,319,343
Brie,F,100,343,0,343
Haily,F,100,343,0,343
Kathlyn,F,100,343,0,343
Kelsy,F,100,343,0,343
Taliah,F,100,343,0,343
Tasia,F,100,343,0,343
Curtiss,M,100,0,342,342
Darrien,M,96,13,329,342
Dionte,M,100,0,342,342
Kaison,M,100,0,342,342
Lochlan,M,98,8,334,342
Makiya,F,100,342,0,342
Renato,M,98,6,336,342
Shaunna,F,100,342,0,342
Yusef,M,100,0,342,342
Antone,M,100,0,341,341
Breck,M,83,59,282,341
Janai,F,97,330,11,341
Jordi,M,94,20,321,341
Myesha,F,100,341,0,341
Payson,M,50,170,171,341
Abe,M,100,0,340,340
Clarke,M,77,77,263,340
Ewan,M,100,0,340,340
Krystin,F,100,340,0,340
Marek,M,100,0,340,340
Niles,M,100,0,340,340
Randee,F,90,307,33,340
Salome,F,92,312,28,340
Tahlia,F,100,340,0,340
Dejah,F,100,339,0,339
Demetrice,M,51,167,172,339
Erasmo,M,100,0,339,339
Ernestina,F,100,339,0,339
Lillyann,F,100,339,0,339
Louella,F,100,339,0,339
Maisy,F,100,339,0,339
Mariajose,F,100,339,0,339
Montez,M,96,13,326,339
Beatrix,F,100,338,0,338
Deanthony,M,100,0,338,338
Jet,M,98,7,331,338
Machelle,F,100,338,0,338
Trevion,M,100,0,338,338
Willy,M,100,0,338,338
Gabriele,F,75,252,85,337
Kylar,M,68,108,229,337
Ravi,M,100,0,337,337
Ritchie,M,100,0,337,337
Rolanda,F,100,337,0,337
Yahya,M,100,0,337,337
Zayn,M,100,0,337,337
Ani,F,100,336,0,336
Aryn,F,85,287,49,336
Bjorn,M,100,0,336,336
Honey,F,100,336,0,336
Job,M,100,0,336,336
Kayce,F,92,309,27,336
Keona,F,98,330,6,336
Leeanne,F,100,336,0,336
Raylynn,F,99,331,5,336
Amado,M,100,0,335,335
Cambree,F,100,335,0,335
Felice,F,93,312,23,335
Halo,F,87,290,45,335
Leilany,F,100,335,0,335
Violette,F,100,335,0,335
Butch,M,100,0,334,334
Divya,F,99,329,5,334
Khristian,M,87,42,292,334
Makaela,F,100,334,0,334
Marcelle,F,82,275,59,334
Orrin,M,100,0,334,334
Adia,F,100,333,0,333
Aniston,F,100,333,0,333
Apryl,F,100,333,0,333
Carri,F,100,333,0,333
Destinie,F,100,333,0,333
Emmerson,F,88,294,39,333
Gitty,F,100,333,0,333
Idris,M,98,5,328,333
Jovon,M,88,40,293,333
Maksim,M,100,0,333,333
Mayah,F,100,333,0,333
Samia,F,100,333,0,333
Shona,F,100,333,0,333
Timmie,M,95,16,317,333
Addalyn,F,100,332,0,332
Domenico,M,100,0,332,332
Franky,M,100,0,332,332
Jakub,M,100,0,332,332
Javan,M,98,6,326,332
Jazelle,F,100,332,0,332
Kaileigh,F,100,332,0,332
Kayleb,M,100,0,332,332
Leonora,F,100,332,0,332
Lianne,F,100,332,0,332
Margarito,M,100,0,332,332
Rebecka,F,100,332,0,332
Shalom,M,63,123,209,332
Smith,M,98,6,326,332
Tyla,F,100,332,0,332
Ariadna,F,100,331,0,331
Dwaine,M,100,0,331,331
Johannah,F,100,331,0,331
Marquel,M,91,30,301,331
Maylin,F,100,331,0,331
Dontrell,M,100,0,330,330
Keoni,M,93,24,306,330
Nazir,M,100,0,330,330
Rylin,F,65,216,114,330
Skylah,F,100,330,0,330
Tobi,F,80,263,67,330
Aletha,F,100,329,0,329
Anjanette,F,100,329,0,329
Ceasar,M,100,0,329,329
Chyanne,F,100,329,0,329
Cristi,F,100,329,0,329
Dempsey,M,87,44,285,329
Dustyn,M,98,6,323,329
Georgie,F,76,249,80,329
Gretta,F,100,329,0,329
Halee,F,100,329,0,329
Herlinda,F,100,329,0,329
Mazie,F,100,329,0,329
Amin,M,100,0,328,328
Aviva,F,100,328,0,328
Dafne,F,100,328,0,328
Felton,M,100,0,328,328
Jacen,M,100,0,328,328
Jacinta,F,100,328,0,328
Jaquelyn,F,100,328,0,328
Javian,M,98,6,322,328
Kavon,M,98,6,322,328
Nikia,F,96,316,12,328
Pandora,F,100,328,0,328
Torrie,F,85,280,48,328
Adilyn,F,100,327,0,327
Amora,F,100,327,0,327
Anaiah,F,100,327,0,327
Chip,M,100,0,327,327
Dashiell,M,100,0,327,327
Derrek,M,100,0,327,327
Elroy,M,100,0,327,327
Evans,M,95,17,310,327
Faigy,F,100,327,0,327
Madysen,F,100,327,0,327
Male,M,100,0,327,327
Shandra,F,100,327,0,327
Zaylee,F,100,327,0,327
Chayse,M,80,64,262,326
Mariya,F,100,326,0,326
Mykayla,F,100,326,0,326
Salomon,M,100,0,326,326
Simona,F,100,326,0,326
Tala,F,100,326,0,326
Torri,F,90,292,34,326
Tyce,M,100,0,326,326
Adilynn,F,100,325,0,325
Allana,F,100,325,0,325
Greer,F,80,261,64,325
Guinevere,F,100,325,0,325
Izaak,M,100,0,325,325
Jencarlos,M,100,0,325,325
Lexy,F,100,325,0,325
Meggan,F,100,325,0,325
Merri,F,100,325,0,325
Milissa,F,100,325,0,325
Najee,M,85,50,275,325
Roma,F,93,302,23,325
Tavion,M,100,0,325,325
Vannessa,F,100,325,0,325
Yaretzy,F,100,325,0,325
Agatha,F,100,324,0,324
Alliyah,F,100,324,0,324
Aysha,F,100,324,0,324
Ciarra,F,100,324,0,324
Elodie,F,100,324,0,324
Gianluca,M,100,0,324,324
Hampton,M,96,13,311,324
Kollin,M,100,0,324,324
Reign,F,69,222,102,324
Zayla,F,100,324,0,324
Addelyn,F,100,323,0,323
Emir,M,100,0,323,323
Juston,M,100,0,323,323
Kamal,M,100,0,323,323
Kathlene,F,100,323,0,323
Laquan,M,93,21,302,323
Magan,F,100,323,0,323
Shanaya,F,100,323,0,323
Taylen,M,55,144,179,323
Tesla,F,97,314,9,323
Zora,F,100,323,0,323
Amarion,M,100,0,322,322
Eben,M,100,0,322,322
Jaela,F,100,322,0,322
Joella,F,100,322,0,322
Kymberly,F,100,322,0,322
Laisha,F,100,322,0,322
Oskar,M,100,0,322,322
Peggie,F,100,322,0,322
Abygail,F,100,321,0,321
Avrohom,M,100,0,321,321
Baileigh,F,100,321,0,321
Beryl,F,85,273,48,321
Carisa,F,100,321,0,321
Dillion,M,100,0,321,321
Itzayana,F,100,321,0,321
Jameel,M,100,0,321,321
Kaili,F,100,321,0,321
Lesia,F,100,321,0,321
Lorne,M,100,0,321,321
Shan,M,73,88,233,321
Tionna,F,100,321,0,321
Adin,M,100,0,320,320
Amal,F,92,294,26,320
Andrey,M,97,11,309,320
Elli,F,100,320,0,320
Jianna,F,100,320,0,320
Jonny,M,100,0,320,320
Lillyan,F,100,320,0,320
Lino,M,100,0,320,320
Osiris,M,74,83,237,320
Raynard,M,100,0,320,320
Tamya,F,100,320,0,320
Wilford,M,100,0,320,320
Caelan,M,81,62,257,319
Daylon,M,100,0,319,319
Giulia,F,100,319,0,319
Jaye,F,66,210,109,319
Latia,F,100,319,0,319
Syncere,M,78,70,249,319
Arlin,M,72,88,230,318
Delicia,F,100,318,0,318
Dov,M,100,0,318,318
Eder,M,100,0,318,318
Elouise,F,100,318,0,318
Kaelin,F,75,240,78,318
Kavin,M,100,0,318,318
Kera,F,100,318,0,318
Kimani,F,51,161,157,318
Nour,F,81,257,61,318
Vinson,M,100,0,318,318
Aura,F,100,317,0,317
Candida,F,100,317,0,317
Christan,M,53,150,167,317
Codey,M,100,0,317,317
Gatlin,M,100,0,317,317
Geno,M,100,0,317,317
Imari,F,71,226,91,317
Madelyne,F,100,317,0,317
Mirian,F,100,317,0,317
Osman,M,100,0,317,317
Ronni,F,95,301,16,317
Sahil,M,100,0,317,317
Shawnna,F,100,317,0,317
Aayden,M,100,0,316,316
Angeles,F,98,310,6,316
Angely,F,100,316,0,316
Arion,M,76,77,239,316
Demetrios,M,100,0,316,316
Jad,M,100,0,316,316
Jere,M,79,66,250,316
Jovanna,F,100,316,0,316
Kalista,F,100,316,0,316
Les,M,100,0,316,316
Natosha,F,100,316,0,316
Nikolaus,M,100,0,316,316
Prudence,F,100,316,0,316
Sirena,F,100,316,0,316
Teresita,F,100,316,0,316
Zella,F,100,316,0,316
Annabeth,F,100,315,0,315
Armon,M,100,0,315,315
Cristen,F,97,304,11,315
Faris,M,100,0,315,315
Haywood,M,100,0,315,315
Jacqulyn,F,100,315,0,315
Jenae,F,100,315,0,315
Karisa,F,100,315,0,315
Karlene,F,100,315,0,315
Khiry,M,98,7,308,315
Kirra,F,100,315,0,315
Klarissa,F,100,315,0,315
Shia,M,67,104,211,315
Tenzin,M,58,132,183,315
Alonna,F,100,314,0,314
Armoni,F,62,196,118,314
Carrol,F,53,167,147,314
Chelsy,F,100,314,0,314
Claira,F,100,314,0,314
Ransom,M,100,0,314,314
Wally,M,100,0,314,314
Willem,M,100,0,314,314
Adler,M,90,30,283,313
Analy,F,100,313,0,313
Brayton,M,100,0,313,313
Corin,F,67,210,103,313
Daveon,M,98,6,307,313
Deisy,F,100,313,0,313
Delma,F,89,279,34,313
Evon,F,83,259,54,313
Ishan,M,100,0,313,313
Jamee,F,95,296,17,313
Jubilee,F,100,313,0,313
Kaily,F,100,313,0,313
Keyona,F,100,313,0,313
Kyren,M,95,16,297,313
Lamonte,M,100,0,313,313
Nilda,F,100,313,0,313
Rayleigh,F,100,313,0,313
Rosalba,F,100,313,0,313
Virgie,F,98,308,5,313
Zahara,F,100,313,0,313
Emoni,F,96,300,12,312
Irie,F,84,263,49,312
Nile,M,91,29,283,312
Rashida,F,100,312,0,312
Sheron,F,88,273,39,312
Shilo,F,69,215,97,312
Terron,M,97,10,302,312
Torrence,M,96,14,298,312
Armond,M,100,0,311,311
Charleston,M,80,63,248,311
Crissy,F,100,311,0,311
Deeann,F,100,311,0,311
Kenyetta,F,98,304,7,311
Lauretta,F,100,311,0,311
Pierson,M,100,0,311,311
Rustin,M,100,0,311,311
Rylynn,F,95,295,16,311
Torie,F,92,285,26,311
Yancy,M,84,51,260,311
Zia,F,87,272,39,311
Lanae,F,100,310,0,310
Lian,M,61,121,189,310
Milly,F,100,310,0,310
Samya,F,100,310,0,310
Soledad,F,98,305,5,310
Talitha,F,100,310,0,310
Yaseen,M,100,0,310,310
Ziva,F,100,310,0,310
Aleshia,F,100,309,0,309
Ashlea,F,100,309,0,309
Buford,M,100,0,309,309
Daryle,M,92,24,285,309
Greysen,M,90,30,279,309
Hartley,F,72,222,87,309
Janiece,F,100,309,0,309
Kristiana,F,100,309,0,309
Nisha,F,100,309,0,309
Talisha,F,100,309,0,309
Aarya,F,83,256,52,308
Debbi,F,100,308,0,308
Indigo,F,77,238,70,308
Katherin,F,100,308,0,308
Khari,M,74,81,227,308
Lex,M,100,0,308,308
Rashard,M,100,0,308,308
Taleah,F,100,308,0,308
Wynn,M,65,108,200,308
Zamir,M,100,0,308,308
Zenobia,F,100,308,0,308
Cayleigh,F,100,307,0,307
Che,M,87,41,266,307
Coltin,M,100,0,307,307
Daija,F,100,307,0,307
Eleanore,F,100,307,0,307
Emmaleigh,F,100,307,0,307
Genna,F,100,307,0,307
Jariel,M,98,7,300,307
Mirella,F,100,307,0,307
Niyah,F,100,307,0,307
Rayven,F,94,288,19,307
Sarena,F,100,307,0,307
Taylar,F,98,301,6,307
Aleksandra,F,100,306,0,306
Arlyn,F,61,188,118,306
Artie,M,76,73,233,306
Becca,F,100,306,0,306
Caylin,F,95,291,15,306
Danyel,F,71,218,88,306
Lennie,M,65,108,198,306
Madelaine,F,100,306,0,306
Sanjay,M,100,0,306,306
Seven,M,67,102,204,306
Steffanie,F,100,306,0,306
Vivaan,M,100,0,306,306
Ammar,M,100,0,305,305
Audie,M,83,52,253,305
Avion,M,87,41,264,305
Bryton,M,96,12,293,305
Chanell,F,100,305,0,305
Charlton,M,100,0,305,305
Delton,M,100,0,305,305
Geovanny,M,100,0,305,305
Laith,M,100,0,305,305
Muhammed,M,100,0,305,305
Shaneka,F,100,305,0,305
Talan,M,100,0,305,305
Woody,M,100,0,305,305
Ahmir,M,100,0,304,304
Allysa,F,100,304,0,304
Aryeh,M,100,0,304,304
Cady,F,100,304,0,304
Castiel,M,98,5,299,304
Chava,F,100,304,0,304
Dashaun,M,100,0,304,304
Jenise,F,100,304,0,304
Kary,F,57,173,131,304
Meridith,F,100,304,0,304
Nadya,F,100,304,0,304
Rosalynn,F,100,304,0,304
Tyana,F,100,304,0,304
Viktoria,F,100,304,0,304
Andrei,M,100,0,303,303
Aston,M,97,10,293,303
Breon,M,88,35,268,303
Candie,F,100,303,0,303
Ferdinand,M,100,0,303,303
Harmonie,F,100,303,0,303
Jairus,M,100,0,303,303
Lilyan,F,100,303,0,303
Noelani,F,100,303,0,303
Odis,M,100,0,303,303
Seraphina,F,100,303,0,303
Trish,F,100,303,0,303
Alvina,F,100,302,0,302
Arvin,M,100,0,302,302
Calliope,F,100,302,0,302
Daylan,M,93,22,280,302
Josias,M,100,0,302,302
Kenadee,F,100,302,0,302
Keturah,F,100,302,0,302
Khalia,F,100,302,0,302
Mccoy,M,98,7,295,302
Nallely,F,100,302,0,302
Prentice,M,100,0,302,302
Reta,F,100,302,0,302
Rolland,M,100,0,302,302
Sharif,M,98,5,297,302
Tanja,F,100,302,0,302
Vernita,F,100,302,0,302
Zendaya,F,100,302,0,302
Alistair,M,100,0,301,301
Faustino,M,100,0,301,301
Jailene,F,100,301,0,301
Kristel,F,100,301,0,301
Olen,M,100,0,301,301
Sahana,F,100,301,0,301
Tyrel,M,100,0,301,301
Vilma,F,100,301,0,301
Arik,M,100,0,300,300
Clover,F,100,300,0,300
Emry,F,72,215,85,300
Jarell,M,100,0,300,300
Kirstyn,F,100,300,0,300
Larae,F,100,300,0,300
Patric,M,96,11,289,300
Achilles,M,100,0,299,299
Dacia,F,100,299,0,299
Dev,M,100,0,299,299
Isac,M,100,0,299,299
Jaclynn,F,100,299,0,299
Josslyn,F,100,299,0,299
Keshaun,M,98,5,294,299
Lakota,F,53,159,140,299
Leisha,F,100,299,0,299
Mel,M,91,27,272,299
Shawanda,F,100,299,0,299
Tavares,M,100,0,299,299
Adley,F,86,255,43,298
Alishia,F,100,298,0,298
Ansel,M,100,0,298,298
Calleigh,F,100,298,0,298
Clemente,M,100,0,298,298
Conley,M,90,29,269,298
Dovid,M,100,0,298,298
Fox,M,98,7,291,298
Jame,M,82,54,244,298
Jamon,M,100,0,298,298
Lamarr,M,100,0,298,298
Regis,M,92,23,275,298
Candyce,F,100,297,0,297
Carma,F,100,297,0,297
Sebrina,F,100,297,0,297
Tito,M,100,0,297,297
Brion,M,98,5,291,296
Ciana,F,100,296,0,296
Dreama,F,100,296,0,296
Eliel,M,100,0,296,296
Gissel,F,100,296,0,296
Hyrum,M,100,0,296,296
Jonelle,F,98,291,5,296
Julee,F,100,296,0,296
Karyme,F,100,296,0,296
Lizet,F,100,296,0,296
Phylicia,F,100,296,0,296
Rome,M,92,24,272,296
Rondell,M,94,17,279,296
Aliyana,F,100,295,0,295
Baila,F,100,295,0,295
Domenick,M,100,0,295,295
Edmundo,M,100,0,295,295
Elda,F,100,295,0,295
Graydon,M,100,0,295,295
Hellen,F,100,295,0,295
Kobi,M,71,87,208,295
Koda,M,92,24,271,295
Meranda,F,100,295,0,295
Qiana,F,100,295,0,295
Sharita,F,100,295,0,295
Tallulah,F,100,295,0,295
Yamile,F,100,295,0,295
Anessa,F,100,294,0,294
Angelika,F,100,294,0,294
Arionna,F,100,294,0,294
Ashlin,F,95,279,15,294
Bryden,M,100,0,294,294
Christoper,M,100,0,294,294
Denae,F,100,294,0,294
Imogene,F,100,294,0,294
Italia,F,100,294,0,294
Jae,M,53,137,157,294
Janina,F,100,294,0,294
Kevyn,M,92,23,271,294
Kyndra,F,100,294,0,294
Lashay,F,100,294,0,294
Lonna,F,100,294,0,294
Madaline,F,100,294,0,294
Olyvia,F,100,294,0,294
Terance,M,100,0,294,294
Adnan,M,100,0,293,293
Angelena,F,100,293,0,293
Bethann,F,100,293,0,293
Corry,M,85,44,249,293
Finnian,M,100,0,293,293
Iain,M,100,0,293,293
Jalil,M,100,0,293,293
Jovie,F,100,293,0,293
Kerrigan,F,95,279,14,293
Lakyn,F,98,288,5,293
Laurene,F,100,293,0,293
Symphony,F,100,293,0,293
Tiago,M,100,0,293,293
Amarie,F,84,244,48,292
Jania,F,100,292,0,292
Jaziel,M,100,0,292,292
Laquisha,F,100,292,0,292
Shepherd,M,100,0,292,292
Shivani,F,100,292,0,292
Stefano,M,100,0,292,292
Tessie,F,100,292,0,292
Amerie,F,100,291,0,291
Bartholomew,M,100,0,291,291
Brittnie,F,100,291,0,291
Calen,M,93,20,271,291
Leobardo,M,100,0,291,291
Luci,F,100,291,0,291
Marah,F,100,291,0,291
Sherron,F,82,239,52,291
Taelyn,F,96,279,12,291
Yash,M,100,0,291,291
Brinlee,F,100,290,0,290
Broc,M,100,0,290,290
Canon,M,100,0,290,290
Jaeda,F,100,290,0,290
Jaila,F,100,290,0,290
Kaine,M,100,0,290,290
Krissy,F,100,290,0,290
Lacee,F,100,290,0,290
Lamarcus,M,100,0,290,290
Landin,M,100,0,290,290
Osbaldo,M,100,0,290,290
Abdulrahman,M,100,0,289,289
Alyna,F,100,289,0,289
Avril,F,100,289,0,289
Brianda,F,98,284,5,289
Daven,M,93,21,268,289
Inga,F,100,289,0,289
Mahlon,M,100,0,289,289
Marlys,F,100,289,0,289
Renaldo,M,100,0,289,289
Shaye,F,79,229,60,289
Taisha,F,100,289,0,289
Tamala,F,100,289,0,289
Abriana,F,100,288,0,288
Carletta,F,100,288,0,288
Catarina,F,100,288,0,288
Christain,M,86,40,248,288
Christos,M,100,0,288,288
Elexis,F,100,288,0,288
Fanny,F,100,288,0,288
Jazzmine,F,100,288,0,288
Kyah,F,100,288,0,288
Melynda,F,100,288,0,288
Terell,M,98,5,283,288
Umar,M,100,0,288,288
Zaden,M,100,0,288,288
Azriel,M,76,68,219,287
Catelyn,F,100,287,0,287
Cianna,F,100,287,0,287
Deshon,M,94,18,269,287
Jalon,M,97,8,279,287
Jamiah,F,88,252,35,287
Kady,F,100,287,0,287
Keion,M,100,0,287,287
Kierstyn,F,100,287,0,287
Martika,F,100,287,0,287
Nickole,F,100,287,0,287
Rand,M,93,19,268,287
Sindy,F,100,287,0,287
Alphonse,M,100,0,286,286
Eleanora,F,100,286,0,286
Esau,M,100,0,286,286
Karey,F,78,224,62,286
Klayton,M,100,0,286,286
Loreen,F,100,286,0,286
Morgen,F,76,218,68,286
Perri,F,94,269,17,286
Tyasia,F,100,286,0,286
Anja,F,100,285,0,285
Cedar,M,55,127,158,285
Clarisa,F,100,285,0,285
Darvin,M,100,0,285,285
Deante,M,100,0,285,285
Emelyn,F,100,285,0,285
Lachelle,F,100,285,0,285
Myia,F,100,285,0,285
Raizy,F,100,285,0,285
Raniyah,F,100,285,0,285
Alona,F,100,284,0,284
Brayleigh,F,100,284,0,284
Cassaundra,F,100,284,0,284
Devaughn,M,100,0,284,284
Domonic,M,98,5,279,284
Jermey,M,100,0,284,284
Josephina,F,100,284,0,284
Kamaria,F,100,284,0,284
Kerstin,F,100,284,0,284
Lake,M,78,62,222,284
Rance,M,100,0,284,284
Reena,F,100,284,0,284
Tyreek,M,100,0,284,284
Alaric,M,100,0,283,283
Bianka,F,100,283,0,283
Carsten,M,100,0,283,283
Davie,M,82,50,233,283
Gisel,F,100,283,0,283
Jiselle,F,100,283,0,283
Kamran,M,96,10,273,283
Kateri,F,100,283,0,283
Mykah,F,57,162,121,283
Peri,F,98,278,5,283
Tavian,M,100,0,283,283
Zina,F,100,283,0,283
Auston,M,100,0,282,282
Cam,M,88,34,248,282
Chayce,M,88,34,248,282
Darline,F,100,282,0,282
Davey,M,96,11,271,282
Dimitrios,M,100,0,282,282
Iona,F,100,282,0,282
Jocelin,F,100,282,0,282
Klara,F,100,282,0,282
Lyman,M,100,0,282,282
Rebeka,F,100,282,0,282
Serene,F,100,282,0,282
Vincente,M,100,0,282,282
Anali,F,100,281,0,281
Brandin,M,98,7,274,281
Brylie,F,100,281,0,281
Cairo,M,90,28,253,281
Caterina,F,100,281,0,281
Jaymes,M,100,0,281,281
Magda,F,100,281,0,281
Mahmoud,M,100,0,281,281
Marshawn,M,98,6,275,281
Myriam,F,100,281,0,281
Phineas,M,100,0,281,281
Vianney,F,100,281,0,281
Wolfgang,M,100,0,281,281
Anas,M,100,0,280,280
Elgin,M,100,0,280,280
Fausto,M,100,0,280,280
Idalia,F,100,280,0,280
Jeshua,M,100,0,280,280
Rayford,M,100,0,280,280
Tiesha,F,100,280,0,280
Briseida,F,100,279,0,279
Carman,F,84,234,45,279
Corliss,F,97,272,7,279
Damen,M,100,0,279,279
Devona,F,100,279,0,279
Imogen,F,100,279,0,279
Kaytlyn,F,100,279,0,279
Maryn,F,100,279,0,279
Tonie,F,91,255,24,279
Zuriel,M,80,55,224,279
Aleyda,F,100,278,0,278
Deonta,M,100,0,278,278
Elba,F,100,278,0,278
Gaylon,M,94,16,262,278
Jenell,F,100,278,0,278
Kandis,F,100,278,0,278
Maliya,F,100,278,0,278
Martell,M,100,0,278,278
Melodee,F,100,278,0,278
Nicol,F,98,273,5,278
Nika,F,100,278,0,278
Samaya,F,100,278,0,278
Serafina,F,100,278,0,278
Shawnda,F,100,278,0,278
Alida,F,100,277,0,277
Alpha,M,61,108,169,277
Coretta,F,100,277,0,277
Fransisco,M,100,0,277,277
Gracey,F,100,277,0,277
Isobel,F,100,277,0,277
Jaret,M,100,0,277,277
Jaslynn,F,100,277,0,277
Jenniffer,F,100,277,0,277
Jethro,M,100,0,277,277
Keilani,F,100,277,0,277
Marli,F,100,277,0,277
Renard,M,100,0,277,277
Sacha,F,84,234,43,277
Skylee,F,100,277,0,277
Tiffaney,F,100,277,0,277
Varun,M,100,0,277,277
Arlie,M,76,67,209,276
Arsenio,M,100,0,276,276
Ashten,M,55,123,153,276
Atreyu,M,100,0,276,276
Donya,F,93,258,18,276
Jannet,F,100,276,0,276
Jarren,M,100,0,276,276
Karime,F,100,276,0,276
Loran,M,63,103,173,276
Malaika,F,100,276,0,276
Malek,M,100,0,276,276
Pamella,F,100,276,0,276
Sanjana,F,100,276,0,276
Amauri,M,74,71,204,275
Caley,F,95,261,14,275
Chynna,F,100,275,0,275
Emmit,M,100,0,275,275
Female,F,100,275,0,275
Kathaleen,F,100,275,0,275
Kc,M,69,85,190,275
Larhonda,F,100,275,0,275
Tiffiny,F,100,275,0,275
Zaina,F,100,275,0,275
Briza,F,100,274,0,274
Cathi,F,100,274,0,274
Chadd,M,100,0,274,274
Charolette,F,100,274,0,274
Earle,M,100,0,274,274
Ilan,M,96,10,264,274
Jeni,F,100,274,0,274
Kacee,F,92,251,23,274
Makiah,F,84,229,45,274
Neftali,M,85,41,233,274
Neo,M,100,0,274,274
Robinson,M,100,0,274,274
Ameera,F,100,273,0,273
Dakari,M,92,21,252,273
Eian,M,100,0,273,273
Kelcey,F,75,204,69,273
Kenadie,F,100,273,0,273
San,F,74,202,71,273
Sharen,F,100,273,0,273
Tammara,F,100,273,0,273
Yuna,F,100,273,0,273
Bayley,F,81,221,51,272
Brynleigh,F,100,272,0,272
Ilona,F,100,272,0,272
Judie,F,100,272,0,272
Kaniya,F,100,272,0,272
Kiernan,M,76,66,206,272
Makinley,F,100,272,0,272
Melvina,F,100,272,0,272
Micayla,F,100,272,0,272
Nana,F,67,182,90,272
Noam,M,93,20,252,272
Parrish,M,89,30,242,272
Reno,M,100,0,272,272
Tyrek,M,100,0,272,272
Wayde,M,100,0,272,272
Aaryn,F,66,179,92,271
Adair,M,52,129,142,271
Akilah,F,100,271,0,271
Amador,M,100,0,271,271
Arica,F,100,271,0,271
Baxter,M,100,0,271,271
Brooklin,F,100,271,0,271
Chancellor,M,100,0,271,271
Dejon,M,98,5,266,271
Jasleen,F,100,271,0,271
Kamarion,M,100,0,271,271
Kyli,F,100,271,0,271
Maceo,M,100,0,271,271
Makyla,F,100,271,0,271
Malea,F,100,271,0,271
Mattison,F,92,250,21,271
Tanvi,F,100,271,0,271
Becki,F,100,270,0,270
Beyonce,F,100,270,0,270
Cambrie,F,100,270,0,270
Citlaly,F,100,270,0,270
Kaedyn,M,69,83,187,270
Korina,F,100,270,0,270
Lashunda,F,100,270,0,270
Lynell,F,67,181,89,270
Otha,M,91,23,247,270
Philippe,M,100,0,270,270
Ronnell,M,93,19,251,270
Shaylynn,F,100,270,0,270
Susann,F,100,270,0,270
Yakov,M,100,0,270,270
Alasia,F,100,269,0,269
Aleyah,F,100,269,0,269
Daja,F,100,269,0,269
Elam,M,100,0,269,269
Huey,M,100,0,269,269
Jailynn,F,97,261,8,269
Kailah,F,100,269,0,269
Kiesha,F,100,269,0,269
Nayla,F,100,269,0,269
Reginal,M,100,0,269,269
Salman,M,100,0,269,269
Shaylyn,F,100,269,0,269
Tashia,F,100,269,0,269
Tylar,M,53,126,143,269
Zoee,F,100,269,0,269
Aadhya,F,100,268,0,268
Adella,F,100,268,0,268
Carver,M,100,0,268,268
Demari,M,92,22,246,268
Derrik,M,100,0,268,268
Flavio,M,100,0,268,268
Hansel,M,100,0,268,268
Jaziah,M,57,115,153,268
Kanesha,F,100,268,0,268
Kenlee,F,100,268,0,268
Kodie,M,54,122,146,268
Lael,F,73,195,73,268
Nicklas,M,100,0,268,268
Richmond,M,100,0,268,268
Vita,F,100,268,0,268
Aarna,F,100,267,0,267
Casper,M,100,0,267,267
Chesney,F,91,242,25,267
Cosette,F,100,267,0,267
Dickie,M,96,12,255,267
Jaedon,M,98,5,262,267
Kahlan,F,98,262,5,267
Kaniyah,F,100,267,0,267
Kaycie,F,100,267,0,267
Kecia,F,100,267,0,267
Kelle,F,98,262,5,267
Korben,M,100,0,267,267
Micky,M,81,52,215,267
Miesha,F,100,267,0,267
Nakita,F,100,267,0,267
Nolen,M,98,5,262,267
Rojelio,M,100,0,267,267
Sherwin,M,100,0,267,267
Yazmine,F,100,267,0,267
Benicio,M,100,0,266,266
Eisley,F,100,266,0,266
Farrell,M,88,31,235,266
Kalena,F,100,266,0,266
Kennadi,F,100,266,0,266
Nidia,F,100,266,0,266
Quincey,M,71,76,190,266
Ramone,M,100,0,266,266
Shamya,F,100,266,0,266
Siri,F,100,266,0,266
Vernice,F,91,243,23,266
Zipporah,F,100,266,0,266
Arika,F,100,265,0,265
Beckie,F,100,265,0,265
Cienna,F,100,265,0,265
Daniell,F,64,170,95,265
Dezirae,F,100,265,0,265
Janett,F,100,265,0,265
Joie,F,95,252,13,265
Kamil,M,78,59,206,265
Khai,M,86,37,228,265
Kolt,M,100,0,265,265
Kynleigh,F,100,265,0,265
Lyrik,F,61,161,104,265
Macayla,F,100,265,0,265
Nils,M,100,0,265,265
Onyx,M,67,88,177,265
Taron,M,98,5,260,265
Zola,F,100,265,0,265
Aksel,M,100,0,264,264
Ara,F,67,177,87,264
Berta,F,100,264,0,264
Delila,F,100,264,0,264
Dennie,M,84,42,222,264
Dontay,M,100,0,264,264
Kamilla,F,100,264,0,264
Marylin,F,100,264,0,264
Maxie,M,65,92,172,264
Micha,M,51,129,135,264
Osiel,M,100,0,264,264
Porsche,F,100,264,0,264
Sal,M,100,0,264,264
Tavin,M,97,8,256,264
Terrel,M,96,10,254,264
Ashia,F,100,263,0,263
Emalyn,F,100,263,0,263
Flint,M,100,0,263,263
Journi,F,100,263,0,263
Karrington,F,87,229,34,263
Lakendra,F,100,263,0,263
Lavell,M,98,5,258,263
Legacy,F,74,194,69,263
Reynold,M,100,0,263,263
Synthia,F,100,263,0,263
Tyreese,M,100,0,263,263
Wardell,M,100,0,263,263
Angelie,F,100,262,0,262
Angelyn,F,100,262,0,262
Audry,F,98,257,5,262
Camelia,F,100,262,0,262
Denita,F,100,262,0,262
Diesel,M,100,0,262,262
Dixon,M,100,0,262,262
Jesslyn,F,100,262,0,262
Kendric,M,100,0,262,262
Marely,F,100,262,0,262
Mychal,M,89,29,233,262
Odalis,F,100,262,0,262
Raj,M,100,0,262,262
Tru,M,61,101,161,262
Tuesday,F,100,262,0,262
Abbi,F,100,261,0,261
Aram,M,98,5,256,261
Demonte,M,100,0,261,261
Devonta,M,100,0,261,261
Janetta,F,100,261,0,261
Jaymee,F,100,261,0,261
Kattie,F,100,261,0,261
Kenda,F,100,261,0,261
Khaled,M,100,0,261,261
Letty,F,100,261,0,261
Lovely,F,100,261,0,261
Marivel,F,100,261,0,261
Shaquille,M,87,35,226,261
Tadeo,M,100,0,261,261
Tari,F,98,256,5,261
Thomasina,F,100,261,0,261
Velvet,F,100,261,0,261
Yonatan,M,100,0,261,261
Anitra,F,100,260,0,260
Antwain,M,100,0,260,260
Baltazar,M,100,0,260,260
Berlin,F,80,209,51,260
Dawne,F,100,260,0,260
Diandra,F,100,260,0,260
Jacquelyne,F,100,260,0,260
Jashawn,M,98,5,255,260
Kainoa,M,96,11,249,260
Kaira,F,100,260,0,260
Lux,F,80,208,52,260
Natashia,F,100,260,0,260
Nayely,F,100,260,0,260
Romel,M,100,0,260,260
Shanel,F,100,260,0,260
Siera,F,100,260,0,260
Somer,F,100,260,0,260
Abbigale,F,100,259,0,259
Blas,M,100,0,259,259
Bracha,F,100,259,0,259
Danni,F,96,249,10,259
Decker,M,98,5,254,259
Devora,F,100,259,0,259
Gema,F,100,259,0,259
Jacorey,M,100,0,259,259
Janya,F,100,259,0,259
Julienne,F,98,254,5,259
Milla,F,100,259,0,259
Raelene,F,100,259,0,259
Rashid,M,100,0,259,259
Steele,M,98,5,254,259
Tehya,F,100,259,0,259
Zach,M,100,0,259,259
Aila,F,100,258,0,258
Aislynn,F,100,258,0,258
Andree,F,58,150,108,258
Arianny,F,100,258,0,258
Athan,M,100,0,258,258
Callista,F,100,258,0,258
Carolyne,F,100,258,0,258
Cashton,M,100,0,258,258
Jahmir,M,100,0,258,258
Jennette,F,100,258,0,258
Johnetta,F,100,258,0,258
Landan,M,100,0,258,258
Laticia,F,100,258,0,258
Penni,F,100,258,0,258
Riana,F,100,258,0,258
Aman,M,96,9,248,257
Anwar,M,94,16,241,257
Deedra,F,100,257,0,257
Devontae,M,100,0,257,257
Fabio,M,100,0,257,257
Kiefer,M,100,0,257,257
Lavelle,M,81,49,208,257
Lawerence,M,100,0,257,257
Marlana,F,100,257,0,257
Marlow,M,56,112,145,257
Rock,M,100,0,257,257
Sampson,M,100,0,257,257
Sherrell,F,100,257,0,257
Alessa,F,100,256,0,256
Amaiya,F,100,256,0,256
Brooklynne,F,100,256,0,256
Charline,F,100,256,0,256
Chole,F,100,256,0,256
Daysha,F,100,256,0,256
Duwayne,M,100,0,256,256
Isael,M,100,0,256,256
Kaeli,F,100,256,0,256
Kaliah,F,100,256,0,256
Keana,F,100,256,0,256
Khamari,M,78,56,200,256
Macee,F,100,256,0,256
Martine,F,87,223,33,256
Mckay,M,88,30,226,256
Mikaila,F,100,256,0,256
Newton,M,100,0,256,256
Nyomi,F,100,256,0,256
Renada,F,100,256,0,256
Roddy,M,100,0,256,256
Saad,M,100,0,256,256
Saray,F,100,256,0,256
Travion,M,100,0,256,256
Yasin,M,100,0,256,256
Yeshua,M,100,0,256,256
Abdirahman,M,100,0,255,255
Anh,F,70,179,76,255
Aramis,M,91,23,232,255
Ashwin,M,100,0,255,255
Babette,F,100,255,0,255
Corrin,F,98,249,6,255
Daijah,F,100,255,0,255
Emeline,F,100,255,0,255
Fayth,F,100,255,0,255
Jaxsen,M,100,0,255,255
Jeb,M,100,0,255,255
Joscelyn,F,100,255,0,255
Kylene,F,100,255,0,255
Lainie,F,100,255,0,255
Lakia,F,100,255,0,255
Lavinia,F,100,255,0,255
Raylen,M,64,93,162,255
Tyran,M,100,0,255,255
Yana,F,100,255,0,255
Yovani,M,100,0,255,255
Barrie,F,74,188,66,254
Bertram,M,100,0,254,254
Chayton,M,100,0,254,254
Cherokee,F,90,228,26,254
Hadi,M,100,0,254,254
Hayward,M,100,0,254,254
Issa,M,78,56,198,254
Jaina,F,100,254,0,254
Josalyn,F,100,254,0,254
Latoria,F,100,254,0,254
Lura,F,100,254,0,254
Marwa,F,100,254,0,254
Mathieu,M,100,0,254,254
Mendel,M,100,0,254,254
Preslie,F,100,254,0,254
Vivianne,F,100,254,0,254
Xenia,F,100,254,0,254
Yasir,M,100,0,254,254
Adara,F,100,253,0,253
Amor,F,83,209,44,253
Anette,F,100,253,0,253
Candance,F,100,253,0,253
Jaelin,M,59,104,149,253
Jenson,M,98,5,248,253
Jones,M,100,0,253,253
Kerwin,M,100,0,253,253
Molli,F,100,253,0,253
Mose,M,100,0,253,253
Parth,M,100,0,253,253
Rebekka,F,100,253,0,253
Sinai,F,94,237,16,253
Yesica,F,100,253,0,253
Ambar,F,98,247,5,252
Arley,M,77,59,193,252
Arwen,F,100,252,0,252
Camellia,F,100,252,0,252
Chasen,M,100,0,252,252
Crawford,M,98,6,246,252
Daina,F,100,252,0,252
Danniel,M,93,17,235,252
Emiliana,F,100,252,0,252
Geraldo,M,100,0,252,252
Jaxx,M,100,0,252,252
Jenine,F,100,252,0,252
Ledger,M,100,0,252,252
Leslye,F,100,252,0,252
Maddix,M,89,27,225,252
Meri,F,100,252,0,252
Miabella,F,100,252,0,252
Shantelle,F,100,252,0,252
Analeigh,F,100,251,0,251
Anthoney,M,100,0,251,251
Asma,F,100,251,0,251
Everlee,F,100,251,0,251
Gearld,M,98,5,246,251
Kadie,F,100,251,0,251
Kathyrn,F,100,251,0,251
Kavya,F,98,245,6,251
Keesha,F,100,251,0,251
Laronda,F,100,251,0,251
Lavina,F,100,251,0,251
Osmar,M,100,0,251,251
Velda,F,100,251,0,251
Aamir,M,100,0,250,250
Adriano,M,100,0,250,250
Bethel,F,92,231,19,250
Deklan,M,100,0,250,250
Geronimo,M,100,0,250,250
Kyrah,F,100,250,0,250
Lezlie,F,100,250,0,250
Melaine,F,100,250,0,250
Shai,M,51,122,128,250
Shedrick,M,100,0,250,250
Taha,M,100,0,250,250
Tomi,F,100,250,0,250
Vania,F,100,250,0,250
Wendie,F,100,250,0,250
Wilder,M,94,14,236,250
Zebulon,M,100,0,250,250
Amilia,F,100,249,0,249
Anayeli,F,100,249,0,249
Boaz,M,100,0,249,249
Buster,M,100,0,249,249
Carolee,F,100,249,0,249
Courtnie,F,100,249,0,249
Demarius,M,100,0,249,249
Dmitri,M,100,0,249,249
Jamell,M,100,0,249,249
Jeanene,F,100,249,0,249
Kinzley,F,100,249,0,249
Stephania,F,100,249,0,249
Teanna,F,100,249,0,249
Zaylen,M,98,6,243,249
Amaria,F,100,248,0,248
Bryar,M,81,48,200,248
Caeden,M,100,0,248,248
Denim,M,78,55,193,248
Dia,F,98,243,5,248
Dorsey,M,83,41,207,248
Jajuan,M,100,0,248,248
Khloee,F,100,248,0,248
Kiyah,F,100,248,0,248
Lafayette,M,100,0,248,248
Long,M,100,0,248,248
Marika,F,100,248,0,248
Monae,F,100,248,0,248
Naila,F,100,248,0,248
Porfirio,M,100,0,248,248
Raeleigh,F,100,248,0,248
Ragan,F,82,203,45,248
Ryen,M,61,97,151,248
Shaquita,F,100,248,0,248
Stoney,M,100,0,248,248
Waymon,M,100,0,248,248
Zarah,F,100,248,0,248
Zenaida,F,100,248,0,248
Adiel,M,92,20,227,247
Alexavier,M,100,0,247,247
Anaiya,F,100,247,0,247
Chassity,F,100,247,0,247
Hardy,M,100,0,247,247
Pernell,M,95,12,235,247
Rafe,M,100,0,247,247
Rainey,F,88,217,30,247
Sammuel,M,100,0,247,247
Shakia,F,100,247,0,247
Shaquan,M,79,53,194,247
Suellen,F,100,247,0,247
Talmadge,M,100,0,247,247
Tisa,F,100,247,0,247
Xavion,M,100,0,247,247
Adelia,F,100,246,0,246
An,F,56,138,108,246
Anai,F,100,246,0,246
Carys,F,100,246,0,246
Denna,F,100,246,0,246
Dewitt,M,100,0,246,246
Evolet,F,100,246,0,246
Indiana,F,56,137,109,246
Indira,F,100,246,0,246
Jakai,M,92,19,227,246
Joell,M,64,88,158,246
Katey,F,100,246,0,246
Kimi,F,78,193,53,246
Lettie,F,100,246,0,246
Payden,M,62,94,152,246
Shanique,F,100,246,0,246
Thane,M,100,0,246,246
Alene,F,100,245,0,245
Bernita,F,100,245,0,245
Filip,M,100,0,245,245
Jacinto,M,100,0,245,245
Jacklynn,F,100,245,0,245
Jazzmin,F,100,245,0,245
Jeron,M,100,0,245,245
Kasi,F,98,240,5,245
Kelci,F,100,245,0,245
Koa,M,85,36,209,245
Lamya,F,100,245,0,245
Lory,F,92,225,20,245
Marcelina,F,100,245,0,245
Micki,F,97,238,7,245
Philomena,F,100,245,0,245
Ravyn,F,100,245,0,245
Rayvon,M,96,11,234,245
Rosio,F,100,245,0,245
Sven,M,100,0,245,245
Tavia,F,100,245,0,245
Wayland,M,100,0,245,245
Christene,F,100,244,0,244
Darcey,F,95,231,13,244
Eason,M,100,0,244,244
Elie,M,86,34,210,244
Jayven,M,100,0,244,244
Masyn,M,73,65,179,244
Sahar,F,100,244,0,244
Samone,F,100,244,0,244
Shaan,M,100,0,244,244
Sherwood,M,100,0,244,244
Talisa,F,100,244,0,244
Tavaris,M,100,0,244,244
Yariel,M,98,5,239,244
Aime,F,100,243,0,243
Asya,F,100,243,0,243
Ayman,M,98,5,238,243
Berkeley,F,79,191,52,243
Chadrick,M,100,0,243,243
Chasidy,F,100,243,0,243
Demetric,M,84,38,205,243
Ela,F,100,243,0,243
Esequiel,M,100,0,243,243
Jacari,M,98,6,237,243
Jahlil,M,100,0,243,243
Janelly,F,100,243,0,243
Kaydee,F,100,243,0,243
Markayla,F,100,243,0,243
Refugio,M,97,8,235,243
Samari,F,71,173,70,243
Santa,F,100,243,0,243
Tomika,F,100,243,0,243
Adalie,F,100,242,0,242
Alen,M,100,0,242,242
Anabell,F,100,242,0,242
Aspyn,F,100,242,0,242
Cally,F,100,242,0,242
Hafsa,F,100,242,0,242
Hakim,M,100,0,242,242
Heide,F,100,242,0,242
Jahir,M,100,0,242,242
Kimberely,F,100,242,0,242
Laramie,M,59,99,143,242
Notnamed,M,51,119,123,242
Reyansh,M,100,0,242,242
Shena,F,100,242,0,242
Sinead,F,100,242,0,242
Artemio,M,100,0,241,241
Ashtin,M,56,107,134,241
Danisha,F,100,241,0,241
Davy,M,94,14,227,241
Drayden,M,100,0,241,241
Jamaya,F,100,241,0,241
Jamere,M,100,0,241,241
Jannah,F,100,241,0,241
Joetta,F,100,241,0,241
Kabir,M,100,0,241,241
Kruz,M,100,0,241,241
Lashon,F,71,171,70,241
Lexington,F,63,152,89,241
Mecca,F,90,217,24,241
Prisha,F,100,241,0,241
Wilber,M,100,0,241,241
Willian,M,100,0,241,241
Aharon,M,100,0,240,240
Akiva,M,100,0,240,240
Alexsandra,F,100,240,0,240
Braxtyn,M,87,31,209,240
Fischer,M,100,0,240,240
Jiovanni,M,100,0,240,240
Juanpablo,M,100,0,240,240
Krystian,M,72,68,172,240
Lucus,M,100,0,240,240
Milah,F,100,240,0,240
Yehoshua,M,100,0,240,240
Daelyn,F,62,149,90,239
Elon,M,78,53,186,239
Evander,M,100,0,239,239
Kloey,F,100,239,0,239
Lannie,M,68,77,162,239
Maddex,M,100,0,239,239
Nakisha,F,100,239,0,239
Sunni,F,100,239,0,239
Tarra,F,100,239,0,239
Analee,F,100,238,0,238
Burl,M,100,0,238,238
Clive,M,100,0,238,238
Jeancarlos,M,100,0,238,238
Kolin,M,100,0,238,238
Lu,F,100,238,0,238
Lynelle,F,100,238,0,238
Markeith,M,100,0,238,238
Roselynn,F,100,238,0,238
Sabrena,F,100,238,0,238
Shaquana,F,100,238,0,238
Teodoro,M,100,0,238,238
Vonnie,F,94,223,15,238
Bronx,M,98,5,232,237
Carmello,M,100,0,237,237
Danyell,F,86,203,34,237
Javin,M,100,0,237,237
Jereme,M,100,0,237,237
Katrice,F,100,237,0,237
Maris,F,90,213,24,237
Nevada,F,63,149,88,237
Novalee,F,100,237,0,237
Solange,F,100,237,0,237
Talen,M,95,12,225,237
Tatiyana,F,100,237,0,237
Yocheved,F,100,237,0,237
Yuridia,F,100,237,0,237
Abhinav,M,100,0,236,236
Antwone,M,100,0,236,236
Bryer,M,90,24,212,236
Darold,M,100,0,236,236
Dayla,F,100,236,0,236
Desirea,F,100,236,0,236
Dwane,M,100,0,236,236
Gabino,M,100,0,236,236
Jenee,F,100,236,0,236
Kashton,M,100,0,236,236
Kaydin,M,75,60,176,236
Kayne,M,100,0,236,236
Nariyah,F,100,236,0,236
Regena,F,100,236,0,236
Sahasra,F,100,236,0,236
True,M,61,92,144,236
Uziel,M,100,0,236,236
Aayan,M,100,0,235,235
Ambria,F,100,235,0,235
Aysia,F,100,235,0,235
Gorge,M,100,0,235,235
Jorja,F,100,235,0,235
Karlos,M,100,0,235,235
Kezia,F,100,235,0,235
Lashaun,F,51,121,114,235
Leeroy,M,100,0,235,235
Leyna,F,100,235,0,235
Lovell,M,95,12,223,235
Malky,F,100,235,0,235
Merrie,F,100,235,0,235
Rebbecca,F,100,235,0,235
Rhylee,F,89,210,25,235
Shaya,M,56,103,132,235
Stefania,F,100,235,0,235
Timber,F,64,151,84,235
Una,F,100,235,0,235
Zoraida,F,100,235,0,235
Azalia,F,100,234,0,234
Charise,F,100,234,0,234
Demetrio,M,100,0,234,234
Ebonie,F,100,234,0,234
Eitan,M,100,0,234,234
Filiberto,M,100,0,234,234
Harmon,M,100,0,234,234
Jerrick,M,100,0,234,234
Karmyn,F,100,234,0,234
Markie,F,80,187,47,234
Neely,F,98,229,5,234
Rani,F,85,198,36,234
Romello,M,100,0,234,234
Rori,F,100,234,0,234
Tamyra,F,100,234,0,234
Adalia,F,100,233,0,233
Addalynn,F,100,233,0,233
Brando,M,100,0,233,233
Chloee,F,100,233,0,233
Cinnamon,F,100,233,0,233
Eternity,F,100,233,0,233
Ethyn,M,100,0,233,233
Kieth,M,100,0,233,233
Layan,F,100,233,0,233
Minh,M,91,20,213,233
Oziel,M,100,0,233,233
Rivers,M,63,86,147,233
Ruger,M,100,0,233,233
Samar,F,53,124,109,233
Sunday,F,100,233,0,233
Allissa,F,100,232,0,232
Asiah,F,84,194,38,232
Dietrich,M,94,15,217,232
Jaheim,M,100,0,232,232
Jaquez,M,100,0,232,232
Johny,M,100,0,232,232
Kataleya,F,100,232,0,232
Kobie,M,81,45,187,232
Krisha,F,100,232,0,232
Phillis,F,100,232,0,232
Price,M,100,0,232,232
Raechel,F,100,232,0,232
Sharleen,F,100,232,0,232
Taven,M,98,5,227,232
Alston,M,100,0,231,231
Auden,M,70,70,161,231
Dann,F,55,127,104,231
Dayle,F,75,174,57,231
Donavin,M,100,0,231,231
Glinda,F,100,231,0,231
Jamesha,F,100,231,0,231
Jamilah,F,100,231,0,231
Karlyn,F,100,231,0,231
Kaylei,F,100,231,0,231
Latrina,F,100,231,0,231
Lessie,F,88,203,28,231
Lise,F,100,231,0,231
Malisa,F,100,231,0,231
Maryah,F,100,231,0,231
Niesha,F,100,231,0,231
Ozzie,M,95,11,220,231
Passion,F,100,231,0,231
Tyren,M,100,0,231,231
Arnaldo,M,100,0,230,230
Demian,M,100,0,230,230
Detra,F,100,230,0,230
Gwyn,F,95,218,12,230
Haydn,M,87,31,199,230
Hortencia,F,100,230,0,230
Mick,M,100,0,230,230
Mikeal,M,100,0,230,230
Nels,M,100,0,230,230
Saleem,M,100,0,230,230
Sanjuana,F,100,230,0,230
September,F,100,230,0,230
Sharyl,F,100,230,0,230
Tova,F,100,230,0,230
Xitlali,F,100,230,0,230
Zephyr,M,83,39,191,230
Caysen,M,95,11,218,229
Delaine,F,86,197,32,229
Garren,M,100,0,229,229
Gisell,F,100,229,0,229
Glendon,M,100,0,229,229
Kalei,F,92,211,18,229
Lakin,F,79,181,48,229
Pascual,M,100,0,229,229
Rosana,F,100,229,0,229
Sandie,F,100,229,0,229
Shalyn,F,100,229,0,229
Tanaya,F,100,229,0,229
Tylee,F,79,181,48,229
Adamari,F,100,228,0,228
Anay,M,61,89,139,228
Baleigh,F,100,228,0,228
Christiane,F,100,228,0,228
Desiray,F,100,228,0,228
Emeri,F,96,220,8,228
Fatoumata,F,100,228,0,228
Grayden,M,100,0,228,228
Janise,F,100,228,0,228
Jessiah,M,83,38,190,228
Johna,F,100,228,0,228
Karisma,F,100,228,0,228
Kilee,F,100,228,0,228
Kipp,M,100,0,228,228
Letisha,F,100,228,0,228
Loree,F,100,228,0,228
Marius,M,100,0,228,228
Mckenzi,F,100,228,0,228
Melania,F,100,228,0,228
Rayanna,F,100,228,0,228
Shamari,F,60,137,91,228
Shekinah,F,100,228,0,228
Tamiko,F,100,228,0,228
Tarsha,F,100,228,0,228
Tyre,M,97,6,222,228
Zelma,F,100,228,0,228
Aminata,F,100,227,0,227
Andrae,M,100,0,227,227
Coreen,F,100,227,0,227
Corissa,F,100,227,0,227
Dain,M,100,0,227,227
Giles,M,100,0,227,227
Izak,M,100,0,227,227
Jovana,F,100,227,0,227
Marykate,F,100,227,0,227
Nautica,F,96,219,8,227
Quin,M,79,47,180,227
Rosina,F,100,227,0,227
Safiya,F,100,227,0,227
Shaylin,F,100,227,0,227
Sherrod,M,100,0,227,227
Taylee,F,100,227,0,227
Veer,M,100,0,227,227
Vikram,M,100,0,227,227
Adriene,F,100,226,0,226
Alvis,M,98,5,221,226
Ameerah,F,100,226,0,226
Camari,M,61,89,137,226
Carleton,M,100,0,226,226
Deeanna,F,100,226,0,226
Eriberto,M,100,0,226,226
Faisal,M,100,0,226,226
Franz,M,100,0,226,226
Giovany,M,100,0,226,226
Hanan,F,92,208,18,226
Hester,F,96,216,10,226
Inara,F,100,226,0,226
Jadelyn,F,100,226,0,226
Jansen,M,90,22,204,226
Kemari,M,72,64,162,226
Lawana,F,100,226,0,226
Lawanna,F,100,226,0,226
Lev,M,94,13,213,226
Lucile,F,100,226,0,226
Rasheeda,F,98,221,5,226
Saif,M,100,0,226,226
Shanya,F,100,226,0,226
Taelor,F,88,200,26,226
Trinitee,F,100,226,0,226
Zakiyah,F,100,226,0,226
Aly,F,63,142,83,225
Avian,M,82,40,185,225
Boyce,M,100,0,225,225
Britnee,F,100,225,0,225
Columbus,M,100,0,225,225
Jakobi,M,100,0,225,225
Jala,F,100,225,0,225
Jaxxon,M,100,0,225,225
Jina,F,100,225,0,225
Kyrin,M,94,13,212,225
Latina,F,100,225,0,225
Ren,M,88,26,199,225
Rogan,M,94,13,212,225
Roshan,M,94,14,211,225
Tyrique,M,100,0,225,225
Venice,F,94,212,13,225
Aj,M,98,5,219,224
Amaia,F,100,224,0,224
Angelle,F,100,224,0,224
Brixton,M,89,25,199,224
Elizebeth,F,100,224,0,224
Kellye,F,100,224,0,224
Maury,M,86,31,193,224
Rafaela,F,100,224,0,224
Rakeem,M,100,0,224,224
Roan,M,94,13,211,224
Safa,F,100,224,0,224
Skip,M,100,0,224,224
Walton,M,100,0,224,224
Yanet,F,100,224,0,224
Aerial,F,100,223,0,223
Anyla,F,100,223,0,223
Arizona,F,96,213,10,223
Azael,M,100,0,223,223
Cassi,F,100,223,0,223
Cathey,F,100,223,0,223
Conan,M,100,0,223,223
Damir,M,100,0,223,223
Donato,M,100,0,223,223
Jaydyn,M,58,93,130,223
Lauro,M,100,0,223,223
Lindsy,F,100,223,0,223
Lisandro,M,100,0,223,223
Mahdi,M,100,0,223,223
Presleigh,F,100,223,0,223
Zen,M,87,30,193,223
Anselmo,M,100,0,222,222
Baily,F,76,169,53,222
Breeana,F,100,222,0,222
Dwan,M,60,88,134,222
Gabrial,M,88,26,196,222
Issabella,F,100,222,0,222
Jenica,F,100,222,0,222
Landis,M,90,23,199,222
Lynden,M,65,77,145,222
Michaella,F,100,222,0,222
Nohemi,F,100,222,0,222
Romy,F,86,192,30,222
Ronell,M,84,36,186,222
Sora,F,81,180,42,222
Sumaya,F,100,222,0,222
Tobey,M,75,55,167,222
Towanda,F,100,222,0,222
Zakariya,M,94,13,209,222
Adel,M,65,78,143,221
Akhil,M,100,0,221,221
Ansh,M,100,0,221,221
Devion,M,100,0,221,221
Eliott,M,100,0,221,221
Gaylene,F,100,221,0,221
Hayli,F,100,221,0,221
Isacc,M,100,0,221,221
Juwan,M,98,5,216,221
Karely,F,100,221,0,221
Kellyn,F,87,192,29,221
Lark,F,95,211,10,221
Lashawnda,F,100,221,0,221
Levy,M,98,5,216,221
Mackenzi,F,100,221,0,221
Mendy,F,72,159,62,221
Mistie,F,100,221,0,221
Paisleigh,F,100,221,0,221
Prentiss,M,98,5,216,221
Regenia,F,100,221,0,221
Seanna,F,100,221,0,221
Tawni,F,100,221,0,221
Watson,M,100,0,221,221
Akash,M,100,0,220,220
Aleya,F,100,220,0,220
Ayush,M,100,0,220,220
Cree,F,60,131,89,220
Dannette,F,100,220,0,220
Dereon,M,74,57,163,220
Dontavious,M,100,0,220,220
Faron,M,97,7,213,220
Hawa,F,100,220,0,220
Heber,M,100,0,220,220
Jayshawn,M,100,0,220,220
Jeanmarie,F,100,220,0,220
Kennady,F,100,220,0,220
Liyah,F,100,220,0,220
Mahala,F,100,220,0,220
Michela,F,100,220,0,220
Mikell,M,76,52,168,220
Nancie,F,100,220,0,220
Rollin,M,100,0,220,220
Santo,M,100,0,220,220
Shanequa,F,100,220,0,220
Shayan,M,98,5,215,220
Tyshaun,M,100,0,220,220
Anushka,F,100,219,0,219
Aren,M,93,16,203,219
Arissa,F,100,219,0,219
Bari,F,98,214,5,219
Cletus,M,100,0,219,219
Courtnee,F,100,219,0,219
Daniyah,F,100,219,0,219
Davi,M,79,47,172,219
Elio,M,100,0,219,219
Haileigh,F,100,219,0,219
Inaya,F,100,219,0,219
Jarius,M,100,0,219,219
Johnmichael,M,100,0,219,219
Laiken,F,81,178,41,219
Leatha,F,100,219,0,219
Loyal,M,87,28,191,219
Mandie,F,100,219,0,219
Nino,M,100,0,219,219
Obadiah,M,100,0,219,219
Randle,M,100,0,219,219
Roque,M,100,0,219,219
Rosaura,F,100,219,0,219
Samanta,F,100,219,0,219
Sammantha,F,100,219,0,219
Skyy,F,95,207,12,219
Sunnie,F,100,219,0,219
Tashawn,M,86,31,188,219
Twana,F,100,219,0,219
Wilda,F,100,219,0,219
Abdullahi,M,100,0,218,218
Ailani,F,100,218,0,218
Akshara,F,100,218,0,218
Blain,M,100,0,218,218
Celso,M,100,0,218,218
Dream,F,84,184,34,218
Elisia,F,100,218,0,218
Jadah,F,100,218,0,218
Jalaya,F,100,218,0,218
Juliane,F,100,218,0,218
Markita,F,100,218,0,218
Modesto,M,100,0,218,218
Ona,F,100,218,0,218
Saphira,F,100,218,0,218
Shaelynn,F,100,218,0,218
Tiger,M,97,7,211,218
Treyson,M,100,0,218,218
Truett,M,100,0,218,218
Yulisa,F,100,218,0,218
Abran,M,100,0,217,217
Andreana,F,100,217,0,217
Antoni,M,100,0,217,217
Cloey,F,100,217,0,217
Dyana,F,100,217,0,217
Erie,M,87,29,188,217
Izel,F,82,178,39,217
Jori,F,91,197,20,217
Keya,F,100,217,0,217
Khristopher,M,100,0,217,217
Kyana,F,100,217,0,217
Lanna,F,100,217,0,217
Laurin,F,88,192,25,217
Navya,F,100,217,0,217
Om,M,100,0,217,217
Saeed,M,100,0,217,217
Tarek,M,100,0,217,217
Tonisha,F,100,217,0,217
Adelaida,F,100,216,0,216
Aleyna,F,100,216,0,216
Audrea,F,100,216,0,216
Darlyn,F,97,210,6,216
Darryn,M,94,12,204,216
Eldridge,M,100,0,216,216
Gladis,F,100,216,0,216
Jalin,M,75,55,161,216
Jarad,M,100,0,216,216
Kennth,M,100,0,216,216
Keyara,F,100,216,0,216
Konstantinos,M,100,0,216,216
Lilyanne,F,100,216,0,216
Natanael,M,100,0,216,216
Niklas,M,100,0,216,216
Shaindy,F,100,216,0,216
Aleeah,F,100,215,0,215
Blaize,M,88,25,190,215
Callahan,M,75,54,161,215
Dalary,F,100,215,0,215
Dalen,M,100,0,215,215
Eliazar,M,100,0,215,215
Hiba,F,100,215,0,215
Jamarius,M,100,0,215,215
Kenney,M,100,0,215,215
Kipton,M,100,0,215,215
Lorine,F,100,215,0,215
Maja,F,100,215,0,215
Nabil,M,93,15,200,215
Naeem,M,100,0,215,215
Nicholle,F,100,215,0,215
Oaklee,F,75,162,53,215
Rigo,M,100,0,215,215
Sharman,F,97,209,6,215
Silvana,F,100,215,0,215
Stephane,F,59,127,88,215
Tequila,F,100,215,0,215
Zaine,M,100,0,215,215
Abriella,F,100,214,0,214
Armin,M,100,0,214,214
Delmer,M,100,0,214,214
Elayne,F,100,214,0,214
Elden,M,100,0,214,214
Felisa,F,100,214,0,214
Iyonna,F,100,214,0,214
Jann,F,93,199,15,214
Miquel,M,100,0,214,214
Rion,M,74,55,159,214
Ryden,M,93,15,199,214
Shiv,M,100,0,214,214
Taina,F,100,214,0,214
West,M,100,0,214,214
Amberlee,F,100,213,0,213
Ananda,F,98,208,5,213
Cord,M,100,0,213,213
Enedina,F,100,213,0,213
Janyla,F,100,213,0,213
Jennings,M,89,23,190,213
Joeseph,M,100,0,213,213
Kalob,M,100,0,213,213
Kambree,F,100,213,0,213
Kedrick,M,100,0,213,213
Lillith,F,100,213,0,213
Rohit,M,100,0,213,213
Steffany,F,100,213,0,213
Westyn,M,92,16,197,213
Aide,F,100,212,0,212
Alaysha,F,100,212,0,212
Analicia,F,100,212,0,212
Batsheva,F,100,212,0,212
Brailyn,F,77,163,49,212
Cartier,M,84,34,178,212
Cheree,F,100,212,0,212
Dessie,F,100,212,0,212
Grayce,F,100,212,0,212
Hala,F,100,212,0,212
Javeon,M,100,0,212,212
Jazzlynn,F,100,212,0,212
Journie,F,100,212,0,212
Kyanna,F,100,212,0,212
Quran,M,100,0,212,212
Sena,F,90,190,22,212
Taja,F,98,207,5,212
Talyn,F,56,119,93,212
Tirzah,F,100,212,0,212
Zayvion,M,100,0,212,212
Aleida,F,100,211,0,211
Anela,F,100,211,0,211
Avarie,F,100,211,0,211
Cyle,M,100,0,211,211
Dusti,F,100,211,0,211
Dynasty,F,100,211,0,211
Gabriell,F,75,158,53,211
Jahari,M,85,32,179,211
Jaidon,M,94,13,198,211
Jihad,M,100,0,211,211
Karleen,F,100,211,0,211
Kirkland,M,100,0,211,211
Kyrsten,F,100,211,0,211
Marceline,F,100,211,0,211
Myriah,F,100,211,0,211
Nubia,F,100,211,0,211
Ranae,F,100,211,0,211
Randie,F,71,149,62,211
Teague,M,100,0,211,211
Terrion,M,94,13,198,211
Windell,M,100,0,211,211
Cort,M,100,0,210,210
Dominica,F,100,210,0,210
Dyan,F,95,199,11,210
Eman,F,97,203,7,210
Giulianna,F,100,210,0,210
Kaylon,M,65,73,137,210
Kiyan,M,97,7,203,210
Lisandra,F,100,210,0,210
Lucious,M,100,0,210,210
Mikki,F,98,205,5,210
Naim,M,100,0,210,210
Odette,F,100,210,0,210
Uma,F,100,210,0,210
Calder,M,100,0,209,209
Eusebio,M,100,0,209,209
Florentino,M,100,0,209,209
Giorgio,M,100,0,209,209
Hanah,F,100,209,0,209
January,F,100,209,0,209
Kassi,F,100,209,0,209
Lavar,M,98,5,204,209
Marbella,F,100,209,0,209
Maude,F,100,209,0,209
Melodi,F,100,209,0,209
Nakayla,F,100,209,0,209
Ridley,M,57,89,120,209
Tysen,M,100,0,209,209
Zooey,F,100,209,0,209
Abigael,F,100,208,0,208
Adrina,F,100,208,0,208
Akil,M,100,0,208,208
Baruch,M,100,0,208,208
Brently,M,97,7,201,208
Coltyn,M,100,0,208,208
Darris,M,100,0,208,208
Dedric,M,97,7,201,208
Domenica,F,100,208,0,208
Jadin,M,77,47,161,208
Lynwood,M,100,0,208,208
Melton,M,100,0,208,208
Melyssa,F,100,208,0,208
Natividad,F,55,114,94,208
Naveen,M,70,62,146,208
Rosalva,F,100,208,0,208
Shawana,F,100,208,0,208
Sima,F,100,208,0,208
Arline,F,100,207,0,207
Avigail,F,100,207,0,207
Cass,M,93,14,193,207
Corben,M,100,0,207,207
Gamaliel,M,100,0,207,207
Halima,F,100,207,0,207
Jireh,M,52,100,107,207
Naomy,F,100,207,0,207
Raeanne,F,100,207,0,207
Rosann,F,100,207,0,207
Santina,F,100,207,0,207
Shanti,F,91,188,19,207
Tavis,M,100,0,207,207
Tea,F,100,207,0,207
Trysten,M,86,28,179,207
Zac,M,100,0,207,207
Zayda,F,100,207,0,207
Brodrick,M,100,0,206,206
Emelie,F,100,206,0,206
Ilse,F,100,206,0,206
Jareth,M,100,0,206,206
Jayci,F,100,206,0,206
Jona,F,78,161,45,206
Lajuan,M,67,69,137,206
Lashawna,F,100,206,0,206
Lauralee,F,100,206,0,206
Mayer,M,100,0,206,206
Melannie,F,100,206,0,206
Zadie,F,100,206,0,206
Alonza,M,100,0,205,205
Alyanna,F,100,205,0,205
Alysson,F,100,205,0,205
Amparo,F,100,205,0,205
Cleve,M,100,0,205,205
Drema,F,100,205,0,205
Emmi,F,100,205,0,205
Florine,F,100,205,0,205
Jomar,M,100,0,205,205
Liesl,F,100,205,0,205
Macario,M,100,0,205,205
Madelynne,F,100,205,0,205
Nickolaus,M,100,0,205,205
Rashon,M,97,7,198,205
Renzo,M,100,0,205,205
Silver,F,79,162,43,205
Sparkle,F,100,205,0,205
Teagen,F,50,103,102,205
Zacharias,M,100,0,205,205
Zariya,F,100,205,0,205
Aislyn,F,100,204,0,204
Amity,F,100,204,0,204
Asiya,F,100,204,0,204
Azure,F,78,160,44,204
Dajah,F,100,204,0,204
Deniz,M,55,91,113,204
Elisheva,F,100,204,0,204
Gaetano,M,100,0,204,204
Iran,M,67,67,137,204
Jailen,M,82,36,168,204
Kayci,F,100,204,0,204
Kyden,M,98,5,199,204
Leopold,M,100,0,204,204
Meyer,M,90,20,184,204
Noella,F,100,204,0,204
Raylin,F,72,147,57,204
Robbi,F,79,161,43,204
Rolf,M,100,0,204,204
Sanya,F,100,204,0,204
Saoirse,F,100,204,0,204
Shala,F,100,204,0,204
Shaunda,F,100,204,0,204
Sherika,F,100,204,0,204
Shiann,F,100,204,0,204
Teal,F,81,166,38,204
Vayda,F,100,204,0,204
Wilburn,M,100,0,204,204
Zofia,F,100,204,0,204
Anyssa,F,100,203,0,203
Arnetta,F,100,203,0,203
Babyboy,M,100,0,203,203
Bradon,M,100,0,203,203
Braylynn,F,85,173,30,203
Brinda,F,100,203,0,203
Demitri,M,100,0,203,203
Demitrius,M,100,0,203,203
Elyjah,M,100,0,203,203
Gaston,M,100,0,203,203
Gavriel,M,100,0,203,203
Herminia,F,100,203,0,203
Jarek,M,100,0,203,203
Jeanpaul,M,100,0,203,203
Jovita,F,100,203,0,203
Kage,M,100,0,203,203
Kamara,F,100,203,0,203
Keasia,F,100,203,0,203
Kolbe,M,98,5,198,203
Marcanthony,M,100,0,203,203
Maycie,F,100,203,0,203
Michaelangelo,M,100,0,203,203
Mickel,M,94,12,191,203
Novella,F,100,203,0,203
Reegan,F,76,154,49,203
Stormi,F,100,203,0,203
Sueann,F,100,203,0,203
Zeus,M,100,0,203,203
Alyana,F,100,202,0,202
Ashlynne,F,100,202,0,202
Cardell,M,100,0,202,202
Eris,F,79,159,43,202
Evyn,F,62,125,77,202
Kennard,M,100,0,202,202
Kolbie,F,79,160,42,202
Kynslee,F,100,202,0,202
Malakhi,M,100,0,202,202
Nahum,M,100,0,202,202
Natisha,F,100,202,0,202
Nicolai,M,100,0,202,202
Sayra,F,100,202,0,202
Syeda,F,100,202,0,202
Tamisha,F,100,202,0,202
Taran,M,81,39,163,202
Terran,M,76,48,154,202
Thanh,M,57,86,116,202
Tobie,F,63,127,75,202
Yanely,F,100,202,0,202
Alaa,F,77,155,46,201
Alaura,F,100,201,0,201
Annalyse,F,100,201,0,201
Ashlei,F,100,201,0,201
Cailee,F,100,201,0,201
Cassy,F,100,201,0,201
Danthony,M,100,0,201,201
Deb,F,100,201,0,201
Felica,F,100,201,0,201
Jacquez,M,100,0,201,201
Jarrad,M,100,0,201,201
Kambria,F,100,201,0,201
Kamia,F,100,201,0,201
Kekoa,M,97,6,195,201
Kenadi,F,100,201,0,201
Leron,M,100,0,201,201
Lydell,M,100,0,201,201
Marilu,F,100,201,0,201
Mickayla,F,100,201,0,201
Nikolaos,M,100,0,201,201
Olympia,F,100,201,0,201
Shaniece,F,100,201,0,201
Shaunte,F,93,187,14,201
Siya,F,100,201,0,201
Vanity,F,100,201,0,201
Ajani,M,87,26,174,200
Aleesha,F,100,200,0,200
Annastasia,F,100,200,0,200
Arabelle,F,100,200,0,200
Avary,F,95,190,10,200
Broden,M,100,0,200,200
Calie,F,100,200,0,200
Dajon,M,98,5,195,200
Delfina,F,100,200,0,200
Delfino,M,100,0,200,200
Diedra,F,100,200,0,200
Emari,F,54,109,91,200
Erynn,F,100,200,0,200
Feliciano,M,100,0,200,200
Francheska,F,100,200,0,200
Garnet,F,62,125,75,200
Geovany,M,100,0,200,200
Illiana,F,100,200,0,200
Jakoby,M,100,0,200,200
Jalayah,F,100,200,0,200
Keysha,F,100,200,0,200
Lillia,F,100,200,0,200
Lucila,F,100,200,0,200
Marilou,F,100,200,0,200
Pansy,F,100,200,0,200
Tyreke,M,100,0,200,200
Abdulaziz,M,100,0,199,199
Adora,F,100,199,0,199
Annah,F,100,199,0,199
Arantza,F,100,199,0,199
Arrianna,F,100,199,0,199
Braxten,M,100,0,199,199
Cecilio,M,100,0,199,199
Christ,M,100,0,199,199
Doran,M,97,5,194,199
Fidencio,M,100,0,199,199
Gerrit,M,100,0,199,199
Jancarlos,M,100,0,199,199
Jazlene,F,100,199,0,199
Jermain,M,100,0,199,199
Jeronimo,M,100,0,199,199
Khali,F,67,134,65,199
Marvel,F,51,101,98,199
Rosy,F,100,199,0,199
Stefon,M,100,0,199,199
Tonda,F,100,199,0,199
Yechiel,M,100,0,199,199
Adah,F,100,198,0,198
Allena,F,100,198,0,198
Benjiman,M,100,0,198,198
Brienne,F,97,193,5,198
Ciro,M,100,0,198,198
Cortland,M,97,5,193,198
Enos,M,100,0,198,198
Esha,F,100,198,0,198
Jayveon,M,100,0,198,198
Kenzo,M,100,0,198,198
Paden,M,91,17,181,198
Rosaline,F,100,198,0,198
Sanvi,F,100,198,0,198
Seana,F,100,198,0,198
Slater,M,100,0,198,198
Aadya,F,100,197,0,197
Brittnay,F,100,197,0,197
Camie,F,100,197,0,197
Carlyle,M,91,17,180,197
Cassey,F,90,178,19,197
Donielle,F,95,188,9,197
Ena,F,100,197,0,197
Izabela,F,100,197,0,197
Janella,F,100,197,0,197
Jens,M,100,0,197,197
Jhon,M,100,0,197,197
Jiya,F,100,197,0,197
Joao,M,100,0,197,197
Liah,F,100,197,0,197
Marquetta,F,100,197,0,197
Marylee,F,100,197,0,197
Marylynn,F,100,197,0,197
Melissia,F,100,197,0,197
Mylan,M,71,58,139,197
Olivier,M,100,0,197,197
Phaedra,F,100,197,0,197
Rheanna,F,100,197,0,197
Stafford,M,100,0,197,197
Tambra,F,100,197,0,197
Tj,M,100,0,197,197
Victory,F,74,145,52,197
Aaliya,F,100,196,0,196
Amberlynn,F,100,196,0,196
Ansleigh,F,100,196,0,196
Caliyah,F,100,196,0,196
Cinthya,F,100,196,0,196
Damoni,M,78,43,153,196
Desteny,F,100,196,0,196
Eliyah,F,67,132,64,196
Ellyana,F,100,196,0,196
Emiley,F,100,196,0,196
Esai,M,100,0,196,196
Harlen,M,95,9,187,196
Joely,F,100,196,0,196
Johathan,M,100,0,196,196
Koren,F,91,179,17,196
Lynnea,F,100,196,0,196
Milford,M,100,0,196,196
Nahomi,F,100,196,0,196
Pauletta,F,100,196,0,196
Payne,M,100,0,196,196
Renay,F,100,196,0,196
Sai,M,77,46,150,196
Salim,M,100,0,196,196
Sariya,F,100,196,0,196
Tamir,M,96,8,188,196
Wells,M,93,13,183,196
Zacharia,M,97,6,190,196
Aeris,F,100,195,0,195
Cameren,M,89,22,173,195
Emili,F,100,195,0,195
Eulalia,F,100,195,0,195
Jaelen,M,87,26,169,195
Janita,F,100,195,0,195
Jeanelle,F,100,195,0,195
Jennyfer,F,100,195,0,195
Joye,F,100,195,0,195
Lyndell,M,76,47,148,195
Marquan,M,100,0,195,195
Maryelizabeth,F,100,195,0,195
Medina,F,100,195,0,195
Neve,F,100,195,0,195
Omega,F,68,133,62,195
Ricci,F,57,112,83,195
Rupert,M,100,0,195,195
Rush,M,100,0,195,195
Saya,F,100,195,0,195
Saydee,F,100,195,0,195
Sharilyn,F,100,195,0,195
Tamica,F,100,195,0,195
Tamiya,F,100,195,0,195
Tesha,F,100,195,0,195
Violetta,F,100,195,0,195
Waleed,M,100,0,195,195
Arriana,F,100,194,0,194
Briann,F,100,194,0,194
Ciaran,M,100,0,194,194
Crimson,F,66,129,65,194
Damond,M,97,5,189,194
Dyson,M,97,5,189,194
Florencio,M,100,0,194,194
Griffen,M,100,0,194,194
Jahzara,F,100,194,0,194
Jaison,M,100,0,194,194
Jameer,M,100,0,194,194
Jennica,F,100,194,0,194
Jeriah,M,81,36,158,194
Jerron,M,100,0,194,194
Julieanne,F,100,194,0,194
Kellyann,F,100,194,0,194
Kelsee,F,100,194,0,194
Klaire,F,100,194,0,194
Liya,F,100,194,0,194
Lotus,F,97,189,5,194
Naftali,M,100,0,194,194
Naiya,F,100,194,0,194
Nakiya,F,100,194,0,194
Nilsa,F,100,194,0,194
Sid,M,100,0,194,194
Sir,M,100,0,194,194
Takiyah,F,100,194,0,194
Yoselyn,F,100,194,0,194
Zyion,M,79,40,154,194
Clancy,M,75,49,144,193
Delainey,F,100,193,0,193
Karren,F,100,193,0,193
Keaira,F,100,193,0,193
Kohl,M,100,0,193,193
Maelynn,F,100,193,0,193
Margarett,F,100,193,0,193
Marysol,F,100,193,0,193
Mycah,F,54,105,88,193
Nerissa,F,100,193,0,193
Pietro,M,100,0,193,193
Samirah,F,100,193,0,193
Shylah,F,100,193,0,193
Tillie,F,100,193,0,193
Zacchaeus,M,100,0,193,193
Aaryan,M,100,0,192,192
Akshay,M,100,0,192,192
Alizabeth,F,100,192,0,192
Bailie,F,100,192,0,192
Carlisle,M,68,61,131,192
Dagoberto,M,100,0,192,192
Denali,F,75,144,48,192
Efraim,M,100,0,192,192
Janea,F,100,192,0,192
Jasiel,M,90,19,173,192
Jessee,M,76,46,146,192
Karthik,M,100,0,192,192
Kelan,M,100,0,192,192
La,F,85,163,29,192
Loralei,F,100,192,0,192
Lyndi,F,100,192,0,192
Shantal,F,100,192,0,192
Story,F,95,183,9,192
Thompson,M,100,0,192,192
Ubaldo,M,100,0,192,192
Wesson,M,100,0,192,192
Aaleyah,F,100,191,0,191
Alexandros,M,100,0,191,191
Alexcia,F,100,191,0,191
Baylen,M,90,19,172,191
Celene,F,100,191,0,191
Cherilyn,F,100,191,0,191
Deane,M,71,55,136,191
Georgene,F,100,191,0,191
Kaelan,M,78,42,149,191
Katharina,F,100,191,0,191
Kendyll,F,97,186,5,191
Kinzie,F,100,191,0,191
Launa,F,100,191,0,191
Lawrance,M,100,0,191,191
Malique,M,100,0,191,191
Oran,M,100,0,191,191
Oswald,M,100,0,191,191
Queenie,F,100,191,0,191
Rivky,F,100,191,0,191
Romero,M,100,0,191,191
Tyrin,M,100,0,191,191
Viki,F,100,191,0,191
Ysabella,F,100,191,0,191
Zaynab,F,100,191,0,191
Aleksandr,M,100,0,190,190
Arcelia,F,100,190,0,190
Aziza,F,100,190,0,190
Blade,M,100,0,190,190
Cate,F,100,190,0,190
Chesley,M,65,67,123,190
Dasani,F,69,131,59,190
Dustan,M,100,0,190,190
Faviola,F,100,190,0,190
Javien,M,100,0,190,190
Jayquan,M,100,0,190,190
Johannes,M,100,0,190,190
Kace,M,100,0,190,190
Kaydon,M,92,16,174,190
Kimball,M,89,20,170,190
Krystyna,F,100,190,0,190
Laela,F,100,190,0,190
Laya,F,100,190,0,190
Mackayla,F,100,190,0,190
Maelyn,F,100,190,0,190
Maleek,M,100,0,190,190
Marchelle,F,100,190,0,190
Naseem,M,86,27,163,190
Richardo,M,100,0,190,190
Rony,M,100,0,190,190
Shawnta,F,90,171,19,190
Shenika,F,100,190,0,190
Tatyanna,F,100,190,0,190
Tyisha,F,100,190,0,190
Amon,M,100,0,189,189
Ander,M,100,0,189,189
Babygirl,F,97,183,6,189
Bear,M,100,0,189,189
Caylie,F,100,189,0,189
Cera,F,100,189,0,189
Elyana,F,100,189,0,189
Geary,M,100,0,189,189
Jacee,F,97,183,6,189
Kathern,F,100,189,0,189
Keelie,F,100,189,0,189
Lynlee,F,100,189,0,189
Marjory,F,100,189,0,189
Matilde,F,97,183,6,189
Meah,F,100,189,0,189
Pamelia,F,100,189,0,189
Sharie,F,100,189,0,189
Yousif,M,100,0,189,189
Anel,F,90,169,19,188
Anjel,M,72,52,136,188
Anslee,F,100,188,0,188
Antonino,M,100,0,188,188
Arlan,M,100,0,188,188
Breckin,M,89,21,167,188
Britain,M,61,74,114,188
Coley,M,81,35,153,188
Damya,F,100,188,0,188
Deondra,F,82,155,33,188
Detrick,M,97,5,183,188
Dorien,M,92,15,173,188
Edan,M,87,24,164,188
Ezrah,M,83,32,156,188
Fabiana,F,100,188,0,188
Garfield,M,100,0,188,188
Genie,F,100,188,0,188
Javaris,M,100,0,188,188
Kamani,F,63,118,70,188
Keiry,F,100,188,0,188
Mariama,F,100,188,0,188
Marna,F,100,188,0,188
Marya,F,100,188,0,188
Mckinlee,F,100,188,0,188
Penney,F,100,188,0,188
Randon,M,100,0,188,188
Rowyn,F,78,146,42,188
Rudolfo,M,100,0,188,188
Shakayla,F,100,188,0,188
Sherice,F,100,188,0,188
Anaiyah,F,100,187,0,187
Candido,M,100,0,187,187
Collier,M,84,30,157,187
Desarae,F,100,187,0,187
Edrick,M,100,0,187,187
Ezekial,M,100,0,187,187
Jelena,F,100,187,0,187
Jolyn,F,100,187,0,187
Majesty,F,79,147,40,187
Marygrace,F,100,187,0,187
Paiton,F,84,157,30,187
Rozlyn,F,100,187,0,187
Sakura,F,100,187,0,187
Sedona,F,100,187,0,187
Takoda,M,88,23,164,187
Taneisha,F,100,187,0,187
Valente,M,100,0,187,187
Yoana,F,100,187,0,187
Zinnia,F,100,187,0,187
Alexie,F,91,169,17,186
Anijah,F,100,186,0,186
Braylan,M,94,12,174,186
Caidence,F,89,166,20,186
Celestina,F,100,186,0,186
Chimere,F,100,186,0,186
Coralie,F,100,186,0,186
Daniya,F,100,186,0,186
Drayton,M,100,0,186,186
Emmanuelle,F,81,150,36,186
Gaylen,M,84,30,156,186
Jadan,M,78,40,146,186
Jayleigh,F,100,186,0,186
Justis,M,80,37,149,186
Keena,F,96,179,7,186
Leatrice,F,100,186,0,186
Maha,F,100,186,0,186
Marino,M,100,0,186,186
Navaeh,F,100,186,0,186
Omarion,M,100,0,186,186
Raniya,F,100,186,0,186
Sheilah,F,100,186,0,186
Tam,F,50,93,93,186
Thurston,M,100,0,186,186
Treshawn,M,100,0,186,186
Whittney,F,100,186,0,186
Yehudis,F,100,186,0,186
Zyan,M,77,43,143,186
Amaree,M,63,69,116,185
Anand,M,100,0,185,185
Antonina,F,100,185,0,185
Blayke,F,51,95,90,185
Cheryll,F,100,185,0,185
Diedre,F,100,185,0,185
Diona,F,100,185,0,185
Djuan,M,100,0,185,185
Edythe,F,100,185,0,185
Ender,M,100,0,185,185
Geoff,M,100,0,185,185
Gwenda,F,100,185,0,185
Huxley,M,90,18,167,185
Jackelin,F,100,185,0,185
Jacqualine,F,100,185,0,185
Joya,F,100,185,0,185
Katilyn,F,100,185,0,185
Kylea,F,100,185,0,185
Lizzette,F,100,185,0,185
Marinda,F,100,185,0,185
Marly,F,100,185,0,185
Niah,F,100,185,0,185
Perrin,M,80,37,148,185
Shriya,F,100,185,0,185
Syrus,M,100,0,185,185
Verenice,F,100,185,0,185
Zak,M,100,0,185,185
Adi,F,57,104,80,184
Alethia,F,100,184,0,184
Ambrosia,F,100,184,0,184
Birdie,F,100,184,0,184
Celestino,M,100,0,184,184
Christion,M,97,6,178,184
Coralee,F,100,184,0,184
Jalyssa,F,100,184,0,184
Jamichael,M,100,0,184,184
Jenevieve,F,100,184,0,184
Jeremih,M,100,0,184,184
Kareena,F,100,184,0,184
Karry,F,61,113,71,184
Kena,F,97,179,5,184
Kilian,M,97,5,179,184
Lisamarie,F,100,184,0,184
Manda,F,100,184,0,184
Miki,F,97,179,5,184
Nataleigh,F,100,184,0,184
Nidhi,F,100,184,0,184
Silvestre,M,100,0,184,184
Stryker,M,100,0,184,184
Zyair,M,89,21,163,184
Aleeyah,F,100,183,0,183
Asael,M,100,0,183,183
Chenoa,F,100,183,0,183
Contessa,F,100,183,0,183
Derrion,M,93,12,171,183
Dymond,F,100,183,0,183
Eduard,M,100,0,183,183
Eladio,M,100,0,183,183
Evalina,F,100,183,0,183
Garnett,M,78,41,142,183
Halen,M,64,66,117,183
Henderson,M,100,0,183,183
Irelynn,F,100,183,0,183
Jani,F,100,183,0,183
Jerell,M,100,0,183,183
Junius,M,100,0,183,183
Kamaya,F,100,183,0,183
Latrisha,F,100,183,0,183
Laure,F,100,183,0,183
Lenna,F,100,183,0,183
Myasia,F,100,183,0,183
Narciso,M,100,0,183,183
Nazareth,M,54,84,99,183
Nisa,F,100,183,0,183
Sachin,M,100,0,183,183
Samiah,F,100,183,0,183
Shirlee,F,100,183,0,183
Tillman,M,100,0,183,183
Treveon,M,100,0,183,183
Tylen,M,100,0,183,183
Valeri,F,100,183,0,183
Zaniah,F,100,183,0,183
Aleia,F,100,182,0,182
Alford,M,100,0,182,182
Alyshia,F,100,182,0,182
Alyza,F,100,182,0,182
Annalynn,F,100,182,0,182
Breona,F,100,182,0,182
Brienna,F,100,182,0,182
Brinkley,F,100,182,0,182
Caius,M,100,0,182,182
Cameo,F,82,150,32,182
Chancey,M,63,67,115,182
Destine,F,82,150,32,182
Drue,M,53,86,96,182
Efrem,M,100,0,182,182
Geovani,M,100,0,182,182
Kailen,M,54,83,99,182
Kareen,F,63,114,68,182
Laynie,F,100,182,0,182
Levar,M,100,0,182,182
Lindell,M,84,29,153,182
Marquette,M,67,60,122,182
Maryanna,F,100,182,0,182
Milagro,F,95,173,9,182
Patrina,F,100,182,0,182
Petrina,F,100,182,0,182
Pooja,F,100,182,0,182
Renesmee,F,100,182,0,182
Rochell,F,96,175,7,182
Ruthanne,F,100,182,0,182
Stacee,F,100,182,0,182
Tamira,F,100,182,0,182
Tiernan,M,88,21,161,182
Vivek,M,100,0,182,182
Walt,M,100,0,182,182
Aayush,M,100,0,181,181
Arlinda,F,100,181,0,181
Ashby,M,52,87,94,181
Brystol,F,97,175,6,181
Calandra,F,100,181,0,181
Cher,F,95,172,9,181
Eastyn,M,59,74,107,181
Ellena,F,100,181,0,181
Estephanie,F,100,181,0,181
Irina,F,100,181,0,181
Jalia,F,100,181,0,181
Karalyn,F,100,181,0,181
Keilah,F,100,181,0,181
Khalif,M,100,0,181,181
Kyley,F,94,171,10,181
Lakenya,F,100,181,0,181
Laraine,F,100,181,0,181
Loryn,F,100,181,0,181
Mykal,M,82,33,148,181
Najah,F,97,176,5,181
Nery,M,82,33,148,181
Rebel,F,50,91,90,181
Roderic,M,100,0,181,181
Ryon,M,100,0,181,181
Sandro,M,100,0,181,181
Skylor,M,64,66,115,181
Suzannah,F,100,181,0,181
Takia,F,100,181,0,181
Takisha,F,100,181,0,181
Tiffini,F,100,181,0,181
Westen,M,100,0,181,181
Xavian,M,100,0,181,181
Abbigayle,F,100,180,0,180
Alysse,F,100,180,0,180
Amyra,F,100,180,0,180
Brilee,F,96,173,7,180
Cliffton,M,100,0,180,180
Cristie,F,100,180,0,180
Daisey,F,100,180,0,180
Francie,F,100,180,0,180
Hashim,M,100,0,180,180
Izabell,F,100,180,0,180
Jaidan,M,76,43,137,180
Janean,F,100,180,0,180
Jonpaul,M,100,0,180,180
Lakayla,F,100,180,0,180
Lanell,F,73,132,48,180
Lenox,M,81,35,145,180
Linkin,M,100,0,180,180
Makenzy,F,100,180,0,180
Marcial,M,100,0,180,180
Mattea,F,100,180,0,180
Mischa,F,91,164,16,180
Rapheal,M,100,0,180,180
Riki,F,72,129,51,180
Sarabeth,F,100,180,0,180
Vianca,F,100,180,0,180
Xena,F,100,180,0,180
Zaya,F,100,180,0,180
Ahna,F,100,179,0,179
Audri,F,100,179,0,179
Ayvah,F,100,179,0,179
Aziyah,F,96,171,8,179
Cayce,F,75,135,44,179
Delonte,M,100,0,179,179
Dezarae,F,100,179,0,179
Diondre,M,100,0,179,179
Drucilla,F,100,179,0,179
Durrell,M,100,0,179,179
Elisabet,F,100,179,0,179
Emilyn,F,100,179,0,179
Harriette,F,100,179,0,179
Irelyn,F,100,179,0,179
Irish,F,89,159,20,179
Italy,F,100,179,0,179
Jamall,M,100,0,179,179
Janely,F,100,179,0,179
Jimi,M,70,54,125,179
Joslin,F,100,179,0,179
Kaydance,F,100,179,0,179
Lakiesha,F,100,179,0,179
Mahalia,F,100,179,0,179
Malani,F,100,179,0,179
Maleigha,F,100,179,0,179
Mariaelena,F,100,179,0,179
Maricella,F,100,179,0,179
Mattias,M,100,0,179,179
Mekayla,F,100,179,0,179
Noemy,F,100,179,0,179
Nori,F,93,167,12,179
Rodriquez,M,100,0,179,179
Sammi,F,92,164,15,179
Shanise,F,100,179,0,179
Shivam,M,100,0,179,179
Tino,M,100,0,179,179
Trudie,F,100,179,0,179
Adaleigh,F,100,178,0,178
Ahuva,F,100,178,0,178
Alane,F,100,178,0,178
Angeli,F,100,178,0,178
Anirudh,M,100,0,178,178
Derron,M,100,0,178,178
Jathan,M,100,0,178,178
Jonathen,M,100,0,178,178
Keirra,F,100,178,0,178
Laylani,F,100,178,0,178
Londa,F,100,178,0,178
Loreal,F,100,178,0,178
Maximino,M,100,0,178,178
Mei,F,100,178,0,178
Naimah,F,100,178,0,178
Shanay,F,100,178,0,178
Taegan,F,73,130,48,178
Trevis,M,97,5,173,178
Triton,M,100,0,178,178
Velia,F,100,178,0,178
Yitty,F,100,178,0,178
Yusra,F,100,178,0,178
Zamari,M,70,54,124,178
Zeb,M,100,0,178,178
Zuleyka,F,100,178,0,178
Amiee,F,100,177,0,177
Andriana,F,100,177,0,177
Aoife,F,100,177,0,177
Baker,M,96,7,170,177
Damonte,M,100,0,177,177
Delina,F,100,177,0,177
Devonna,F,100,177,0,177
Kamar,M,100,0,177,177
Kamrin,M,76,43,134,177
Keshon,M,97,5,172,177
Ky,M,85,26,151,177
Latashia,F,100,177,0,177
Markia,F,100,177,0,177
Neda,F,100,177,0,177
Neville,M,100,0,177,177
Normand,M,100,0,177,177
Raena,F,100,177,0,177
Romell,M,100,0,177,177
Rosamaria,F,100,177,0,177
Siara,F,100,177,0,177
Stephannie,F,100,177,0,177
Tynisha,F,100,177,0,177
Tyriq,M,100,0,177,177
Adolphus,M,100,0,176,176
Alexzandria,F,100,176,0,176
Belva,F,100,176,0,176
Briona,F,100,176,0,176
Cavan,M,100,0,176,176
Chaney,F,82,144,32,176
Chelsee,F,100,176,0,176
Demetrious,M,100,0,176,176
Haddie,F,100,176,0,176
Jerika,F,100,176,0,176
Jesseca,F,100,176,0,176
Kathia,F,100,176,0,176
Lonzo,M,100,0,176,176
Lorianne,F,100,176,0,176
Makeda,F,100,176,0,176
Matheus,M,100,0,176,176
Neena,F,100,176,0,176
Rehan,M,97,6,170,176
Sanaya,F,100,176,0,176
Shamus,M,100,0,176,176
Shanee,F,100,176,0,176
Taurus,M,100,0,176,176
Tonette,F,100,176,0,176
Vianna,F,100,176,0,176
Yaquelin,F,100,176,0,176
Young,M,77,41,135,176
Amarah,F,100,175,0,175
Banks,M,100,0,175,175
Colston,M,100,0,175,175
Emmarie,F,100,175,0,175
Harland,M,100,0,175,175
Jerred,M,100,0,175,175
Johnette,F,100,175,0,175
Joselynn,F,100,175,0,175
Kaneesha,F,100,175,0,175
Karyl,F,100,175,0,175
Linn,M,57,75,100,175
Llewellyn,M,100,0,175,175
Martel,M,100,0,175,175
Mikaylah,F,100,175,0,175
Naia,F,100,175,0,175
Sakina,F,100,175,0,175
Shamir,M,87,22,153,175
Shepard,M,100,0,175,175
Solana,F,100,175,0,175
Tayvon,M,100,0,175,175
Torry,M,83,29,146,175
Winfield,M,100,0,175,175
Zulma,F,100,175,0,175
Aiza,F,100,174,0,174
Amberlyn,F,100,174,0,174
Benaiah,M,100,0,174,174
Breasia,F,100,174,0,174
Cipriano,M,100,0,174,174
Corbett,M,100,0,174,174
Damarius,M,100,0,174,174
Destanie,F,100,174,0,174
Devine,F,52,91,83,174
Emberly,F,100,174,0,174
Gaylord,M,100,0,174,174
Gaynell,F,100,174,0,174
Gissell,F,100,174,0,174
Ibraheem,M,100,0,174,174
Jashua,M,100,0,174,174
Jenice,F,100,174,0,174
Jeremi,M,97,6,168,174
Joette,F,100,174,0,174
Jonell,F,84,147,27,174
Kaiser,M,100,0,174,174
Kasia,F,100,174,0,174
Keontae,M,94,11,163,174
Kiptyn,M,97,5,169,174
Kitana,F,100,174,0,174
Lashae,F,100,174,0,174
Lisset,F,100,174,0,174
Loki,M,95,8,166,174
Mace,M,100,0,174,174
Merlyn,M,56,76,98,174
Naisha,F,100,174,0,174
Niall,M,100,0,174,174
Norine,F,100,174,0,174
Raeanna,F,100,174,0,174
Rosalio,M,100,0,174,174
Sayuri,F,100,174,0,174
Shalanda,F,100,174,0,174
Shaniah,F,100,174,0,174
Sharmaine,F,97,169,5,174
Shonta,F,97,169,5,174
Tahir,M,100,0,174,174
Vic,M,100,0,174,174
Yamil,M,100,0,174,174
Amaury,M,100,0,173,173
Anyah,F,100,173,0,173
Bastian,M,100,0,173,173
Brendyn,M,100,0,173,173
Cadyn,M,68,56,117,173
Cheyne,M,88,21,152,173
Coleson,M,100,0,173,173
Conrado,M,100,0,173,173
Daryll,M,100,0,173,173
Deyanira,F,100,173,0,173
Drusilla,F,100,173,0,173
Elder,M,100,0,173,173
Eliud,M,100,0,173,173
Farris,M,93,12,161,173
Gaspar,M,100,0,173,173
Georgetta,F,100,173,0,173
Glynda,F,100,173,0,173
Graig,M,100,0,173,173
Jaydah,F,100,173,0,173
Kamiah,F,100,173,0,173
Keiana,F,100,173,0,173
Kennedie,F,100,173,0,173
Keondre,M,100,0,173,173
Keylee,F,100,173,0,173
Kinsleigh,F,100,173,0,173
Kylei,F,100,173,0,173
Lawton,M,100,0,173,173
Lulu,F,100,173,0,173
Rowland,M,100,0,173,173
Tamesha,F,100,173,0,173
Tayvion,M,100,0,173,173
Vernetta,F,100,173,0,173
Wisdom,F,51,88,85,173
Zakia,F,97,168,5,173
Britani,F,100,172,0,172
Caine,M,100,0,172,172
Cammy,F,100,172,0,172
Dashon,M,100,0,172,172
Georgeann,F,100,172,0,172
Golden,M,72,49,123,172
Guillermina,F,100,172,0,172
Ivie,F,97,167,5,172
Jaycen,M,100,0,172,172
Kanon,M,85,26,146,172
Kasha,F,100,172,0,172
Kennon,M,97,5,167,172
Laquanda,F,100,172,0,172
Lin,F,65,112,60,172
Logen,M,87,22,150,172
Maizie,F,100,172,0,172
Mea,F,100,172,0,172
Phebe,F,100,172,0,172
Rayann,F,100,172,0,172
Rebekkah,F,100,172,0,172
Teo,M,100,0,172,172
Alya,F,100,171,0,171
Channel,F,100,171,0,171
Charlyn,F,100,171,0,171
Chloie,F,100,171,0,171
Dawayne,M,100,0,171,171
Ellee,F,100,171,0,171
Ferris,M,93,12,159,171
Garet,M,100,0,171,171
Gavino,M,100,0,171,171
Hussain,M,100,0,171,171
Jaykob,M,100,0,171,171
Keonna,F,100,171,0,171
Kimiko,F,100,171,0,171
Lasonya,F,100,171,0,171
Leeah,F,100,171,0,171
Luanna,F,100,171,0,171
Markanthony,M,100,0,171,171
Mikey,M,100,0,171,171
Nelida,F,100,171,0,171
Niamh,F,100,171,0,171
Porscha,F,100,171,0,171
Raekwon,M,100,0,171,171
Ricco,M,100,0,171,171
Servando,M,100,0,171,171
Sumer,F,100,171,0,171
Surya,M,74,44,127,171
Tamekia,F,100,171,0,171
Tommi,F,100,171,0,171
Treasa,F,100,171,0,171
Vann,M,100,0,171,171
Zarina,F,100,171,0,171
Addysen,F,100,170,0,170
Ammie,F,100,170,0,170
Bennet,M,96,7,163,170
Cherlyn,F,100,170,0,170
Dede,F,100,170,0,170
Eiza,F,100,170,0,170
Godfrey,M,100,0,170,170
Jamario,M,100,0,170,170
Jonmichael,M,100,0,170,170
Kasyn,M,80,34,136,170
Khloie,F,100,170,0,170
Kynnedi,F,100,170,0,170
Lue,F,72,122,48,170
Mckinzie,F,100,170,0,170
Nella,F,100,170,0,170
Nyree,F,88,149,21,170
Ozzy,M,100,0,170,170
Rashel,F,100,170,0,170
Ryu,M,100,0,170,170
Sedric,M,100,0,170,170
Shenita,F,100,170,0,170
Simcha,M,89,18,152,170
Stephine,F,100,170,0,170
Sulema,F,100,170,0,170
Taurean,M,100,0,170,170
Tempest,F,100,170,0,170
Thais,F,100,170,0,170
Theodis,M,100,0,170,170
Vishal,M,100,0,170,170
Yousuf,M,100,0,170,170
Zayan,M,100,0,170,170
Ameena,F,100,169,0,169
Amiracle,F,100,169,0,169
Amna,F,100,169,0,169
Analiese,F,100,169,0,169
Auburn,F,78,131,38,169
Avia,F,100,169,0,169
Avni,F,100,169,0,169
Cai,M,79,36,133,169
Chantay,F,100,169,0,169
Criselda,F,100,169,0,169
Gricelda,F,100,169,0,169
Hagan,M,88,21,148,169
Jazleen,F,100,169,0,169
Julieanna,F,100,169,0,169
Kaidan,M,96,6,163,169
Kaneisha,F,100,169,0,169
Lesha,F,100,169,0,169
Lida,F,100,169,0,169
Loy,M,83,28,141,169
Lynna,F,100,169,0,169
Marcoantonio,M,100,0,169,169
Maryalice,F,100,169,0,169
Miriah,F,100,169,0,169
Nyesha,F,100,169,0,169
Paizley,F,100,169,0,169
Pascal,M,100,0,169,169
Pearline,F,100,169,0,169
Telisha,F,100,169,0,169
Tionne,F,92,155,14,169
Zhane,F,82,139,30,169
Bayron,M,100,0,168,168
Candelario,M,100,0,168,168
Casimir,M,100,0,168,168
Cesia,F,100,168,0,168
Dailyn,F,76,128,40,168
Darek,M,100,0,168,168
Dathan,M,100,0,168,168
Devonne,F,64,107,61,168
Dimas,M,100,0,168,168
Donal,M,100,0,168,168
Gadiel,M,100,0,168,168
Jaceon,M,100,0,168,168
Jerardo,M,100,0,168,168
Jia,F,89,150,18,168
Katheryne,F,100,168,0,168
Kerin,F,83,140,28,168
Lebron,M,100,0,168,168
Nadiya,F,100,168,0,168
Norene,F,100,168,0,168
Saraya,F,100,168,0,168
Sera,F,100,168,0,168
Shealyn,F,100,168,0,168
Taneka,F,100,168,0,168
Torian,M,85,26,142,168
Zoila,F,100,168,0,168
Ahmari,M,71,49,118,167
Alayla,F,100,167,0,167
Allene,F,100,167,0,167
Ameen,M,100,0,167,167
Armen,M,100,0,167,167
Chaise,M,82,30,137,167
Cicely,F,100,167,0,167
Daemon,M,100,0,167,167
Daysi,F,100,167,0,167
Deziree,F,100,167,0,167
Dyanna,F,100,167,0,167
Elmo,M,100,0,167,167
Fallyn,F,100,167,0,167
Gerold,M,100,0,167,167
Golda,F,100,167,0,167
Hindy,F,100,167,0,167
Huda,F,100,167,0,167
Huy,M,100,0,167,167
Isley,F,82,137,30,167
Jamieson,M,88,20,147,167
Kalan,M,83,29,138,167
Keiara,F,100,167,0,167
Krislyn,F,100,167,0,167
Ladawn,F,100,167,0,167
Ladon,M,76,40,127,167
Lasandra,F,100,167,0,167
Merari,F,100,167,0,167
Saniah,F,100,167,0,167
Saxon,M,89,18,149,167
Shemeka,F,100,167,0,167
Shemika,F,100,167,0,167
Shifra,F,100,167,0,167
Sianna,F,100,167,0,167
Sylvan,M,96,6,161,167
Terresa,F,100,167,0,167
Verdell,M,54,76,91,167
Yonathan,M,100,0,167,167
Zaidyn,M,100,0,167,167
Abdallah,M,100,0,166,166
Angelea,F,100,166,0,166
Aubreigh,F,100,166,0,166
Baldemar,M,100,0,166,166
Britteny,F,100,166,0,166
Cassia,F,100,166,0,166
Delylah,F,100,166,0,166
Denzil,M,100,0,166,166
Eithan,M,100,0,166,166
Eyan,M,100,0,166,166
Gaby,F,100,166,0,166
Hayven,F,85,141,25,166
Jameka,F,100,166,0,166
Jeraldine,F,100,166,0,166
Jhonny,M,100,0,166,166
Katana,F,100,166,0,166
Keane,M,100,0,166,166
Kemper,M,82,30,136,166
Kenzley,F,100,166,0,166
Kiarah,F,100,166,0,166
Kym,F,81,134,32,166
Lillianne,F,100,166,0,166
Luisangel,M,100,0,166,166
Migel,M,100,0,166,166
Mychael,M,85,25,141,166
Quadir,M,100,0,166,166
Xavior,M,100,0,166,166
Yuki,F,67,112,54,166
Abbas,M,100,0,165,165
Adalina,F,100,165,0,165
Ainslee,F,100,165,0,165
Candelaria,F,100,165,0,165
Crispin,M,100,0,165,165
Daphney,F,100,165,0,165
Derian,M,94,10,155,165
Eathan,M,100,0,165,165
Flossie,F,100,165,0,165
Fynn,M,93,12,153,165
Geoffery,M,100,0,165,165
Hayle,F,100,165,0,165
Jamier,M,100,0,165,165
Jeancarlo,M,100,0,165,165
Jelisa,F,100,165,0,165
Kiona,F,100,165,0,165
Kyrstin,F,100,165,0,165
Lailani,F,100,165,0,165
Leyah,F,100,165,0,165
Makaylee,F,100,165,0,165
Mamadou,M,100,0,165,165
Margarette,F,100,165,0,165
Mesha,F,100,165,0,165
Nader,M,100,0,165,165
Raoul,M,100,0,165,165
Saba,F,93,154,11,165
Sulaiman,M,100,0,165,165
Teah,F,100,165,0,165
Terah,F,97,160,5,165
Vijay,M,100,0,165,165
Vinh,M,100,0,165,165
Winford,M,100,0,165,165
Wynne,F,92,152,13,165
Zyler,M,100,0,165,165
Abbe,F,100,164,0,164
Adarius,M,100,0,164,164
Adyn,M,85,24,140,164
Aine,F,100,164,0,164
Aleen,F,100,164,0,164
Armida,F,100,164,0,164
Beaux,M,87,22,142,164
Blayze,M,97,5,159,164
Brylan,M,97,5,159,164
Candra,F,100,164,0,164
Cj,M,100,0,164,164
Cordero,M,100,0,164,164
Delora,F,100,164,0,164
Derreck,M,100,0,164,164
Evaristo,M,100,0,164,164
Gionni,M,97,5,159,164
Jamaria,F,93,153,11,164
Jerrad,M,100,0,164,164
Keosha,F,100,164,0,164
Khamani,M,64,59,105,164
Leandre,M,100,0,164,164
Linh,F,89,146,18,164
Link,M,100,0,164,164
Macon,M,84,26,138,164
Maisha,F,100,164,0,164
Maliha,F,100,164,0,164
Mena,F,91,150,14,164
Nayelli,F,100,164,0,164
Raizel,F,100,164,0,164
Ripley,F,79,129,35,164
Shaurya,M,100,0,164,164
Tejas,M,100,0,164,164
Webster,M,100,0,164,164
Zabrina,F,100,164,0,164
Zakari,M,80,32,132,164
Amairany,F,100,163,0,163
Carlito,M,100,0,163,163
Delaina,F,100,163,0,163
Delinda,F,100,163,0,163
Ebonee,F,100,163,0,163
Eliah,M,74,43,120,163
Elyas,M,100,0,163,163
Erianna,F,100,163,0,163
Ilyas,M,100,0,163,163
Joline,F,100,163,0,163
Khaliah,F,100,163,0,163
Lauran,F,100,163,0,163
Lucianna,F,100,163,0,163
Maida,F,100,163,0,163
Maryssa,F,100,163,0,163
Maxon,M,100,0,163,163
Nyjah,M,51,80,83,163
Reya,F,100,163,0,163
Sharae,F,100,163,0,163
Signe,F,100,163,0,163
Toi,F,96,157,6,163
Wyman,M,100,0,163,163
Yarel,F,75,123,40,163
Zada,F,100,163,0,163
Alexzandra,F,100,162,0,162
Antwaun,M,100,0,162,162
Benigno,M,100,0,162,162
Benji,M,100,0,162,162
Carrigan,F,100,162,0,162
Cherelle,F,100,162,0,162
Chloey,F,100,162,0,162
Claribel,F,100,162,0,162
Courtenay,F,79,128,34,162
Dayvon,M,100,0,162,162
Easter,F,100,162,0,162
Elliette,F,100,162,0,162
Ezell,M,100,0,162,162
Francene,F,100,162,0,162
Freedom,F,62,101,61,162
Joceline,F,100,162,0,162
Journei,F,100,162,0,162
Keelin,F,67,109,53,162
Keelyn,F,82,133,29,162
Krew,M,100,0,162,162
Maryrose,F,100,162,0,162
Nicollette,F,100,162,0,162
Rahim,M,100,0,162,162
Raychel,F,100,162,0,162
Reema,F,100,162,0,162
Stevi,F,100,162,0,162
Tyonna,F,100,162,0,162
Ajah,F,100,161,0,161
Allisa,F,100,161,0,161
Bao,M,56,71,90,161
Billi,F,100,161,0,161
Blima,F,100,161,0,161
Bliss,F,100,161,0,161
Dallis,F,64,103,58,161
Danell,F,73,118,43,161
Dodie,F,100,161,0,161
Erykah,F,100,161,0,161
Fulton,M,100,0,161,161
Gustav,M,100,0,161,161
Halli,F,100,161,0,161
Hermelinda,F,100,161,0,161
Iyla,F,100,161,0,161
Jaide,F,100,161,0,161
Jerrel,M,100,0,161,161
Katrena,F,100,161,0,161
Keirsten,F,100,161,0,161
Kendel,M,55,72,89,161
Kiyana,F,100,161,0,161
Lajuana,F,100,161,0,161
Lamonica,F,100,161,0,161
Mykenzie,F,100,161,0,161
Naomie,F,100,161,0,161
Rashell,F,100,161,0,161
Shreyas,M,100,0,161,161
Tasneem,F,100,161,0,161
Treena,F,100,161,0,161
Ulisses,M,100,0,161,161
Yazan,M,100,0,161,161
Aaralyn,F,100,160,0,160
Adryan,M,90,16,144,160
Aislin,F,100,160,0,160
Alita,F,100,160,0,160
Anylah,F,100,160,0,160
Arlena,F,100,160,0,160
Asiyah,F,89,142,18,160
Cameran,M,58,68,92,160
Darious,M,100,0,160,160
Dorris,F,76,121,39,160
Hosanna,F,100,160,0,160
Ieshia,F,100,160,0,160
Ivelisse,F,100,160,0,160
Josefa,F,100,160,0,160
Jovi,F,74,118,42,160
Julietta,F,100,160,0,160
Kalib,M,100,0,160,160
Khalilah,F,100,160,0,160
Lanaya,F,100,160,0,160
Lemar,M,100,0,160,160
Lenin,M,100,0,160,160
Maddilyn,F,100,160,0,160
Michelangelo,M,100,0,160,160
Nicolo,M,100,0,160,160
Ramel,M,100,0,160,160
Roslynn,F,100,160,0,160
Sione,M,100,0,160,160
Theodor,M,100,0,160,160
Vasilios,M,100,0,160,160
Verne,M,89,17,143,160
Yitzchak,M,100,0,160,160
Aleeya,F,100,159,0,159
Ardith,F,100,159,0,159
Artemis,F,75,119,40,159
Ayub,M,100,0,159,159
Calum,M,100,0,159,159
Cerenity,F,100,159,0,159
Cheyann,F,100,159,0,159
Curley,M,85,24,135,159
Darel,M,100,0,159,159
Duran,M,100,0,159,159
Edin,M,90,16,143,159
Haris,M,100,0,159,159
Jaxyn,M,77,36,123,159
Kailin,F,89,141,18,159
Keenen,M,100,0,159,159
Le,F,64,102,57,159
Lorretta,F,100,159,0,159
Mcarthur,M,100,0,159,159
Melita,F,100,159,0,159
Necole,F,100,159,0,159
Neida,F,100,159,0,159
Nijah,F,84,133,26,159
Nilah,F,100,159,0,159
Paulino,M,100,0,159,159
Quan,M,100,0,159,159
Shyanna,F,100,159,0,159
Silverio,M,100,0,159,159
Taelynn,F,100,159,0,159
Tennille,F,100,159,0,159
Tennyson,M,73,43,116,159
Trystin,M,79,34,125,159
Xitlaly,F,100,159,0,159
Zade,M,100,0,159,159
Zayra,F,100,159,0,159
Alphonzo,M,100,0,158,158
Amee,F,100,158,0,158
Arial,F,100,158,0,158
Briseyda,F,100,158,0,158
Brison,M,100,0,158,158
Christena,F,100,158,0,158
Davien,M,100,0,158,158
Deneen,F,100,158,0,158
Deryl,M,92,12,146,158
Deserae,F,100,158,0,158
Donella,F,100,158,0,158
Edsel,M,100,0,158,158
Eleana,F,100,158,0,158
Farhan,M,100,0,158,158
Heston,M,100,0,158,158
Jailah,F,100,158,0,158
Jawan,M,96,7,151,158
Juaquin,M,100,0,158,158
Keandra,F,100,158,0,158
Linley,F,100,158,0,158
Maizy,F,100,158,0,158
Naudia,F,100,158,0,158
Pavel,M,100,0,158,158
Radley,M,94,10,148,158
Rilyn,F,89,140,18,158
Roby,M,96,6,152,158
Robynn,F,100,158,0,158
Roya,F,100,158,0,158
Sela,F,100,158,0,158
Shandi,F,100,158,0,158
Talaya,F,100,158,0,158
Wende,F,100,158,0,158
Yancey,M,100,0,158,158
Aaniyah,F,100,157,0,157
Alexei,M,92,13,144,157
Amada,F,100,157,0,157
Amen,M,64,57,100,157
Amoni,F,83,130,27,157
Annalyn,F,100,157,0,157
Antron,M,100,0,157,157
Arien,M,59,64,93,157
Avonlea,F,100,157,0,157
Bridgit,F,100,157,0,157
Cutter,M,100,0,157,157
Darryle,M,100,0,157,157
Dionicio,M,100,0,157,157
Elysa,F,100,157,0,157
Jacory,M,100,0,157,157
Jakiyah,F,100,157,0,157
Jamyah,F,100,157,0,157
Janasia,F,100,157,0,157
Jonnathan,M,100,0,157,157
Kathey,F,100,157,0,157
Lynetta,F,100,157,0,157
Macklin,M,100,0,157,157
Maysen,F,54,85,72,157
Rakim,M,100,0,157,157
Raziel,M,100,0,157,157
Serinity,F,100,157,0,157
Shamia,F,100,157,0,157
Sneha,F,100,157,0,157
Taylan,M,67,52,105,157
Theophilus,M,100,0,157,157
Breckyn,F,73,114,42,156
Chas,M,97,5,151,156
Cleon,M,100,0,156,156
Cyan,F,89,139,17,156
Daris,M,85,23,133,156
Dea,F,97,151,5,156
December,F,100,156,0,156
Desmon,M,100,0,156,156
Emeli,F,100,156,0,156
Giavonna,F,100,156,0,156
Granville,M,100,0,156,156
Grisel,F,100,156,0,156
Haroon,M,100,0,156,156
Howell,M,100,0,156,156
Jacobe,M,100,0,156,156
Jariah,F,81,126,30,156
Jennefer,F,100,156,0,156
Kaitlan,F,100,156,0,156
Kally,F,100,156,0,156
Kandyce,F,100,156,0,156
Karima,F,100,156,0,156
Keilyn,F,77,120,36,156
Keshav,M,100,0,156,156
Kiel,M,100,0,156,156
Larson,M,92,12,144,156
Meisha,F,100,156,0,156
Mihir,M,100,0,156,156
Mirabelle,F,100,156,0,156
Navy,F,79,123,33,156
Oneal,M,100,0,156,156
Priyanka,F,100,156,0,156
Quanisha,F,100,156,0,156
Rashonda,F,100,156,0,156
Rima,F,100,156,0,156
Serge,M,100,0,156,156
Shade,F,51,80,76,156
Tressie,F,100,156,0,156
Wayman,M,100,0,156,156
Alyah,F,100,155,0,155
Anamarie,F,100,155,0,155
Ardis,F,74,114,41,155
Bobbijo,F,100,155,0,155
Bowie,M,70,46,109,155
Catlin,F,73,113,42,155
Chazz,M,100,0,155,155
Cherryl,F,100,155,0,155
Coco,F,100,155,0,155
Conway,M,100,0,155,155
Cornelious,M,100,0,155,155
Crysta,F,100,155,0,155
Dalene,F,100,155,0,155
Darianna,F,100,155,0,155
Darry,M,100,0,155,155
Eron,M,95,8,147,155
Geena,F,100,155,0,155
Giacomo,M,100,0,155,155
Graycen,F,60,93,62,155
Idella,F,100,155,0,155
Isaih,M,100,0,155,155
Jacolby,M,100,0,155,155
Jannelle,F,100,155,0,155
Keilan,M,100,0,155,155
Kensie,F,100,155,0,155
Keonte,M,100,0,155,155
Lakita,F,100,155,0,155
Laurette,F,100,155,0,155
Laynee,F,100,155,0,155
Lecia,F,100,155,0,155
Leda,F,100,155,0,155
Mallori,F,100,155,0,155
Mckenzy,F,100,155,0,155
Nathon,M,100,0,155,155
Nyssa,F,100,155,0,155
Orson,M,100,0,155,155
Raisa,F,100,155,0,155
Rubie,F,100,155,0,155
Rudra,M,100,0,155,155
Samarth,M,100,0,155,155
Shamiya,F,100,155,0,155
Shatara,F,100,155,0,155
Sigrid,F,100,155,0,155
Sixto,M,100,0,155,155
Tal,M,68,49,106,155
Wendall,M,100,0,155,155
Willam,M,100,0,155,155
Zayna,F,100,155,0,155
Anastacio,M,100,0,154,154
Arnell,M,73,41,113,154
Breeann,F,100,154,0,154
Brileigh,F,100,154,0,154
Briseis,F,100,154,0,154
Calin,M,86,22,132,154
Camry,F,86,133,21,154
Consuela,F,100,154,0,154
De,M,52,74,80,154
Deysi,F,100,154,0,154
Fahad,M,100,0,154,154
Fantasia,F,100,154,0,154
Garner,M,92,13,141,154
Hennessy,F,100,154,0,154
Jene,F,88,135,19,154
Jerrett,M,100,0,154,154
Jin,M,79,32,122,154
Kaelee,F,100,154,0,154
Kimmie,F,92,141,13,154
Race,M,100,0,154,154
Sharod,M,100,0,154,154
Sultan,M,100,0,154,154
Sylus,M,100,0,154,154
Terrica,F,100,154,0,154
Wilhelm,M,100,0,154,154
Yohan,M,100,0,154,154
Zaki,M,100,0,154,154
Zavian,M,100,0,154,154
Zenia,F,100,154,0,154
Adell,F,75,115,38,153
Alexius,F,94,144,9,153
Aryah,F,100,153,0,153
Braylyn,F,56,86,67,153
Caridad,F,100,153,0,153
Chere,F,100,153,0,153
Daymon,M,100,0,153,153
Emilly,F,100,153,0,153
Evelia,F,100,153,0,153
Gala,F,100,153,0,153
Gretel,F,100,153,0,153
Gustave,M,100,0,153,153
Hipolito,M,100,0,153,153
Jc,M,100,0,153,153
Jowell,M,100,0,153,153
Jozlyn,F,100,153,0,153
Judge,M,100,0,153,153
Lovie,F,92,140,13,153
Marlaina,F,100,153,0,153
Meleah,F,100,153,0,153
Michayla,F,100,153,0,153
Neko,M,71,44,109,153
Nicoletta,F,100,153,0,153
Rhyder,M,95,8,145,153
Riccardo,M,100,0,153,153
Safia,F,100,153,0,153
Shalynn,F,100,153,0,153
Shamara,F,100,153,0,153
Shondra,F,100,153,0,153
Tyjuan,M,100,0,153,153
Zackariah,M,100,0,153,153
Zakai,M,100,0,153,153
Addisen,F,100,152,0,152
Adreanna,F,100,152,0,152
Aisley,F,100,152,0,152
Aldair,M,100,0,152,152
Ashante,F,84,127,25,152
Axle,M,100,0,152,152
Aylah,F,100,152,0,152
Christon,M,86,21,131,152
Delta,F,97,147,5,152
Deshun,M,95,8,144,152
Edgard,M,100,0,152,152
Emarie,F,100,152,0,152
Eoin,M,100,0,152,152
Hazen,M,97,5,147,152
Jadarius,M,100,0,152,152
Jawad,M,100,0,152,152
Jetta,F,100,152,0,152
Joannie,F,100,152,0,152
Jospeh,M,100,0,152,152
Kandra,F,100,152,0,152
Kemberly,F,100,152,0,152
Khristina,F,100,152,0,152
Kriston,F,62,94,58,152
Lashaunda,F,100,152,0,152
Lizett,F,100,152,0,152
Marisha,F,100,152,0,152
Mazen,M,100,0,152,152
Meira,F,100,152,0,152
Natan,M,100,0,152,152
Ninfa,F,100,152,0,152
Oliva,F,100,152,0,152
Serafin,M,100,0,152,152
Sia,F,100,152,0,152
Starlene,F,100,152,0,152
Takara,F,100,152,0,152
Vanita,F,100,152,0,152
Vashti,F,100,152,0,152
Zyana,F,100,152,0,152
Aleksandar,M,100,0,151,151
Alexsander,M,100,0,151,151
Anistyn,F,100,151,0,151
Arianah,F,100,151,0,151
Arieanna,F,100,151,0,151
Bellamy,F,100,151,0,151
Connell,M,100,0,151,151
Corrinne,F,100,151,0,151
Dyamond,F,100,151,0,151
Dyland,M,100,0,151,151
Elwin,M,100,0,151,151
Elyn,F,96,145,6,151
Genessis,F,100,151,0,151
Hogan,M,100,0,151,151
Jarid,M,100,0,151,151
Jarron,M,100,0,151,151
Julene,F,100,151,0,151
Jun,M,93,11,140,151
Karizma,F,100,151,0,151
Kelson,M,100,0,151,151
Lanora,F,100,151,0,151
Leiah,F,100,151,0,151
Leya,F,100,151,0,151
Lionell,M,100,0,151,151
Loria,F,100,151,0,151
Maddisyn,F,100,151,0,151
Madina,F,100,151,0,151
Marylyn,F,100,151,0,151
Merideth,F,100,151,0,151
Nehemias,M,100,0,151,151
Nivea,F,100,151,0,151
Nyle,M,100,0,151,151
Rajon,M,100,0,151,151
Sharell,F,100,151,0,151
Sylar,M,96,6,145,151
Tou,M,100,0,151,151
Twanda,F,100,151,0,151
Tywan,M,100,0,151,151
Alaiyah,F,100,150,0,150
Asad,M,100,0,150,150
Bertrand,M,100,0,150,150
Carmon,F,72,108,42,150
Daira,F,100,150,0,150
Demarkus,M,100,0,150,150
Derric,M,100,0,150,150
Donelle,F,77,116,34,150
Emmalin,F,100,150,0,150
Francina,F,100,150,0,150
Ileen,F,100,150,0,150
Jayvian,M,100,0,150,150
Jentry,F,74,111,39,150
Jionni,M,100,0,150,150
Kellin,M,100,0,150,150
Kennan,M,93,11,139,150
Latarsha,F,100,150,0,150
Leonna,F,100,150,0,150
Leylani,F,100,150,0,150
Lilibeth,F,100,150,0,150
Madelene,F,100,150,0,150
Naveah,F,100,150,0,150
Raelee,F,100,150,0,150
Ramya,F,100,150,0,150
Rya,F,100,150,0,150
Sharlyn,F,100,150,0,150
Sina,F,62,93,57,150
Tali,F,89,134,16,150
Tamiyah,F,100,150,0,150
Tenesha,F,100,150,0,150
Vy,F,93,140,10,150
Wellington,M,100,0,150,150
Addy,F,97,144,5,149
Akayla,F,100,149,0,149
Amere,M,91,13,136,149
Asante,M,84,24,125,149
Avaya,F,100,149,0,149
Awilda,F,100,149,0,149
Bunny,F,97,144,5,149
Darryll,M,100,0,149,149
Dayra,F,100,149,0,149
Everest,M,89,17,132,149
Hamzah,M,100,0,149,149
Harmonee,F,100,149,0,149
Haya,F,100,149,0,149
Hobert,M,100,0,149,149
Indya,F,100,149,0,149
Jashaun,M,100,0,149,149
Kassidi,F,100,149,0,149
Khyree,M,100,0,149,149
Kiani,F,100,149,0,149
Kolbi,F,72,108,41,149
Kordell,M,100,0,149,149
Malayna,F,100,149,0,149
Malory,F,100,149,0,149
Marquell,M,100,0,149,149
Mayrin,F,100,149,0,149
Pa,F,97,144,5,149
Riyan,F,52,77,72,149
Shamira,F,100,149,0,149
Shulem,M,100,0,149,149
Tadd,M,100,0,149,149
Temple,F,82,122,27,149
Teryn,F,88,131,18,149
Tiona,F,100,149,0,149
Abriel,F,51,75,73,148
Alessio,M,100,0,148,148
Analeah,F,100,148,0,148
Arnie,M,100,0,148,148
Azia,F,100,148,0,148
Breauna,F,100,148,0,148
Briannah,F,100,148,0,148
Danasia,F,100,148,0,148
Dany,M,96,6,142,148
Darya,F,100,148,0,148
Daunte,M,100,0,148,148
Gennaro,M,100,0,148,148
Giovonni,M,100,0,148,148
Hanson,M,100,0,148,148
Jazlin,F,100,148,0,148
Kamie,F,100,148,0,148
Laury,F,97,143,5,148
Levin,M,100,0,148,148
Linnie,F,79,117,31,148
Linzy,F,78,116,32,148
Meena,F,100,148,0,148
Mekenzie,F,100,148,0,148
My,F,81,120,28,148
Myisha,F,100,148,0,148
Nickey,M,78,33,115,148
Nikayla,F,100,148,0,148
Obie,M,100,0,148,148
Patton,M,92,12,136,148
Phylis,F,100,148,0,148
Renetta,F,100,148,0,148
Rockwell,M,100,0,148,148
Shannah,F,100,148,0,148
Shannel,F,100,148,0,148
Sonali,F,100,148,0,148
Tamarah,F,100,148,0,148
Thomasine,F,100,148,0,148
Tryston,M,100,0,148,148
Vittoria,F,100,148,0,148
Wendel,M,100,0,148,148
Wynona,F,100,148,0,148
Adelita,F,100,147,0,147
Angelee,F,100,147,0,147
Angelene,F,100,147,0,147
Ardell,M,69,45,102,147
Bartley,M,100,0,147,147
Billiejo,F,100,147,0,147
Catheryn,F,100,147,0,147
Cheyanna,F,100,147,0,147
Christianne,F,100,147,0,147
Claud,M,100,0,147,147
Dakarai,M,100,0,147,147
Davontae,M,100,0,147,147
Delena,F,100,147,0,147
Derry,M,93,11,136,147
Dovie,F,100,147,0,147
Edric,M,100,0,147,147
Eugenie,F,100,147,0,147
Evelyne,F,100,147,0,147
Izamar,F,95,140,7,147
Jaunita,F,100,147,0,147
Jibril,M,100,0,147,147
Jr,M,100,0,147,147
Keir,M,93,11,136,147
Lainee,F,100,147,0,147
Lonnell,M,100,0,147,147
Lyndsie,F,100,147,0,147
Mackenzy,F,92,135,12,147
Maelee,F,100,147,0,147
Maricarmen,F,100,147,0,147
Mellanie,F,100,147,0,147
Morrison,M,93,11,136,147
Panagiotis,M,100,0,147,147
Rebeccah,F,100,147,0,147
Reco,M,100,0,147,147
Rider,M,100,0,147,147
Romaine,F,62,91,56,147
Sandee,F,100,147,0,147
Shantae,F,100,147,0,147
Talin,M,66,50,97,147
Tammera,F,100,147,0,147
Vina,F,100,147,0,147
Winslow,M,77,34,113,147
Zuleika,F,100,147,0,147
Alaynah,F,100,146,0,146
Amer,M,100,0,146,146
Amore,F,84,123,23,146
Arne,M,100,0,146,146
Ash,M,97,5,141,146
Camrin,M,84,24,122,146
Daiana,F,100,146,0,146
Debroah,F,100,146,0,146
Devina,F,100,146,0,146
Dresden,M,84,24,122,146
Ellington,F,52,76,70,146
Eshan,M,100,0,146,146
Garvin,M,100,0,146,146
Heba,F,100,146,0,146
Jabril,M,100,0,146,146
Jacquetta,F,100,146,0,146
Jafet,M,100,0,146,146
Jarrid,M,100,0,146,146
Johnathen,M,100,0,146,146
Kalisha,F,100,146,0,146
Kaytlynn,F,100,146,0,146
Keyan,M,100,0,146,146
Kimmy,F,84,123,23,146
Knowledge,M,97,5,141,146
Kortni,F,100,146,0,146
Leen,F,100,146,0,146
Leighanne,F,100,146,0,146
Maurine,F,100,146,0,146
Mayla,F,100,146,0,146
Meara,F,100,146,0,146
Niccole,F,100,146,0,146
Ori,M,82,27,119,146
Raye,F,91,133,13,146
Sabino,M,100,0,146,146
Schyler,M,62,56,90,146
Shanea,F,100,146,0,146
Shannen,F,97,141,5,146
Steffan,M,100,0,146,146
Steffen,M,100,0,146,146
Taylon,M,86,21,125,146
Thorin,M,100,0,146,146
Toriano,M,100,0,146,146
Vinnie,M,54,67,79,146
Abiel,M,100,0,145,145
Alexxis,F,100,145,0,145
Alica,F,100,145,0,145
Avamarie,F,100,145,0,145
Aziz,M,100,0,145,145
Bram,M,100,0,145,145
Camillia,F,100,145,0,145
Dusten,M,100,0,145,145
Elif,F,100,145,0,145
Emileigh,F,100,145,0,145
Gearldine,F,100,145,0,145
Henna,F,100,145,0,145
Jasean,M,100,0,145,145
Joli,F,100,145,0,145
Keagen,M,97,5,140,145
Kearra,F,100,145,0,145
Kenrick,M,100,0,145,145
Koltyn,M,100,0,145,145
Lamia,F,100,145,0,145
Lillyanne,F,100,145,0,145
Lyssa,F,100,145,0,145
Mathis,M,100,0,145,145
Micahel,M,100,0,145,145
Monalisa,F,100,145,0,145
Nadiyah,F,100,145,0,145
Nicholette,F,100,145,0,145
Nissa,F,100,145,0,145
Pearson,M,96,6,139,145
Ravon,M,74,37,108,145
Rayce,M,100,0,145,145
Reginae,F,100,145,0,145
Taunya,F,100,145,0,145
Theda,F,100,145,0,145
Tiberius,M,100,0,145,145
Tyeisha,F,100,145,0,145
Tytiana,F,100,145,0,145
Tytus,M,100,0,145,145
Yecenia,F,100,145,0,145
Alejandrina,F,100,144,0,144
Andru,M,100,0,144,144
Anglea,F,100,144,0,144
Arun,M,100,0,144,144
Bethanne,F,100,144,0,144
Betsey,F,100,144,0,144
Brittan,F,65,94,50,144
Caidyn,M,69,45,99,144
Cyndy,F,100,144,0,144
Ehren,M,100,0,144,144
Elani,F,100,144,0,144
Emaan,F,92,133,11,144
Ennis,M,100,0,144,144
Errick,M,100,0,144,144
Haydon,M,90,14,130,144
Hinda,F,100,144,0,144
Ilyana,F,100,144,0,144
Iqra,F,100,144,0,144
Isra,F,100,144,0,144
Issiah,M,100,0,144,144
Jordann,F,95,137,7,144
Kanyon,M,100,0,144,144
Katherina,F,100,144,0,144
Kerrington,F,85,122,22,144
Khloey,F,100,144,0,144
Khylee,F,100,144,0,144
Kina,F,100,144,0,144
Korin,F,90,129,15,144
Kymber,F,100,144,0,144
Lillee,F,100,144,0,144
Mitzy,F,100,144,0,144
Moishe,M,100,0,144,144
Monserrath,F,100,144,0,144
Nakeisha,F,100,144,0,144
Rahma,F,100,144,0,144
Rawan,F,100,144,0,144
Reda,F,72,104,40,144
Ronica,F,100,144,0,144
Ryanna,F,100,144,0,144
Samarah,F,100,144,0,144
Sanchez,M,96,6,138,144
Sascha,F,70,101,43,144
Shayden,M,72,41,103,144
Sherell,F,100,144,0,144
Tereasa,F,100,144,0,144
Thresa,F,100,144,0,144
Waylan,M,100,0,144,144
Willette,F,100,144,0,144
Zakery,M,100,0,144,144
Abimael,M,100,0,143,143
Adisyn,F,100,143,0,143
Allee,F,100,143,0,143
Aloysius,M,100,0,143,143
Anvi,F,100,143,0,143
Aribella,F,100,143,0,143
Augusto,M,100,0,143,143
Braydan,M,100,0,143,143
Brina,F,100,143,0,143
Caressa,F,100,143,0,143
Chyenne,F,100,143,0,143
Curran,M,94,9,134,143
Dayshawn,M,100,0,143,143
Demar,M,100,0,143,143
Dominga,F,100,143,0,143
Dorie,F,100,143,0,143
Falon,F,97,138,5,143
Frederica,F,100,143,0,143
Gardner,M,100,0,143,143
Hendrik,M,100,0,143,143
Indie,F,88,126,17,143
Iziah,M,100,0,143,143
Jahaziel,M,100,0,143,143
Jamaica,F,100,143,0,143
Jaymi,F,100,143,0,143
Lavada,F,100,143,0,143
Lavonna,F,100,143,0,143
Loralee,F,100,143,0,143
Marvis,M,60,57,86,143
Naja,F,100,143,0,143
Nawal,F,100,143,0,143
Nima,M,76,34,109,143
Octavious,M,100,0,143,143
Oona,F,100,143,0,143
Prescott,M,100,0,143,143
Rhiley,F,69,99,44,143
Rommel,M,100,0,143,143
Roshawn,M,66,48,95,143
Saleh,M,100,0,143,143
Tallon,M,100,0,143,143
Tanis,F,60,86,57,143
Vaughan,M,95,7,136,143
Verity,F,100,143,0,143
Vernie,M,71,42,101,143
Acelynn,F,100,142,0,142
Aishah,F,100,142,0,142
Belia,F,100,142,0,142
Bernardino,M,100,0,142,142
Braydin,M,100,0,142,142
Delon,M,95,7,135,142
Denzell,M,100,0,142,142
Donetta,F,100,142,0,142
Elizabet,F,100,142,0,142
Evangelos,M,100,0,142,142
Francois,M,100,0,142,142
Franki,F,94,134,8,142
Gracee,F,100,142,0,142
Gussie,F,89,126,16,142
Ishani,F,100,142,0,142
Jahaira,F,100,142,0,142
Jasson,M,100,0,142,142
Jenette,F,100,142,0,142
Juvenal,M,100,0,142,142
Layden,M,96,6,136,142
Leighanna,F,100,142,0,142
Mairead,F,100,142,0,142
Manal,F,100,142,0,142
Melanee,F,100,142,0,142
Meta,F,100,142,0,142
Morghan,F,100,142,0,142
Mykala,F,100,142,0,142
Nahomy,F,100,142,0,142
Neill,M,100,0,142,142
Philippa,F,100,142,0,142
Sania,F,100,142,0,142
Shavonda,F,100,142,0,142
Shera,F,100,142,0,142
Tahira,F,100,142,0,142
Tandy,F,73,103,39,142
Taren,F,75,107,35,142
Tray,M,100,0,142,142
Tyshon,M,100,0,142,142
Verlin,M,100,0,142,142
Wonda,F,100,142,0,142
Adrean,M,70,42,99,141
Aleeza,F,100,141,0,141
Alekzander,M,100,0,141,141
Breelyn,F,100,141,0,141
Bricen,M,100,0,141,141
Cillian,M,100,0,141,141
Curry,M,94,8,133,141
Dartagnan,M,100,0,141,141
Edyn,F,90,127,14,141
Etienne,M,95,7,134,141
Exavier,M,100,0,141,141
Ezri,F,87,123,18,141
Graci,F,100,141,0,141
Jakiya,F,100,141,0,141
Jonte,M,81,27,114,141
Kaisen,M,96,6,135,141
Kemani,M,52,68,73,141
Lariah,F,100,141,0,141
Latoyia,F,100,141,0,141
Laurice,F,87,123,18,141
Mariko,F,100,141,0,141
Martavious,M,100,0,141,141
Rashaud,M,100,0,141,141
Sable,F,100,141,0,141
Shain,M,96,6,135,141
Sharhonda,F,100,141,0,141
Sicily,F,100,141,0,141
Steffani,F,100,141,0,141
Taylynn,F,100,141,0,141
Teddi,F,100,141,0,141
Teddie,M,62,53,88,141
Tiffney,F,100,141,0,141
Timia,F,100,141,0,141
Tuan,M,100,0,141,141
Tyrik,M,100,0,141,141
Usman,M,100,0,141,141
Venetia,F,100,141,0,141
Ailin,F,100,140,0,140
Akia,F,94,132,8,140
Avon,M,63,52,88,140
Ayonna,F,100,140,0,140
Aziah,F,61,85,55,140
Cailynn,F,100,140,0,140
Catelynn,F,100,140,0,140
Cornelio,M,100,0,140,140
Cuauhtemoc,M,100,0,140,140
Darlena,F,100,140,0,140
Dasean,M,100,0,140,140
Destry,M,91,12,128,140
Dutch,M,100,0,140,140
Dylann,F,57,80,60,140
Eowyn,F,100,140,0,140
Gittel,F,100,140,0,140
Jazz,M,61,55,85,140
Jeslyn,F,100,140,0,140
Johnell,M,86,19,121,140
Justo,M,100,0,140,140
Kalil,M,100,0,140,140
Katelynne,F,100,140,0,140
Keeli,F,100,140,0,140
Kimbra,F,100,140,0,140
Kinzlee,F,100,140,0,140
Marquese,M,100,0,140,140
Michaelle,F,100,140,0,140
Myleigh,F,100,140,0,140
Nam,M,100,0,140,140
Neomi,F,100,140,0,140
October,F,100,140,0,140
Orianna,F,100,140,0,140
Paetyn,F,96,135,5,140
Rayonna,F,100,140,0,140
Samer,M,100,0,140,140
Sherril,F,96,135,5,140
Teia,F,100,140,0,140
Zeth,M,100,0,140,140
Aisling,F,100,139,0,139
Aleczander,M,100,0,139,139
Armondo,M,100,0,139,139
Beverlee,F,100,139,0,139
Briauna,F,100,139,0,139
Brodey,M,100,0,139,139
Cassady,F,91,127,12,139
Chrystian,M,90,14,125,139
Dijon,M,96,6,133,139
Donzell,M,100,0,139,139
Early,M,94,9,130,139
Ellah,F,100,139,0,139
Ellia,F,100,139,0,139
Gaia,F,100,139,0,139
Genia,F,100,139,0,139
Hadassa,F,100,139,0,139
Hensley,F,90,125,14,139
Jamilet,F,100,139,0,139
Jaynie,F,100,139,0,139
Jeane,F,100,139,0,139
Kalissa,F,100,139,0,139
Kaysha,F,100,139,0,139
Kaysie,F,100,139,0,139
Leviticus,M,100,0,139,139
Lilla,F,100,139,0,139
Lindley,F,83,115,24,139
Lyam,M,100,0,139,139
Manning,M,88,16,123,139
Nasser,M,100,0,139,139
Phuong,F,77,107,32,139
Raynaldo,M,100,0,139,139
Sabella,F,100,139,0,139
Sama,F,100,139,0,139
Shareef,M,100,0,139,139
Shereen,F,100,139,0,139
Sidra,F,100,139,0,139
Silvio,M,100,0,139,139
Tajh,M,100,0,139,139
Teaghan,F,94,131,8,139
Theadore,M,100,0,139,139
Torre,M,67,46,93,139
Trinidy,F,96,134,5,139
Waldo,M,100,0,139,139
Werner,M,100,0,139,139
Zamiyah,F,100,139,0,139
Aaiden,M,100,0,138,138
Ahana,F,100,138,0,138
Antuan,M,100,0,138,138
Azlynn,F,100,138,0,138
Basilio,M,100,0,138,138
Brenner,M,96,5,133,138
Britnie,F,100,138,0,138
Chason,M,100,0,138,138
Clarisse,F,100,138,0,138
Correy,M,100,0,138,138
Dandrea,F,88,121,17,138
Darice,F,100,138,0,138
Destani,F,100,138,0,138
Eros,M,100,0,138,138
Fitzgerald,M,100,0,138,138
Gidget,F,100,138,0,138
Graciella,F,100,138,0,138
Helaina,F,100,138,0,138
Jadore,F,86,119,19,138
Jakia,F,100,138,0,138
Jariyah,F,100,138,0,138
Jaylani,F,96,132,6,138
Jonae,F,100,138,0,138
Karlton,M,100,0,138,138
Kennie,M,80,28,110,138
Kenzlee,F,100,138,0,138
Kervin,M,100,0,138,138
Kristeen,F,100,138,0,138
Laikyn,F,100,138,0,138
Laquinta,F,100,138,0,138
Lorissa,F,100,138,0,138
Lyanna,F,100,138,0,138
Mahi,F,100,138,0,138
Mali,F,96,133,5,138
Marcey,F,100,138,0,138
Markeisha,F,100,138,0,138
Marshell,F,64,89,49,138
Mataya,F,100,138,0,138
Nannie,F,100,138,0,138
Rashelle,F,100,138,0,138
Sharika,F,100,138,0,138
Sharri,F,100,138,0,138
Shawanna,F,100,138,0,138
Shawnte,F,96,132,6,138
Sholom,M,100,0,138,138
Soham,M,100,0,138,138
Tahiry,F,100,138,0,138
Tayton,M,100,0,138,138
Thao,F,83,114,24,138
Truitt,M,100,0,138,138
Weslee,M,86,20,118,138
Ahtziri,F,100,137,0,137
Alfonza,M,100,0,137,137
Amyiah,F,100,137,0,137
Anahy,F,100,137,0,137
Annissa,F,100,137,0,137
Anny,F,100,137,0,137
Avalee,F,100,137,0,137
Bela,F,70,96,41,137
Bibiana,F,100,137,0,137
Caedmon,M,100,0,137,137
Charlena,F,100,137,0,137
Dava,F,100,137,0,137
Diante,M,100,0,137,137
Duston,M,100,0,137,137
Emaleigh,F,100,137,0,137
Eryka,F,100,137,0,137
Finnigan,M,100,0,137,137
Freyja,F,100,137,0,137
Jadelynn,F,100,137,0,137
Jaliah,F,100,137,0,137
Jameelah,F,100,137,0,137
Jessyca,F,100,137,0,137
Johndavid,M,100,0,137,137
Kaeleigh,F,100,137,0,137
Kambri,F,100,137,0,137
Kavion,M,100,0,137,137
Keylan,M,88,16,121,137
Kynzlee,F,100,137,0,137
Lambert,M,100,0,137,137
Lavette,F,100,137,0,137
Mallie,F,93,127,10,137
Marrissa,F,100,137,0,137
Matthews,M,100,0,137,137
Mehki,M,100,0,137,137
Mylo,M,95,7,130,137
Nakiyah,F,100,137,0,137
Nava,F,100,137,0,137
Nneka,F,100,137,0,137
Noland,M,100,0,137,137
Pricila,F,100,137,0,137
Rama,F,83,114,23,137
Saida,F,100,137,0,137
Sheronda,F,100,137,0,137
Stratton,M,100,0,137,137
Tayah,F,100,137,0,137
Teigan,F,58,79,58,137
Theressa,F,100,137,0,137
Vinny,M,100,0,137,137
Zamya,F,100,137,0,137
Zarek,M,100,0,137,137
Adalynne,F,100,136,0,136
Aeden,M,100,0,136,136
Airam,F,85,115,21,136
Albertha,F,100,136,0,136
Alicea,F,100,136,0,136
Ammy,F,100,136,0,136
Anica,F,100,136,0,136
Avry,M,51,67,69,136
Bernabe,M,100,0,136,136
Brailey,F,96,131,5,136
Caileigh,F,100,136,0,136
Carmina,F,100,136,0,136
Christoph,M,100,0,136,136
Decarlos,M,100,0,136,136
Dwyane,M,100,0,136,136
Eveline,F,100,136,0,136
Everley,F,100,136,0,136
Haile,F,76,103,33,136
Jahleel,M,100,0,136,136
Jama,F,95,129,7,136
Jarin,M,94,8,128,136
Jaxin,M,100,0,136,136
Jemima,F,100,136,0,136
Josemanuel,M,100,0,136,136
Kaleo,M,100,0,136,136
Kayvon,M,100,0,136,136
Keifer,M,100,0,136,136
Lawren,F,88,120,16,136
Leasia,F,100,136,0,136
Martie,F,84,114,22,136
Parish,M,68,43,93,136
Ranee,F,100,136,0,136
Rivkah,F,100,136,0,136
Rylei,F,90,122,14,136
Shardae,F,100,136,0,136
Stevenson,M,100,0,136,136
Tona,F,100,136,0,136
Vivica,F,100,136,0,136
Xaiden,M,100,0,136,136
Zakiyyah,F,100,136,0,136
Adleigh,F,100,135,0,135
Aeryn,F,100,135,0,135
Alexsis,F,87,118,17,135
Araseli,F,100,135,0,135
Atley,F,59,80,55,135
Averee,F,91,123,12,135
Barrington,M,100,0,135,135
Bayli,F,100,135,0,135
Brihanna,F,100,135,0,135
Caris,F,100,135,0,135
Cayman,M,77,31,104,135
Ceara,F,100,135,0,135
Christinia,F,100,135,0,135
Delani,F,100,135,0,135
Dorine,F,100,135,0,135
Dorthea,F,100,135,0,135
Dyani,F,96,130,5,135
Eriana,F,100,135,0,135
Falyn,F,100,135,0,135
Gisella,F,100,135,0,135
Isaura,F,100,135,0,135
Izaya,M,100,0,135,135
Jannat,F,100,135,0,135
Javontae,M,100,0,135,135
Jesika,F,100,135,0,135
Joshlyn,F,100,135,0,135
Karalee,F,100,135,0,135
Katara,F,100,135,0,135
Kiyomi,F,100,135,0,135
Korinne,F,100,135,0,135
Larue,F,53,71,64,135
Laurent,M,100,0,135,135
Liora,F,100,135,0,135
Lundyn,F,100,135,0,135
Mignon,F,100,135,0,135
Montreal,M,100,0,135,135
Mylie,F,100,135,0,135
Nicolina,F,100,135,0,135
Pippa,F,100,135,0,135
Rees,M,86,19,116,135
Taneshia,F,100,135,0,135
Thayne,M,100,0,135,135
Tinamarie,F,100,135,0,135
Twanna,F,100,135,0,135
Verona,F,100,135,0,135
Yisrael,M,100,0,135,135
Yohana,F,100,135,0,135
Abella,F,100,134,0,134
Abilene,F,100,134,0,134
Alizay,F,100,134,0,134
Anil,M,100,0,134,134
Argenis,M,100,0,134,134
Ariannah,F,100,134,0,134
Atharv,M,100,0,134,134
Bladimir,M,100,0,134,134
Byran,M,100,0,134,134
Cashmere,F,57,76,58,134
Chistopher,M,100,0,134,134
Dalyn,M,69,41,93,134
Delany,F,100,134,0,134
Ellsworth,M,100,0,134,134
Eshal,F,100,134,0,134
Garen,M,100,0,134,134
Gibran,M,100,0,134,134
Gildardo,M,100,0,134,134
Jaziyah,F,100,134,0,134
Josilyn,F,100,134,0,134
Kawika,M,100,0,134,134
Kionna,F,100,134,0,134
Kirsty,F,100,134,0,134
Laird,M,100,0,134,134
Layken,F,82,110,24,134
Liesel,F,100,134,0,134
Lilliann,F,100,134,0,134
Lorry,F,96,128,6,134
Lynae,F,100,134,0,134
Macyn,F,82,110,24,134
Martinez,M,96,5,129,134
Memory,F,100,134,0,134
Merrilee,F,100,134,0,134
Michaele,F,100,134,0,134
Minna,F,100,134,0,134
Octavian,M,100,0,134,134
Raquan,M,100,0,134,134
Rasheen,M,95,7,127,134
Royale,F,60,81,53,134
Sadia,F,100,134,0,134
Shaela,F,100,134,0,134
Sharan,F,92,123,11,134
Stockton,M,100,0,134,134
Suzi,F,100,134,0,134
Tait,M,100,0,134,134
Terryl,F,50,67,67,134
Teya,F,100,134,0,134
Thayer,M,100,0,134,134
Yashica,F,100,134,0,134
Adian,M,100,0,133,133
Alicen,F,100,133,0,133
Amalie,F,100,133,0,133
Analiyah,F,100,133,0,133
Arnita,F,100,133,0,133
Bevin,F,85,113,20,133
Chari,F,100,133,0,133
Chauncy,M,93,9,124,133
Corby,M,89,15,118,133
Dagny,F,100,133,0,133
Deitra,F,100,133,0,133
Delane,F,53,71,62,133
Eartha,F,100,133,0,133
Emiko,F,96,128,5,133
Fanta,F,100,133,0,133
Fredia,F,100,133,0,133
Gwenn,F,100,133,0,133
Han,M,51,65,68,133
Ignatius,M,100,0,133,133
Ione,F,100,133,0,133
Jasir,M,100,0,133,133
Jennine,F,100,133,0,133
Jessey,M,77,30,103,133
Karam,M,100,0,133,133
Kassondra,F,100,133,0,133
Kejuan,M,100,0,133,133
Kristianna,F,100,133,0,133
Kylon,M,100,0,133,133
Lamon,M,100,0,133,133
Landri,F,100,133,0,133
Lilee,F,100,133,0,133
Linton,M,100,0,133,133
Lipa,M,100,0,133,133
Michala,F,100,133,0,133
Myracle,F,100,133,0,133
Neela,F,100,133,0,133
Niam,M,100,0,133,133
Ocie,M,77,31,102,133
Rondal,M,100,0,133,133
Rosaria,F,100,133,0,133
Sanders,M,100,0,133,133
Savon,M,95,6,127,133
Shakera,F,100,133,0,133
Shalon,F,80,107,26,133
Tameika,F,100,133,0,133
Valen,M,74,34,99,133
Ved,M,100,0,133,133
Yelena,F,100,133,0,133
Adil,M,100,0,132,132
Amaryllis,F,100,132,0,132
Angele,F,100,132,0,132
Arham,M,100,0,132,132
Aundre,M,100,0,132,132
Bonni,F,100,132,0,132
Damiyah,F,100,132,0,132
Daneil,M,100,0,132,132
Dolan,M,100,0,132,132
Donnetta,F,100,132,0,132
Dustie,F,100,132,0,132
Eda,F,100,132,0,132
Hallee,F,100,132,0,132
Jewels,F,100,132,0,132
Joshue,M,100,0,132,132
Juventino,M,100,0,132,132
Kacen,M,100,0,132,132
Kalaya,F,100,132,0,132
Kathrin,F,100,132,0,132
Kendalyn,F,100,132,0,132
Keva,F,100,132,0,132
Keylin,F,68,90,42,132
Khaliyah,F,100,132,0,132
Kizzy,F,100,132,0,132
Kofi,M,100,0,132,132
Larita,F,100,132,0,132
Loghan,M,51,65,67,132
Minda,F,100,132,0,132
Nevan,M,100,0,132,132
Paizlee,F,100,132,0,132
Raghav,M,100,0,132,132
Rexford,M,100,0,132,132
Thania,F,100,132,0,132
Tiyana,F,100,132,0,132
Toniann,F,100,132,0,132
Wolf,M,100,0,132,132
Yves,M,93,9,123,132
Zeinab,F,100,132,0,132
Zyla,F,100,132,0,132
Aaren,M,68,42,89,131
Adonai,M,84,21,110,131
Ailene,F,100,131,0,131
Alaine,F,100,131,0,131
Alika,F,52,68,63,131
Andraya,F,100,131,0,131
Archibald,M,100,0,131,131
Blossom,F,100,131,0,131
Bryanne,F,100,131,0,131
Bryna,F,100,131,0,131
Bryston,M,100,0,131,131
Caspian,M,100,0,131,131
Cavin,M,100,0,131,131
Cosmo,M,100,0,131,131
Cristo,M,100,0,131,131
Damia,F,100,131,0,131
Denia,F,100,131,0,131
Dillard,M,100,0,131,131
Divina,F,100,131,0,131
Domanic,M,100,0,131,131
Elijiah,M,100,0,131,131
Endia,F,100,131,0,131
Filomena,F,100,131,0,131
Gavan,M,100,0,131,131
Haneen,F,100,131,0,131
Harleen,F,100,131,0,131
Hedy,F,100,131,0,131
Hollyn,F,100,131,0,131
Ilia,F,87,114,17,131
Ilianna,F,100,131,0,131
Jakhi,M,100,0,131,131
Jarom,M,100,0,131,131
Jhett,M,100,0,131,131
Joseangel,M,100,0,131,131
Kaeson,M,100,0,131,131
Kailie,F,100,131,0,131
Markese,M,100,0,131,131
Meagen,F,100,131,0,131
Monette,F,100,131,0,131
Rayquan,M,100,0,131,131
Sharice,F,100,131,0,131
Sheyenne,F,100,131,0,131
Shila,F,100,131,0,131
Teonna,F,100,131,0,131
Tien,M,67,43,88,131
Tynesha,F,100,131,0,131
Veronique,F,100,131,0,131
Wil,M,100,0,131,131
Zuleyma,F,100,131,0,131
Aarushi,F,100,130,0,130
Alyx,F,87,113,17,130
Amairani,F,100,130,0,130
Beatris,F,100,130,0,130
Bernetta,F,100,130,0,130
Bralyn,M,63,48,82,130
Brita,F,100,130,0,130
Channon,F,65,85,45,130
Charmayne,F,100,130,0,130
Damein,M,100,0,130,130
Darick,M,100,0,130,130
Darnel,M,96,5,125,130
Eamonn,M,100,0,130,130
Eliam,M,100,0,130,130
Emmanuella,F,100,130,0,130
Felicita,F,100,130,0,130
Geremy,M,100,0,130,130
Gwendolynn,F,100,130,0,130
Irena,F,100,130,0,130
Jahmari,M,100,0,130,130
Kacper,M,100,0,130,130
Kashawn,M,95,7,123,130
Kayana,F,100,130,0,130
Kloie,F,100,130,0,130
Kolleen,F,100,130,0,130
Kylynn,F,96,125,5,130
Lexa,F,100,130,0,130
Malvin,M,100,0,130,130
Mileena,F,100,130,0,130
Mitzie,F,100,130,0,130
Natacha,F,100,130,0,130
Nikkia,F,100,130,0,130
Rachal,F,100,130,0,130
Rayaan,M,88,16,114,130
Rufino,M,100,0,130,130
Selvin,M,100,0,130,130
Shamel,M,89,14,116,130
Tandra,F,100,130,0,130
Tausha,F,100,130,0,130
Tevon,M,100,0,130,130
Tonnie,F,54,70,60,130
Trentin,M,100,0,130,130
Vinay,M,100,0,130,130
Virgilio,M,100,0,130,130
Wendolyn,F,100,130,0,130
Yassin,M,100,0,130,130
Zahira,F,100,130,0,130
Aaliah,F,100,129,0,129
Adena,F,100,129,0,129
Aliviah,F,100,129,0,129
Amadou,M,100,0,129,129
Anusha,F,100,129,0,129
Bakari,M,100,0,129,129
Bretton,M,100,0,129,129
Brilynn,F,96,124,5,129
Derion,M,91,11,118,129
Elyza,F,100,129,0,129
Embry,F,58,75,54,129
Emree,F,100,129,0,129
Evita,F,100,129,0,129
Genese,F,100,129,0,129
Holt,M,100,0,129,129
Jacquie,F,100,129,0,129
Japheth,M,100,0,129,129
Kambrie,F,100,129,0,129
Kamisha,F,100,129,0,129
Keyli,F,100,129,0,129
Layah,F,100,129,0,129
Lorina,F,100,129,0,129
Marleny,F,100,129,0,129
Marquisha,F,100,129,0,129
Mickael,M,100,0,129,129
Nicolaus,M,100,0,129,129
Retta,F,100,129,0,129
Samaira,F,100,129,0,129
Saron,F,84,108,21,129
Soloman,M,100,0,129,129
Teara,F,100,129,0,129
Thai,M,88,16,113,129
Yasmina,F,100,129,0,129
Zamarion,M,100,0,129,129
Zita,F,100,129,0,129
Adriann,F,84,107,21,128
Akeelah,F,100,128,0,128
Augustina,F,100,128,0,128
Bess,F,100,128,0,128
Breyanna,F,100,128,0,128
Breyden,M,100,0,128,128
Brigit,F,100,128,0,128
Caila,F,100,128,0,128
Carlena,F,100,128,0,128
Darcel,F,88,113,15,128
Deadra,F,100,128,0,128
Deagan,M,100,0,128,128
Delvon,M,100,0,128,128
Denyse,F,100,128,0,128
Derin,M,81,24,104,128
Errin,F,69,88,40,128
Esdras,M,100,0,128,128
Fara,F,100,128,0,128
Glennis,F,66,85,43,128
Gracin,M,77,30,98,128
Janney,F,100,128,0,128
Jaryn,M,66,43,85,128
Jayana,F,100,128,0,128
Jeremyah,M,100,0,128,128
Jizelle,F,100,128,0,128
Kaiyah,F,100,128,0,128
Kamea,F,100,128,0,128
Makynzie,F,100,128,0,128
Melisha,F,100,128,0,128
Micheala,F,100,128,0,128
Miko,M,62,49,79,128
Mirabella,F,100,128,0,128
Mykaela,F,100,128,0,128
Nayomi,F,100,128,0,128
Rahman,M,100,0,128,128
Reef,M,100,0,128,128
Rhian,F,80,103,25,128
Rito,M,100,0,128,128
Rollie,M,100,0,128,128
Ronney,M,100,0,128,128
Rylea,F,100,128,0,128
Sarrah,F,100,128,0,128
Shaine,M,88,16,112,128
Shela,F,100,128,0,128
Tarrah,F,100,128,0,128
Tashara,F,100,128,0,128
Vedant,M,100,0,128,128
Yulianna,F,100,128,0,128
Zacharie,M,100,0,128,128
Zakkary,M,100,0,128,128
Ziyon,M,84,21,107,128
Alahna,F,100,127,0,127
Alvino,M,100,0,127,127
Avan,M,94,7,120,127
Azrael,M,79,27,100,127
Brantly,M,100,0,127,127
Brenley,F,96,122,5,127
Brevin,M,100,0,127,127
Brynnlee,F,100,127,0,127
Catrice,F,100,127,0,127
Cleopatra,F,100,127,0,127
Damario,M,100,0,127,127
Danah,F,100,127,0,127
Debera,F,100,127,0,127
Devany,F,100,127,0,127
Donaven,M,100,0,127,127
Elke,F,100,127,0,127
Faiga,F,100,127,0,127
Florencia,F,100,127,0,127
Hillel,M,100,0,127,127
Ioannis,M,100,0,127,127
Jackqueline,F,100,127,0,127
Jahmal,M,100,0,127,127
Jamarr,M,100,0,127,127
Jamira,F,100,127,0,127
Jasmina,F,100,127,0,127
Jaythan,M,100,0,127,127
Jhonatan,M,100,0,127,127
Kyia,F,100,127,0,127
Laryssa,F,100,127,0,127
Louanne,F,100,127,0,127
Manya,F,100,127,0,127
Massiah,M,86,18,109,127
Melaina,F,100,127,0,127
Mishelle,F,100,127,0,127
Montie,M,81,24,103,127
Naquan,M,100,0,127,127
Nhi,F,100,127,0,127
Payge,F,100,127,0,127
Ravin,F,83,106,21,127
Raylyn,F,92,117,10,127
Renate,F,100,127,0,127
Riva,F,100,127,0,127
Shawne,F,68,86,41,127
Shruti,F,100,127,0,127
Tremain,M,100,0,127,127
Zacary,M,100,0,127,127
Zana,F,100,127,0,127
Zykeria,F,100,127,0,127
Amera,F,100,126,0,126
Aracelis,F,100,126,0,126
Ashlan,F,96,121,5,126
Beckam,M,100,0,126,126
Breyana,F,100,126,0,126
Camdon,M,100,0,126,126
Caraline,F,100,126,0,126
Casondra,F,100,126,0,126
Cozette,F,100,126,0,126
Dallen,M,100,0,126,126
Deaundre,M,100,0,126,126
Enjoli,F,100,126,0,126
Erikka,F,100,126,0,126
Genoveva,F,100,126,0,126
Gracia,F,100,126,0,126
Gracy,F,100,126,0,126
Havana,F,100,126,0,126
Hendrick,M,100,0,126,126
Jamika,F,100,126,0,126
Janese,F,100,126,0,126
Jaydee,F,59,74,52,126
Jorje,M,100,0,126,126
Juanito,M,100,0,126,126
Keianna,F,100,126,0,126
Keigan,M,89,14,112,126
Kenzy,F,100,126,0,126
Kevion,M,100,0,126,126
Koltin,M,100,0,126,126
Ladarrius,M,100,0,126,126
Loyce,F,85,107,19,126
Maeghan,F,100,126,0,126
Marque,M,87,16,110,126
Marvell,M,94,7,119,126
Marwan,M,100,0,126,126
Merida,F,100,126,0,126
Muna,F,100,126,0,126
Nadeen,F,100,126,0,126
Nicco,M,96,5,121,126
Oceana,F,100,126,0,126
Rudolf,M,100,0,126,126
Ryane,F,96,121,5,126
Sevyn,F,63,80,46,126
Shaw,M,93,9,117,126
Shireen,F,100,126,0,126
Shirleen,F,100,126,0,126
Tama,F,100,126,0,126
Temeka,F,100,126,0,126
Truth,M,60,50,76,126
Zacarias,M,100,0,126,126
Zharia,F,100,126,0,126
Alvie,M,100,0,125,125
Alyiah,F,100,125,0,125
Andrez,M,100,0,125,125
Aneesa,F,100,125,0,125
Caralyn,F,100,125,0,125
Catarino,M,100,0,125,125
Chanse,M,100,0,125,125
Dade,M,100,0,125,125
Deontay,M,100,0,125,125
Durand,M,100,0,125,125
Ebenezer,M,91,11,114,125
Elsy,F,100,125,0,125
Elzie,M,100,0,125,125
Emmery,F,96,120,5,125
Emy,F,100,125,0,125
Evangelia,F,100,125,0,125
Gwendalyn,F,100,125,0,125
Huntley,M,74,32,93,125
Ibn,M,100,0,125,125
Jaidah,F,100,125,0,125
Jakeb,M,100,0,125,125
Jakyra,F,100,125,0,125
Jayonna,F,100,125,0,125
Jazmen,F,100,125,0,125
Jelissa,F,100,125,0,125
Jolinda,F,100,125,0,125
Jorie,F,100,125,0,125
Kamesha,F,100,125,0,125
Karel,F,66,83,42,125
Keiran,M,89,14,111,125
Kenslee,F,100,125,0,125
Klaus,M,100,0,125,125
Kourtni,F,100,125,0,125
Kyleen,F,100,125,0,125
Kynzie,F,100,125,0,125
Lacresha,F,100,125,0,125
Maddyson,F,100,125,0,125
Madisson,F,100,125,0,125
Madlyn,F,100,125,0,125
Malana,F,100,125,0,125
Michella,F,100,125,0,125
Nabeel,M,100,0,125,125
Nailea,F,100,125,0,125
Patrisha,F,100,125,0,125
Rishaan,M,100,0,125,125
Ronisha,F,100,125,0,125
Saralyn,F,100,125,0,125
Shakita,F,100,125,0,125
Shun,M,96,5,120,125
Susy,F,100,125,0,125
Takeisha,F,100,125,0,125
Tesa,F,100,125,0,125
Thornton,M,100,0,125,125
Tinisha,F,100,125,0,125
Tyronne,M,100,0,125,125
Ulices,M,100,0,125,125
Wanita,F,100,125,0,125
Zahraa,F,100,125,0,125
Alizae,F,100,124,0,124
Amil,M,55,56,68,124
Andee,F,100,124,0,124
Bev,F,100,124,0,124
Caitlan,F,100,124,0,124
Casi,F,100,124,0,124
Cattleya,F,100,124,0,124
Cherice,F,100,124,0,124
Collyn,M,81,23,101,124
Deseree,F,100,124,0,124
Donisha,F,100,124,0,124
Durell,M,100,0,124,124
Dylen,M,100,0,124,124
Emalie,F,100,124,0,124
Empress,F,100,124,0,124
Eren,M,81,24,100,124
General,M,100,0,124,124
Harli,F,100,124,0,124
Haylen,F,87,108,16,124
Humza,M,100,0,124,124
Jacori,M,100,0,124,124
Jalan,M,92,10,114,124
Jamaine,M,96,5,119,124
Jaycion,M,100,0,124,124
Kamrynn,F,95,118,6,124
Keitha,F,100,124,0,124
Kenesha,F,100,124,0,124
Lanisha,F,100,124,0,124
Lary,M,100,0,124,124
Lashun,F,68,84,40,124
Makia,F,100,124,0,124
Marciano,M,100,0,124,124
Maryan,F,100,124,0,124
Mavrick,M,100,0,124,124
Nadira,F,100,124,0,124
Neisha,F,100,124,0,124
Nuvia,F,100,124,0,124
Oneida,F,100,124,0,124
Orval,M,100,0,124,124
Otoniel,M,100,0,124,124
Prestyn,M,78,27,97,124
Rennie,M,57,53,71,124
Sagan,M,66,42,82,124
Sumner,M,85,19,105,124
Tajah,F,92,114,10,124
Terisa,F,100,124,0,124
Tomasa,F,100,124,0,124
Vaishnavi,F,100,124,0,124
Vallerie,F,100,124,0,124
Aahana,F,100,123,0,123
Amyia,F,100,123,0,123
Andromeda,F,100,123,0,123
Avelina,F,100,123,0,123
Aylen,F,86,106,17,123
Bayla,F,100,123,0,123
Bladen,M,100,0,123,123
Braidyn,M,86,17,106,123
Burnell,M,100,0,123,123
Copeland,M,76,29,94,123
Damar,M,100,0,123,123
Damara,F,100,123,0,123
Deirdra,F,100,123,0,123
Devynn,F,85,105,18,123
Dujuan,M,100,0,123,123
Garold,M,100,0,123,123
Garon,M,100,0,123,123
Jamileth,F,100,123,0,123
Janyah,F,100,123,0,123
Kaleena,F,100,123,0,123
Kaleigha,F,100,123,0,123
Kesean,M,100,0,123,123
Lakeesha,F,100,123,0,123
Levern,M,83,21,102,123
Louvenia,F,100,123,0,123
Lynzie,F,100,123,0,123
Mahki,M,100,0,123,123
Malikai,M,100,0,123,123
Micheline,F,100,123,0,123
Nirvana,F,100,123,0,123
Phyliss,F,100,123,0,123
Raynell,F,52,64,59,123
Rida,F,95,117,6,123
Spence,M,100,0,123,123
Terina,F,100,123,0,123
Tylon,M,100,0,123,123
Urban,M,100,0,123,123
Welton,M,100,0,123,123
Xaiver,M,100,0,123,123
Albin,M,100,0,122,122
Ambrielle,F,100,122,0,122
Andersen,M,77,28,94,122
Annaleah,F,100,122,0,122
Aralyn,F,100,122,0,122
Arla,F,100,122,0,122
Boruch,M,100,0,122,122
Cache,M,71,35,87,122
Charon,F,77,94,28,122
Christyn,F,100,122,0,122
Cordarius,M,100,0,122,122
Cylus,M,100,0,122,122
Daliyah,F,100,122,0,122
Damiya,F,100,122,0,122
Delwin,M,100,0,122,122
Destyni,F,100,122,0,122
Dezaray,F,100,122,0,122
Dierdre,F,100,122,0,122
Dontavius,M,100,0,122,122
Dyllon,M,100,0,122,122
Eniyah,F,100,122,0,122
Ethaniel,M,100,0,122,122
Evamarie,F,100,122,0,122
Florinda,F,100,122,0,122
Herb,M,100,0,122,122
Ixchel,F,100,122,0,122
Jaelah,F,100,122,0,122
Jamy,F,57,70,52,122
Kailan,F,56,68,54,122
Karlo,M,100,0,122,122
Katty,F,100,122,0,122
Keneth,M,100,0,122,122
Kennadie,F,100,122,0,122
Kensi,F,100,122,0,122
Khang,M,100,0,122,122
Krissa,F,100,122,0,122
Ladd,M,100,0,122,122
Lakelyn,F,100,122,0,122
Lan,F,75,92,30,122
Manha,F,100,122,0,122
Marielena,F,100,122,0,122
Megha,F,100,122,0,122
Melaney,F,100,122,0,122
Miangel,F,100,122,0,122
Niels,M,100,0,122,122
Porcha,F,100,122,0,122
Ramond,M,100,0,122,122
Rayn,M,52,59,63,122
Romelia,F,100,122,0,122
Roshni,F,100,122,0,122
Sheryll,F,100,122,0,122
Skylyn,F,100,122,0,122
Tifany,F,100,122,0,122
Tiffiney,F,100,122,0,122
Tijuana,F,100,122,0,122
Tylin,M,82,22,100,122
Vannesa,F,100,122,0,122
Xochilt,F,100,122,0,122
Abbott,M,93,8,113,121
Abdurrahman,M,100,0,121,121
Adaya,F,100,121,0,121
Aishwarya,F,100,121,0,121
Albino,M,100,0,121,121
Amaan,M,100,0,121,121
Amel,F,53,64,57,121
Analiah,F,100,121,0,121
Angle,F,87,105,16,121
Auria,F,100,121,0,121
Barret,M,100,0,121,121
Brailynn,F,100,121,0,121
Constantino,M,100,0,121,121
Damone,M,100,0,121,121
Deangela,F,100,121,0,121
Deona,F,100,121,0,121
Desaray,F,100,121,0,121
Donivan,M,100,0,121,121
Erina,F,100,121,0,121
Georgine,F,100,121,0,121
Harrell,M,100,0,121,121
Hurley,M,95,6,115,121
Ivon,F,69,84,37,121
Jacelynn,F,100,121,0,121
Janaye,F,100,121,0,121
Jazzmyn,F,100,121,0,121
Jennelle,F,100,121,0,121
Jobe,M,100,0,121,121
Jonni,F,96,116,5,121
Jourdyn,F,84,102,19,121
Katiana,F,100,121,0,121
Kensey,F,100,121,0,121
Khaleb,M,100,0,121,121
Kirsti,F,100,121,0,121
Kush,M,100,0,121,121
Ladell,M,83,21,100,121
Lakeya,F,100,121,0,121
Licia,F,100,121,0,121
Mariely,F,100,121,0,121
Mariza,F,100,121,0,121
Maxson,M,100,0,121,121
Melvyn,M,100,0,121,121
Michial,M,100,0,121,121
Nikisha,F,100,121,0,121
Oden,M,100,0,121,121
Pacey,M,68,39,82,121
Penn,M,100,0,121,121
Polina,F,100,121,0,121
Ranada,F,100,121,0,121
Rayanne,F,100,121,0,121
Rayshaun,M,100,0,121,121
Sabian,M,100,0,121,121
Saskia,F,100,121,0,121
Seren,F,96,116,5,121
Shaunta,F,93,113,8,121
Suzana,F,100,121,0,121
Sylis,M,100,0,121,121
Tilly,F,100,121,0,121
Vanna,F,100,121,0,121
Vishnu,M,100,0,121,121
Yerik,M,100,0,121,121
Aiesha,F,100,120,0,120
Ailey,F,100,120,0,120
Akari,F,68,81,39,120
Athanasios,M,100,0,120,120
Avelyn,F,100,120,0,120
Bay,F,80,96,24,120
Bea,F,100,120,0,120
Blakeley,F,87,104,16,120
Bushra,F,100,120,0,120
Christien,M,91,11,109,120
Collen,M,57,52,68,120
Cross,M,100,0,120,120
Daleysa,F,100,120,0,120
Deloise,F,100,120,0,120
Donia,F,100,120,0,120
Eila,F,100,120,0,120
Enoc,M,100,0,120,120
Fredericka,F,100,120,0,120
Gerome,M,100,0,120,120
Goldy,F,100,120,0,120
Hadyn,F,52,63,57,120
Jarel,M,100,0,120,120
Jerone,M,100,0,120,120
Jolena,F,100,120,0,120
Jontae,M,78,27,93,120
Justino,M,100,0,120,120
Karine,F,100,120,0,120
Keiona,F,100,120,0,120
Kelcy,F,88,106,14,120
Kendria,F,100,120,0,120
Kersten,F,100,120,0,120
Laniah,F,100,120,0,120
Lisabeth,F,100,120,0,120
Lucina,F,100,120,0,120
Mariafernanda,F,100,120,0,120
Mateusz,M,100,0,120,120
Mathilda,F,100,120,0,120
Mikenzie,F,100,120,0,120
Morton,M,100,0,120,120
Mykell,M,76,29,91,120
Nadja,F,100,120,0,120
Navid,M,89,13,107,120
Nevaeha,F,100,120,0,120
Olaf,M,100,0,120,120
Robie,M,75,30,90,120
Romelo,M,100,0,120,120
Ryah,F,100,120,0,120
Shadow,M,57,52,68,120
Taira,F,100,120,0,120
Tangie,F,100,120,0,120
Taquan,M,100,0,120,120
Tarin,F,69,83,37,120
Tayshawn,M,100,0,120,120
Teisha,F,100,120,0,120
Thien,M,100,0,120,120
Tytan,M,100,0,120,120
Uzziah,M,100,0,120,120
Vincenza,F,100,120,0,120
Wednesday,F,100,120,0,120
Yatziri,F,100,120,0,120
Yisel,F,100,120,0,120
Aarron,M,100,0,119,119
Akram,M,100,0,119,119
Alaia,F,100,119,0,119
Amarii,M,53,56,63,119
Americo,M,100,0,119,119
Ameya,F,78,93,26,119
Arav,M,100,0,119,119
Arius,M,96,5,114,119
Avante,M,90,12,107,119
Christpher,M,100,0,119,119
Cristhian,M,100,0,119,119
Cutler,M,100,0,119,119
Emberlyn,F,100,119,0,119
Eston,M,100,0,119,119
Fabrizio,M,100,0,119,119
Fatou,F,100,119,0,119
Georgiann,F,100,119,0,119
Isak,M,100,0,119,119
Jalene,F,95,113,6,119
Jiana,F,100,119,0,119
Joby,M,96,5,114,119
Jozie,F,100,119,0,119
Kailea,F,100,119,0,119
Kierston,F,96,114,5,119
Koi,M,65,42,77,119
Lacretia,F,100,119,0,119
Laquetta,F,100,119,0,119
Lyndee,F,100,119,0,119
Mahayla,F,100,119,0,119
Makaya,F,100,119,0,119
Makya,F,100,119,0,119
Nacole,F,100,119,0,119
Pryce,M,100,0,119,119
Ronen,M,100,0,119,119
Rooney,M,68,38,81,119
Toria,F,100,119,0,119
Tysean,M,100,0,119,119
Tysha,F,100,119,0,119
Tzipora,F,100,119,0,119
Valinda,F,100,119,0,119
Willaim,M,100,0,119,119
Aarin,M,59,48,70,118
Adem,M,100,0,118,118
Aliannah,F,100,118,0,118
Andreya,F,100,118,0,118
Avrie,F,100,118,0,118
Azari,F,69,82,36,118
Azlyn,F,100,118,0,118
Brentlee,M,86,17,101,118
Buffie,F,100,118,0,118
Cayleb,M,100,0,118,118
Chantz,M,100,0,118,118
Daevon,M,100,0,118,118
Daulton,M,100,0,118,118
Davia,F,100,118,0,118
Denese,F,100,118,0,118
Derricka,F,100,118,0,118
Emmah,F,100,118,0,118
Emmersyn,F,100,118,0,118
Gennifer,F,100,118,0,118
Gwenevere,F,100,118,0,118
Ianna,F,100,118,0,118
Jamelle,M,62,45,73,118
Janyce,F,100,118,0,118
Jerico,M,93,8,110,118
Jeryl,M,55,53,65,118
Jevin,M,100,0,118,118
Kadarius,M,100,0,118,118
Kendarius,M,100,0,118,118
Keondra,F,100,118,0,118
Keron,M,94,7,111,118
Khushi,F,100,118,0,118
Leamon,M,100,0,118,118
Lenwood,M,100,0,118,118
Leota,F,100,118,0,118
Madolyn,F,100,118,0,118
Maram,F,100,118,0,118
Marlina,F,100,118,0,118
Matthieu,M,100,0,118,118
Mayleen,F,100,118,0,118
Mccall,F,91,107,11,118
Myiah,F,100,118,0,118
Naliyah,F,100,118,0,118
Rasheem,M,100,0,118,118
Raygan,F,92,108,10,118
Raylon,M,100,0,118,118
Rhiana,F,100,118,0,118
Ronal,M,100,0,118,118
Royalty,F,73,86,32,118
Seema,F,100,118,0,118
Serita,F,100,118,0,118
Sherese,F,100,118,0,118
Tira,F,100,118,0,118
Yenifer,F,100,118,0,118
Ysabel,F,96,113,5,118
Zoei,F,100,118,0,118
Abisai,M,89,13,104,117
Agustina,F,100,117,0,117
Aicha,F,100,117,0,117
Anakaren,F,100,117,0,117
Andreina,F,100,117,0,117
Arwa,F,100,117,0,117
Briahna,F,100,117,0,117
Briant,M,100,0,117,117
Brodi,M,86,16,101,117
Carlita,F,100,117,0,117
Chrissie,F,100,117,0,117
Chyann,F,100,117,0,117
Clarance,M,100,0,117,117
Damita,F,100,117,0,117
Dejanae,F,100,117,0,117
Delisha,F,100,117,0,117
Dessa,F,100,117,0,117
Doretta,F,100,117,0,117
Emrie,F,100,117,0,117
Erickson,M,100,0,117,117
Evy,F,100,117,0,117
Fatma,F,100,117,0,117
Frazier,M,100,0,117,117
Iverson,M,100,0,117,117
Jacqualyn,F,100,117,0,117
Jaimi,F,100,117,0,117
Jamarian,M,100,0,117,117
Jayton,M,100,0,117,117
Julyssa,F,100,117,0,117
Kahlia,F,100,117,0,117
Kal,M,100,0,117,117
Kiaya,F,100,117,0,117
Lakeysha,F,100,117,0,117
Lariyah,F,100,117,0,117
Lashondra,F,100,117,0,117
Leshawn,M,68,37,80,117
Lynnae,F,100,117,0,117
Maple,F,100,117,0,117
Rebbeca,F,100,117,0,117
Sander,M,90,12,105,117
Season,F,100,117,0,117
Sonnie,F,59,69,48,117
Sully,M,56,51,66,117
Tab,M,100,0,117,117
Verena,F,100,117,0,117
Aalayah,F,100,116,0,116
Abbagail,F,100,116,0,116
Adham,M,100,0,116,116
Akasha,F,100,116,0,116
Amadeus,M,100,0,116,116
Annett,F,100,116,0,116
Ariell,F,100,116,0,116
Ashlen,F,100,116,0,116
Binyomin,M,100,0,116,116
Brenten,M,100,0,116,116
Chan,M,79,24,92,116
Charita,F,100,116,0,116
Despina,F,100,116,0,116
Egan,M,100,0,116,116
Emberlynn,F,100,116,0,116
Hasani,M,100,0,116,116
Inger,F,100,116,0,116
Iram,M,91,11,105,116
Jakeem,M,100,0,116,116
Jamauri,M,100,0,116,116
Janiel,M,95,6,110,116
Jayanna,F,100,116,0,116
Jaydn,M,72,33,83,116
Jaysean,M,100,0,116,116
Jeffory,M,100,0,116,116
Jessalynn,F,100,116,0,116
Jestin,M,100,0,116,116
Josi,F,100,116,0,116
Juno,F,87,101,15,116
Kadee,F,100,116,0,116
Kaito,M,100,0,116,116
Kalon,M,100,0,116,116
Karyssa,F,100,116,0,116
Kenyan,M,96,5,111,116
Kiki,F,91,106,10,116
Kimaya,F,100,116,0,116
Kyleah,F,100,116,0,116
Lashea,F,100,116,0,116
Laurance,M,100,0,116,116
Lovina,F,100,116,0,116
Magdalen,F,100,116,0,116
Maliek,M,100,0,116,116
Mariska,F,100,116,0,116
Nycole,F,100,116,0,116
Omayra,F,100,116,0,116
Oneil,M,100,0,116,116
Paradise,F,100,116,0,116
Renda,F,100,116,0,116
Renna,F,100,116,0,116
Reza,M,100,0,116,116
Sharona,F,100,116,0,116
Sierrah,F,100,116,0,116
Sinclair,M,71,34,82,116
Tamarra,F,100,116,0,116
Teaira,F,100,116,0,116
Tor,M,100,0,116,116
Tytianna,F,100,116,0,116
Vittorio,M,100,0,116,116
Zakariah,M,84,18,98,116
Ziyad,M,100,0,116,116
Acadia,F,100,115,0,115
Adysen,F,100,115,0,115
Akshaj,M,100,0,115,115
Alaiya,F,100,115,0,115
Ames,M,100,0,115,115
Amiel,M,96,5,110,115
Amrita,F,100,115,0,115
Aurianna,F,100,115,0,115
Betzaida,F,100,115,0,115
Brandice,F,100,115,0,115
Calley,F,100,115,0,115
Celest,F,100,115,0,115
Christiano,M,100,0,115,115
Cypress,F,56,64,51,115
Danyale,F,95,109,6,115
Dontez,M,100,0,115,115
Eh,M,58,48,67,115
Emersen,F,90,104,11,115
Era,F,100,115,0,115
Genny,F,100,115,0,115
Glynis,F,100,115,0,115
Gypsy,F,100,115,0,115
Izzy,F,75,86,29,115
Jenavieve,F,100,115,0,115
Jerard,M,100,0,115,115
Jerson,M,100,0,115,115
Joah,M,100,0,115,115
Jolisa,F,100,115,0,115
Jorel,M,100,0,115,115
Keela,F,100,115,0,115
Kullen,M,100,0,115,115
Kylia,F,100,115,0,115
Laiyah,F,100,115,0,115
Leilanie,F,100,115,0,115
Liset,F,100,115,0,115
Matilyn,F,100,115,0,115
Murry,M,100,0,115,115
Pessy,F,100,115,0,115
Pharaoh,M,100,0,115,115
Rainy,F,100,115,0,115
Resa,F,100,115,0,115
Sephora,F,100,115,0,115
Shantay,F,100,115,0,115
Shaylene,F,100,115,0,115
Sheba,F,100,115,0,115
Takayla,F,100,115,0,115
Tracye,F,100,115,0,115
Tymir,M,100,0,115,115
Uri,M,95,6,109,115
Vasiliki,F,100,115,0,115
Xavien,M,100,0,115,115
Yulanda,F,100,115,0,115
Aarika,F,100,114,0,114
Anneke,F,100,114,0,114
Antwuan,M,100,0,114,114
Aymar,F,100,114,0,114
Ayomide,M,58,48,66,114
Azra,F,95,108,6,114
Beautiful,F,100,114,0,114
Brelynn,F,96,109,5,114
Calvert,M,100,0,114,114
Candise,F,100,114,0,114
Chenelle,F,100,114,0,114
Christelle,F,100,114,0,114
Cindie,F,100,114,0,114
Clem,M,100,0,114,114
Cosme,M,100,0,114,114
Didier,M,100,0,114,114
Donnette,F,100,114,0,114
Eldred,M,100,0,114,114
Emaline,F,100,114,0,114
Enmanuel,M,100,0,114,114
Enya,F,100,114,0,114
Eryk,M,100,0,114,114
Genelle,F,100,114,0,114
Georgann,F,100,114,0,114
Indy,F,59,67,47,114
Jakira,F,100,114,0,114
Jaxsyn,M,82,21,93,114
Jeralyn,F,100,114,0,114
Jeriel,M,100,0,114,114
Kairo,M,100,0,114,114
Kamri,F,100,114,0,114
Kaylor,F,66,75,39,114
Kile,M,100,0,114,114
Kimberle,F,100,114,0,114
Makynlee,F,100,114,0,114
Malerie,F,100,114,0,114
Manav,M,100,0,114,114
Maxime,M,95,6,108,114
Maylene,F,100,114,0,114
Melena,F,100,114,0,114
Michiel,M,100,0,114,114
Morrigan,F,100,114,0,114
Niasia,F,100,114,0,114
Niccolo,M,100,0,114,114
Nicodemus,M,100,0,114,114
Oryan,M,100,0,114,114
Radhika,F,100,114,0,114
Saria,F,100,114,0,114
Shaundra,F,100,114,0,114
Shella,F,100,114,0,114
Sohan,M,100,0,114,114
Tayshaun,M,100,0,114,114
Tedd,M,100,0,114,114
Teon,M,96,5,109,114
Teron,M,100,0,114,114
Timoteo,M,100,0,114,114
Trevan,M,100,0,114,114
Vesta,F,100,114,0,114
Yahel,M,100,0,114,114
Zamira,F,100,114,0,114
Ziad,M,100,0,114,114
Aarohi,F,100,113,0,113
Able,M,100,0,113,113
Alizah,F,100,113,0,113
Allisyn,F,100,113,0,113
Alyssandra,F,100,113,0,113
Amena,F,100,113,0,113
Annalie,F,100,113,0,113
Ashish,M,100,0,113,113
Avory,F,58,66,47,113
Bobette,F,100,113,0,113
Breah,F,100,113,0,113
Carolin,F,100,113,0,113
Catie,F,100,113,0,113
Chelsa,F,100,113,0,113
Cleophus,M,100,0,113,113
Corinthia,F,100,113,0,113
Darielle,F,100,113,0,113
Ebone,F,100,113,0,113
Ekaterina,F,100,113,0,113
Epifanio,M,100,0,113,113
Erskine,M,100,0,113,113
Frantz,M,100,0,113,113
Genevie,F,100,113,0,113
Girard,M,100,0,113,113
Ilya,M,77,26,87,113
Iola,F,100,113,0,113
Isadore,M,92,9,104,113
Jamilla,F,100,113,0,113
Jennell,F,100,113,0,113
Keeton,M,100,0,113,113
Keyra,F,100,113,0,113
Lyndsi,F,100,113,0,113
Makinzie,F,100,113,0,113
Markis,M,100,0,113,113
Maven,F,68,77,36,113
Mckinsey,F,96,108,5,113
Medha,F,100,113,0,113
Mehdi,M,100,0,113,113
Mikail,M,100,0,113,113
Mischelle,F,100,113,0,113
Nashawn,M,100,0,113,113
Ramy,M,100,0,113,113
Shantia,F,100,113,0,113
Sofiya,F,100,113,0,113
Thaddaeus,M,100,0,113,113
Tiare,F,100,113,0,113
Trapper,M,100,0,113,113
Zoi,F,100,113,0,113
Zona,F,100,113,0,113
Ahron,M,100,0,112,112
Aizen,M,100,0,112,112
Aleasha,F,100,112,0,112
Amadeo,M,100,0,112,112
Annamae,F,100,112,0,112
Annistyn,F,100,112,0,112
Antwane,M,100,0,112,112
Ayoub,M,100,0,112,112
Benjamine,M,100,0,112,112
Blayden,M,100,0,112,112
Chaka,F,62,70,42,112
Corinthian,M,88,14,98,112
Corryn,F,100,112,0,112
Cortnie,F,100,112,0,112
Cylas,M,100,0,112,112
Darsh,M,100,0,112,112
Davonna,F,100,112,0,112
Dieter,M,100,0,112,112
Dionisio,M,100,0,112,112
Donnamarie,F,100,112,0,112
Emmalina,F,100,112,0,112
Estephany,F,100,112,0,112
Fiorella,F,100,112,0,112
Giancarlos,M,100,0,112,112
Gianfranco,M,100,0,112,112
Havyn,F,95,106,6,112
Jancarlo,M,100,0,112,112
Javis,M,100,0,112,112
Jayvin,M,100,0,112,112
Jermel,M,100,0,112,112
Joselyne,F,100,112,0,112
Juanjose,M,100,0,112,112
Kaely,F,100,112,0,112
Katrin,F,100,112,0,112
Kyri,F,74,83,29,112
Malachai,M,100,0,112,112
Maleia,F,100,112,0,112
Marena,F,100,112,0,112
Nadir,M,100,0,112,112
Naythan,M,100,0,112,112
Odelia,F,100,112,0,112
Patryk,M,100,0,112,112
Rayleen,F,100,112,0,112
Regine,F,100,112,0,112
Rhylan,M,62,42,70,112
Rianne,F,100,112,0,112
Ric,M,100,0,112,112
Rishabh,M,100,0,112,112
Rockey,M,100,0,112,112
Sonora,F,100,112,0,112
Tavarus,M,100,0,112,112
Trinette,F,100,112,0,112
Vanda,F,100,112,0,112
Zymir,M,100,0,112,112
Ameenah,F,100,111,0,111
Amilya,F,100,111,0,111
Anasofia,F,100,111,0,111
Aurielle,F,100,111,0,111
Ayelen,F,100,111,0,111
Azeneth,F,100,111,0,111
Braedan,M,100,0,111,111
Branton,M,100,0,111,111
Cage,M,100,0,111,111
Carline,F,100,111,0,111
Carlota,F,100,111,0,111
Caylen,F,78,87,24,111
Cherisse,F,100,111,0,111
Cornel,M,100,0,111,111
Courtni,F,100,111,0,111
Cru,M,100,0,111,111
Daivd,M,100,0,111,111
Danitza,F,100,111,0,111
Demya,F,100,111,0,111
Donette,F,100,111,0,111
Dory,F,86,95,16,111
Eyad,M,100,0,111,111
Jaice,M,80,22,89,111
Kaeley,F,100,111,0,111
Kaliana,F,100,111,0,111
Kallan,M,75,28,83,111
Keithan,M,100,0,111,111
Kriss,M,71,32,79,111
Landree,F,100,111,0,111
Latara,F,100,111,0,111
Leylah,F,100,111,0,111
Little,M,75,28,83,111
Loyalty,F,78,87,24,111
Mackenzee,F,100,111,0,111
Montanna,F,94,104,7,111
Nancee,F,100,111,0,111
Raegen,F,100,111,0,111
Rahsaan,M,100,0,111,111
Reaghan,F,100,111,0,111
Roshonda,F,100,111,0,111
Shalee,F,100,111,0,111
Shirl,F,87,97,14,111
Siani,F,100,111,0,111
Subrina,F,100,111,0,111
Telisa,F,100,111,0,111
Tenia,F,100,111,0,111
Walid,M,100,0,111,111
Zaneta,F,100,111,0,111
Zaynah,F,100,111,0,111
Aalyiah,F,100,110,0,110
Aiva,F,100,110,0,110
Ajanae,F,100,110,0,110
Alesa,F,100,110,0,110
Alley,F,100,110,0,110
Azaan,M,100,0,110,110
Berlinda,F,100,110,0,110
Branda,F,100,110,0,110
Brieana,F,100,110,0,110
Brooklyne,F,100,110,0,110
Carmyn,F,100,110,0,110
Chany,F,100,110,0,110
Cherita,F,100,110,0,110
Davidson,M,100,0,110,110
Eligio,M,100,0,110,110
Eshaan,M,100,0,110,110
Gabby,F,100,110,0,110
Griffith,M,100,0,110,110
Helaine,F,100,110,0,110
Huston,M,100,0,110,110
Jaicee,F,100,110,0,110
Jd,M,100,0,110,110
Jozef,M,100,0,110,110
Kamyah,F,100,110,0,110
Kanika,F,100,110,0,110
Karishma,F,100,110,0,110
Keala,F,95,105,5,110
Kendon,M,100,0,110,110
Kenlie,F,100,110,0,110
Lateisha,F,100,110,0,110
Londen,F,70,77,33,110
Lorien,F,100,110,0,110
Luvenia,F,100,110,0,110
Mabry,F,100,110,0,110
Maija,F,100,110,0,110
Malin,F,80,88,22,110
Marline,F,100,110,0,110
Meilani,F,100,110,0,110
Mickeal,M,100,0,110,110
Monisha,F,100,110,0,110
Pari,F,100,110,0,110
Reeve,M,77,25,85,110
Sabria,F,100,110,0,110
Sadee,F,100,110,0,110
Savina,F,100,110,0,110
Shaheed,M,100,0,110,110
Sheryle,F,100,110,0,110
Sibyl,F,100,110,0,110
Starlet,F,100,110,0,110
Syler,M,100,0,110,110
Talina,F,100,110,0,110
Tayson,M,100,0,110,110
Tex,M,100,0,110,110
Theresia,F,100,110,0,110
Thierry,M,95,6,104,110
Tifani,F,100,110,0,110
Timberly,F,100,110,0,110
Waylen,M,100,0,110,110
Yamilex,F,100,110,0,110
Zaylin,M,64,40,70,110
Zeina,F,100,110,0,110
Aldon,M,100,0,109,109
Aleaha,F,100,109,0,109
Allanah,F,100,109,0,109
Aralynn,F,100,109,0,109
Avinash,M,100,0,109,109
Bernell,M,82,20,89,109
Carlisa,F,100,109,0,109
Celinda,F,100,109,0,109
Charlise,F,100,109,0,109
Chioma,F,100,109,0,109
Christeen,F,100,109,0,109
Cisco,M,100,0,109,109
Colden,M,100,0,109,109
Danesha,F,100,109,0,109
Dmarcus,M,100,0,109,109
Guido,M,100,0,109,109
Gwynne,F,100,109,0,109
Herminio,M,100,0,109,109
Jaiceon,M,100,0,109,109
Jalani,M,51,53,56,109
Jenay,F,100,109,0,109
Jerrid,M,100,0,109,109
Karmelo,M,100,0,109,109
Kathya,F,100,109,0,109
Kelin,M,65,38,71,109
Kenith,M,100,0,109,109
Lady,F,100,109,0,109
Lanetta,F,100,109,0,109
Lasha,F,100,109,0,109
Lekisha,F,100,109,0,109
Lorenz,M,100,0,109,109
Mahir,M,100,0,109,109
Mahnoor,F,100,109,0,109
Marice,M,58,46,63,109
Markisha,F,100,109,0,109
Meliza,F,100,109,0,109
Mikenna,F,100,109,0,109
Neila,F,100,109,0,109
Nicholai,M,100,0,109,109
Ranya,F,100,109,0,109
Rayburn,M,100,0,109,109
Riker,M,100,0,109,109
Shalisa,F,100,109,0,109
Shanetta,F,100,109,0,109
Skylin,F,89,97,12,109
Stasia,F,100,109,0,109
Stefen,M,100,0,109,109
Tenille,F,100,109,0,109
Teryl,F,76,83,26,109
Tora,F,100,109,0,109
Trayton,M,100,0,109,109
Vernard,M,100,0,109,109
Yan,M,85,16,93,109
Zoha,F,100,109,0,109
Aadi,M,100,0,108,108
Adelynne,F,100,108,0,108
Aerin,F,100,108,0,108
Arayah,F,100,108,0,108
Aurea,F,100,108,0,108
Azaiah,M,95,5,103,108
Benjaman,M,100,0,108,108
Blue,M,66,37,71,108
Britanny,F,100,108,0,108
Chara,F,100,108,0,108
Charletta,F,100,108,0,108
Chavis,M,100,0,108,108
Chi,F,66,71,37,108
Conchita,F,100,108,0,108
Courteney,F,95,103,5,108
Destanee,F,100,108,0,108
Emmily,F,100,108,0,108
Emonie,F,100,108,0,108
Evelynne,F,100,108,0,108
Ezio,M,100,0,108,108
Fabricio,M,100,0,108,108
Farid,M,100,0,108,108
Faustina,F,100,108,0,108
Hadiya,F,100,108,0,108
Hiedi,F,100,108,0,108
Jakyla,F,100,108,0,108
Jamillah,F,100,108,0,108
Jasiyah,F,64,69,39,108
Jaylinn,F,100,108,0,108
Kadynce,F,100,108,0,108
Kalayah,F,100,108,0,108
Kerra,F,100,108,0,108
Khyla,F,100,108,0,108
Lateef,M,100,0,108,108
Latifa,F,100,108,0,108
Malikah,F,92,99,9,108
Maliki,M,100,0,108,108
Mareli,F,100,108,0,108
Nida,F,100,108,0,108
Oksana,F,100,108,0,108
Praise,F,72,78,30,108
Rayah,F,100,108,0,108
Remona,F,100,108,0,108
Romie,F,51,55,53,108
Sachi,F,100,108,0,108
Shareen,F,100,108,0,108
Shilah,F,100,108,0,108
Sparrow,F,88,95,13,108
Sumayyah,F,100,108,0,108
Tailynn,F,100,108,0,108
Tajuana,F,100,108,0,108
Thersa,F,100,108,0,108
Tron,M,100,0,108,108
Tziporah,F,100,108,0,108
Viaan,M,100,0,108,108
Viraj,M,100,0,108,108
Allister,M,94,6,101,107
Aniela,F,100,107,0,107
Anthoni,M,100,0,107,107
Anthonie,M,100,0,107,107
Antwoine,M,100,0,107,107
Aolani,F,100,107,0,107
Atlee,M,71,31,76,107
Avayah,F,100,107,0,107
Bane,M,100,0,107,107
Carah,F,100,107,0,107
Chelcie,F,100,107,0,107
Cydnee,F,100,107,0,107
Darey,M,100,0,107,107
Daxon,M,100,0,107,107
Erek,M,100,0,107,107
Ermelinda,F,100,107,0,107
Fares,M,100,0,107,107
Fenton,M,100,0,107,107
Georgios,M,100,0,107,107
Gianella,F,100,107,0,107
Ginamarie,F,100,107,0,107
Greenlee,F,100,107,0,107
Huck,M,100,0,107,107
Jaciel,M,100,0,107,107
Javari,M,100,0,107,107
Jenaya,F,100,107,0,107
Jonette,F,100,107,0,107
Jonie,F,100,107,0,107
Juel,M,66,36,71,107
Kadi,F,100,107,0,107
Karalynn,F,100,107,0,107
Kayanna,F,100,107,0,107
Kelia,F,100,107,0,107
Krystel,F,100,107,0,107
Kunal,M,100,0,107,107
Maegen,F,100,107,0,107
Maher,M,100,0,107,107
Melanny,F,100,107,0,107
Mikyla,F,100,107,0,107
Mollee,F,100,107,0,107
Mordecai,M,100,0,107,107
Pearce,M,100,0,107,107
Qasim,M,100,0,107,107
Roshanda,F,100,107,0,107
Santonio,M,100,0,107,107
Shakir,M,100,0,107,107
Shamekia,F,100,107,0,107
Shariah,F,100,107,0,107
Shawntel,F,100,107,0,107
Sherida,F,100,107,0,107
Shianna,F,100,107,0,107
Shlok,M,100,0,107,107
Sonjia,F,100,107,0,107
Suanne,F,100,107,0,107
Taliya,F,100,107,0,107
Talmage,M,100,0,107,107
Tamaya,F,100,107,0,107
Terris,M,89,12,95,107
Timeka,F,100,107,0,107
Traveon,M,100,0,107,107
Yamila,F,100,107,0,107
Yulonda,F,100,107,0,107
Abigal,F,100,106,0,106
Abrahm,M,100,0,106,106
Adrielle,F,100,106,0,106
Alara,F,100,106,0,106
Amire,M,83,18,88,106
Arath,M,100,0,106,106
Aundra,M,63,39,67,106
Blakelee,F,92,98,8,106
Boe,M,100,0,106,106
Bonifacio,M,100,0,106,106
Brystal,F,100,106,0,106
Calia,F,100,106,0,106
Carlette,F,100,106,0,106
Carry,F,61,65,41,106
Dalvin,M,100,0,106,106
Daphnie,F,100,106,0,106
Deliah,F,100,106,0,106
Eesha,F,100,106,0,106
Haskell,M,100,0,106,106
Hermione,F,100,106,0,106
Hung,M,100,0,106,106
Ikaika,M,100,0,106,106
Irasema,F,100,106,0,106
Jabriel,M,100,0,106,106
Jannell,F,100,106,0,106
Jayline,F,100,106,0,106
Jhonathan,M,100,0,106,106
Ka,F,84,89,17,106
Kreg,M,100,0,106,106
Lamiyah,F,100,106,0,106
Larrie,M,66,36,70,106
Lavonte,M,100,0,106,106
Leiana,F,100,106,0,106
Locke,M,100,0,106,106
Lorita,F,100,106,0,106
Moussa,M,100,0,106,106
Murad,M,100,0,106,106
Natascha,F,100,106,0,106
Nereyda,F,100,106,0,106
Nicholes,M,100,0,106,106
Nihal,M,82,19,87,106
Quade,M,100,0,106,106
Raigan,F,100,106,0,106
Rhona,F,100,106,0,106
Ronak,M,100,0,106,106
Ruel,M,100,0,106,106
Shalene,F,100,106,0,106
Sherree,F,100,106,0,106
Snow,F,94,100,6,106
Talea,F,100,106,0,106
Talha,M,100,0,106,106
Tenaya,F,100,106,0,106
Toshia,F,100,106,0,106
Zahria,F,100,106,0,106
Zania,F,100,106,0,106
Ziah,F,72,76,30,106
Abrahan,M,100,0,105,105
Acie,M,95,5,100,105
Ahren,M,100,0,105,105
Alesandra,F,100,105,0,105
Andrianna,F,100,105,0,105
Arlet,F,100,105,0,105
Avital,F,100,105,0,105
Ayisha,F,100,105,0,105
Bashir,M,100,0,105,105
Cayley,F,100,105,0,105
Chavon,F,89,93,12,105
Cidney,F,100,105,0,105
Davaughn,M,100,0,105,105
Deniece,F,100,105,0,105
Diamonique,F,100,105,0,105
Elexus,F,100,105,0,105
Eligh,M,100,0,105,105
Elija,M,100,0,105,105
Gardenia,F,100,105,0,105
Gionna,F,100,105,0,105
Isidoro,M,100,0,105,105
Jamarious,M,100,0,105,105
Jerrilyn,F,100,105,0,105
Juliano,M,100,0,105,105
Kalila,F,100,105,0,105
Karra,F,100,105,0,105
Kiely,F,100,105,0,105
Kishan,M,100,0,105,105
Klay,M,100,0,105,105
Konnie,F,100,105,0,105
Kortnee,F,100,105,0,105
Kysen,M,100,0,105,105
Landrie,F,100,105,0,105
Lari,F,100,105,0,105
Lenita,F,100,105,0,105
Letisia,F,100,105,0,105
Linnette,F,100,105,0,105
Lyriq,F,91,96,9,105
Marijo,F,100,105,0,105
Markos,M,100,0,105,105
Marne,F,100,105,0,105
Michaelene,F,100,105,0,105
Midori,F,100,105,0,105
Mireille,F,100,105,0,105
Monta,M,62,40,65,105
Montavious,M,100,0,105,105
Morganne,F,100,105,0,105
Nakesha,F,100,105,0,105
Niara,F,100,105,0,105
Niel,M,100,0,105,105
Nigeria,F,100,105,0,105
Nikol,F,100,105,0,105
Norwood,M,100,0,105,105
Pheonix,M,60,42,63,105
Rithvik,M,100,0,105,105
Roshelle,F,100,105,0,105
Rozalyn,F,100,105,0,105
Shameeka,F,100,105,0,105
Sharese,F,100,105,0,105
Shoshanna,F,100,105,0,105
Skyelar,F,79,83,22,105
Stellan,M,100,0,105,105
Talena,F,100,105,0,105
Tamari,F,76,80,25,105
Tanasia,F,100,105,0,105
Taylyn,F,100,105,0,105
Treston,M,100,0,105,105
Verania,F,100,105,0,105
Willia,F,66,69,36,105
Yailin,F,100,105,0,105
Yalonda,F,100,105,0,105
Yasser,M,100,0,105,105
Zenon,M,100,0,105,105
Aakash,M,100,0,104,104
Aili,F,100,104,0,104
Alastair,M,100,0,104,104
Amory,F,57,59,45,104
Anise,F,100,104,0,104
Annagrace,F,100,104,0,104
Apolonio,M,100,0,104,104
Arrow,M,73,28,76,104
Audria,F,100,104,0,104
Ayda,F,100,104,0,104
Bentleigh,F,93,97,7,104
Cherly,F,100,104,0,104
Cheston,M,100,0,104,104
Crue,M,100,0,104,104
Dayvion,M,100,0,104,104
Denette,F,100,104,0,104
Derrius,M,100,0,104,104
Emalynn,F,100,104,0,104
Emmagrace,F,100,104,0,104
Evey,F,100,104,0,104
Faiza,F,100,104,0,104
Finlay,M,80,21,83,104
Furman,M,100,0,104,104
Garey,M,100,0,104,104
Hani,M,88,12,92,104
Hermon,M,95,5,99,104
Jahsiah,M,100,0,104,104
Jaileen,F,100,104,0,104
Jamara,F,95,99,5,104
Janisha,F,100,104,0,104
Jarely,F,100,104,0,104
Jaylie,F,100,104,0,104
Jayon,M,100,0,104,104
Jeanpierre,M,100,0,104,104
Kaelen,M,73,28,76,104
Kaitlynne,F,100,104,0,104
Kam,M,76,25,79,104
Kamauri,M,67,34,70,104
Kandie,F,100,104,0,104
Kiandra,F,100,104,0,104
Kieren,M,70,31,73,104
Kizzie,F,100,104,0,104
Kyna,F,100,104,0,104
Kyng,M,100,0,104,104
Lamarion,M,100,0,104,104
Latroy,M,100,0,104,104
Laurinda,F,100,104,0,104
Laurine,F,100,104,0,104
Lavender,F,100,104,0,104
Leonela,F,100,104,0,104
Leshia,F,100,104,0,104
Lew,M,100,0,104,104
Lucienne,F,100,104,0,104
Meegan,F,100,104,0,104
Neysa,F,100,104,0,104
Nitya,F,100,104,0,104
Osama,M,100,0,104,104
Reuven,M,100,0,104,104
Ronette,F,100,104,0,104
Rye,M,83,18,86,104
Serjio,M,100,0,104,104
Shaindel,F,100,104,0,104
Shakara,F,100,104,0,104
Shakyra,F,100,104,0,104
Suraj,M,100,0,104,104
Sury,F,100,104,0,104
Taniah,F,100,104,0,104
Tawnee,F,100,104,0,104
Terrick,M,100,0,104,104
Tesia,F,100,104,0,104
Tiffeny,F,100,104,0,104
Venecia,F,100,104,0,104
Xzavion,M,100,0,104,104
Yoseph,M,100,0,104,104
Zaylie,F,100,104,0,104
Ziya,F,100,104,0,104
Ziyah,F,95,99,5,104
Abhiram,M,100,0,103,103
Adrionna,F,100,103,0,103
Advaith,M,100,0,103,103
Aitana,F,100,103,0,103
Aiyden,M,100,0,103,103
Aleana,F,100,103,0,103
Alynna,F,100,103,0,103
Aneesh,M,100,0,103,103
Aniyla,F,100,103,0,103
Aniylah,F,100,103,0,103
Arieana,F,100,103,0,103
Arminda,F,100,103,0,103
Asim,M,100,0,103,103
Avin,M,91,9,94,103
Bergen,F,54,56,47,103
Bethani,F,100,103,0,103
Brunilda,F,100,103,0,103
Brynlie,F,100,103,0,103
Caroll,F,79,81,22,103
Chayla,F,100,103,0,103
Cristiana,F,100,103,0,103
Dagan,M,95,5,98,103
Derald,M,100,0,103,103
Eulalio,M,100,0,103,103
Florian,M,100,0,103,103
Garin,M,100,0,103,103
Genise,F,100,103,0,103
Germain,M,95,5,98,103
Gregor,M,100,0,103,103
Haziel,M,100,0,103,103
Izrael,M,100,0,103,103
Jemal,M,100,0,103,103
Jerick,M,100,0,103,103
Kaimana,M,84,16,87,103
Kallista,F,100,103,0,103
Kaori,F,100,103,0,103
Kimberlin,F,100,103,0,103
Lashandra,F,100,103,0,103
Lizbet,F,100,103,0,103
Macen,M,100,0,103,103
Mackinzie,F,100,103,0,103
Maeson,M,85,15,88,103
Makenzee,F,100,103,0,103
Mardi,F,100,103,0,103
Maribelle,F,100,103,0,103
Marlynn,F,100,103,0,103
Marycatherine,F,100,103,0,103
Mattew,M,100,0,103,103
Maxfield,M,100,0,103,103
Nessa,F,100,103,0,103
Padraic,M,100,0,103,103
Rasheedah,F,100,103,0,103
Rashod,M,100,0,103,103
Reginia,F,100,103,0,103
Rhema,F,100,103,0,103
Sakinah,F,100,103,0,103
Saleen,F,100,103,0,103
Sameera,F,100,103,0,103
Shomari,M,100,0,103,103
Tarrance,M,100,0,103,103
Tashina,F,100,103,0,103
Trevyn,M,100,0,103,103
Washington,M,100,0,103,103
Wiliam,M,100,0,103,103
Yannick,M,100,0,103,103
Zachari,M,100,0,103,103
Zari,F,100,103,0,103
Aariz,M,100,0,102,102
Adams,M,100,0,102,102
Adreana,F,100,102,0,102
Alda,F,100,102,0,102
Alister,M,100,0,102,102
Anasia,F,100,102,0,102
Annalia,F,100,102,0,102
Arihanna,F,100,102,0,102
Aurelius,M,100,0,102,102
Belynda,F,100,102,0,102
Berlyn,F,100,102,0,102
Beronica,F,100,102,0,102
Braylie,F,100,102,0,102
Brodee,M,100,0,102,102
Calissa,F,100,102,0,102
Cassidee,F,100,102,0,102
Champ,M,100,0,102,102
Chrisette,F,100,102,0,102
Christiaan,M,100,0,102,102
Courtlyn,F,100,102,0,102
Daimon,M,100,0,102,102
Denisa,F,100,102,0,102
Deserie,F,100,102,0,102
Elimelech,M,100,0,102,102
Erna,F,100,102,0,102
Fadi,M,100,0,102,102
Faythe,F,100,102,0,102
Gwynn,F,94,96,6,102
Haniya,F,100,102,0,102
Hanley,M,57,44,58,102
Jaceyon,M,100,0,102,102
Jahiem,M,100,0,102,102
Jaleigh,F,100,102,0,102
Janson,M,100,0,102,102
Jock,M,100,0,102,102
Kanoa,M,100,0,102,102
Karmin,F,100,102,0,102
Kasondra,F,100,102,0,102
Katharyn,F,100,102,0,102
Kenai,M,100,0,102,102
Kendale,M,90,10,92,102
Keniyah,F,100,102,0,102
Kieara,F,100,102,0,102
Lashundra,F,100,102,0,102
Laszlo,M,100,0,102,102
Leonie,F,100,102,0,102
Lukus,M,100,0,102,102
Lunden,F,59,60,42,102
Luqman,M,100,0,102,102
Macarthur,M,100,0,102,102
Margeaux,F,100,102,0,102
Mayar,F,93,95,7,102
Maysa,F,100,102,0,102
Mazzy,F,100,102,0,102
Milinda,F,100,102,0,102
Neema,F,76,78,24,102
Newell,M,100,0,102,102
Nija,F,100,102,0,102
Raquelle,F,100,102,0,102
Rayana,F,100,102,0,102
Saverio,M,100,0,102,102
Shakeria,F,100,102,0,102
Shanan,F,90,92,10,102
Shealynn,F,100,102,0,102
Shree,F,92,94,8,102
Stevens,M,100,0,102,102
Sun,F,65,66,36,102
Toren,M,100,0,102,102
Verla,F,100,102,0,102
Yuvraj,M,100,0,102,102
Zionna,F,100,102,0,102
Aashi,F,100,101,0,101
Abhay,M,100,0,101,101
Abrar,F,57,58,43,101
Alayne,F,100,101,0,101
Amaiyah,F,100,101,0,101
Amellia,F,100,101,0,101
Andrina,F,100,101,0,101
Anuj,M,100,0,101,101
Ariona,F,100,101,0,101
Arisha,F,100,101,0,101
Aslan,M,88,12,89,101
Athina,F,100,101,0,101
Bohdan,M,100,0,101,101
Bronwen,F,100,101,0,101
Candee,F,100,101,0,101
Catina,F,100,101,0,101
Constanza,F,100,101,0,101
Deborha,F,100,101,0,101
Dekota,M,75,25,76,101
Denee,F,100,101,0,101
Dimitrius,M,100,0,101,101
Edvin,M,100,0,101,101
Edy,M,74,26,75,101
Elona,F,100,101,0,101
Ensley,F,100,101,0,101
Estrellita,F,100,101,0,101
Fraidy,F,100,101,0,101
Fredricka,F,100,101,0,101
Georgianne,F,100,101,0,101
Hadlie,F,100,101,0,101
Haydin,M,58,42,59,101
Jamiel,M,100,0,101,101
Jamye,F,100,101,0,101
Jamyra,F,100,101,0,101
Jlynn,F,94,95,6,101
Kansas,F,100,101,0,101
Kedric,M,100,0,101,101
Kyliee,F,100,101,0,101
Laquesha,F,100,101,0,101
Loralie,F,100,101,0,101
Loretha,F,100,101,0,101
Marqus,M,100,0,101,101
Matea,F,100,101,0,101
Merilee,F,100,101,0,101
Mikhael,M,100,0,101,101
Myeisha,F,100,101,0,101
Prestin,M,100,0,101,101
Rainer,M,95,5,96,101
Raudel,M,100,0,101,101
Rozlynn,F,100,101,0,101
Rudi,M,71,29,72,101
Ruhi,F,100,101,0,101
Salah,M,100,0,101,101
Sarahy,F,100,101,0,101
Scotlyn,F,100,101,0,101
Shakur,M,100,0,101,101
Suhani,F,100,101,0,101
Takira,F,100,101,0,101
Tonny,M,100,0,101,101
Torrin,M,88,12,89,101
Toy,F,58,59,42,101
Treven,M,100,0,101,101
Yanelis,F,100,101,0,101
Yolande,F,100,101,0,101
Abbygale,F,100,100,0,100
Ahlam,F,100,100,0,100
Aiko,F,100,100,0,100
Atara,F,100,100,0,100
Atiya,F,100,100,0,100
Ayala,F,100,100,0,100
Betsaida,F,100,100,0,100
Carmelina,F,100,100,0,100
Cherylann,F,100,100,0,100
Cortni,F,100,100,0,100
Coryn,F,100,100,0,100
Croix,M,100,0,100,100
Crystle,F,100,100,0,100
Deleon,M,100,0,100,100
Dondi,M,64,36,64,100
Edd,M,100,0,100,100
Eilene,F,100,100,0,100
Elmira,F,100,100,0,100
Elodia,F,100,100,0,100
Fenix,M,82,18,82,100
Flavia,F,100,100,0,100
Gabryella,F,100,100,0,100
Gennesis,F,100,100,0,100
Ginette,F,100,100,0,100
Graceann,F,100,100,0,100
Jalesa,F,100,100,0,100
Jehu,M,100,0,100,100
Jeneen,F,100,100,0,100
Jermy,M,100,0,100,100
Joelene,F,100,100,0,100
Kaileb,M,100,0,100,100
Karaline,F,100,100,0,100
Karianne,F,100,100,0,100
Kei,M,65,35,65,100
Kela,F,100,100,0,100
Kendrell,M,95,5,95,100
Khole,F,94,94,6,100
Kimberlynn,F,100,100,0,100
Kirah,F,100,100,0,100
Krystyn,F,100,100,0,100
Laree,F,100,100,0,100
Lashell,F,100,100,0,100
Lashelle,F,100,100,0,100
Leeana,F,100,100,0,100
Lejla,F,100,100,0,100
Lindon,M,100,0,100,100
Lizandro,M,100,0,100,100
Mailyn,F,100,100,0,100
Marge,F,100,100,0,100
Masiah,M,90,10,90,100
Maynor,M,100,0,100,100
Meghana,F,100,100,0,100
Meriah,F,100,100,0,100
Nelia,F,100,100,0,100
Ottis,M,100,0,100,100
Raffaele,M,100,0,100,100
Raja,M,74,26,74,100
Ramiyah,F,100,100,0,100
Reiley,F,65,65,35,100
Rosabella,F,100,100,0,100
Saisha,F,100,100,0,100
Sebastion,M,100,0,100,100
Shailyn,F,100,100,0,100
Shandy,F,79,79,21,100
Shaylah,F,100,100,0,100
Temika,F,100,100,0,100
Terica,F,100,100,0,100
Valli,F,100,100,0,100
Varsha,F,100,100,0,100
Ventura,M,85,15,85,100
Vernessa,F,100,100,0,100
Alixandra,F,100,99,0,99
Amariana,F,100,99,0,99
Annita,F,100,99,0,99
Arlis,M,80,20,79,99
Britten,M,60,40,59,99
Cambry,F,100,99,0,99
Carlina,F,100,99,0,99
Chancy,M,66,34,65,99
Chavez,M,100,0,99,99
Christoffer,M,100,0,99,99
Cincere,M,77,23,76,99
Cruze,M,100,0,99,99
Daegan,M,95,5,94,99
Daelynn,F,95,94,5,99
Darnisha,F,100,99,0,99
Davonta,M,100,0,99,99
Denielle,F,100,99,0,99
Eber,M,100,0,99,99
Emmalie,F,100,99,0,99
Erron,M,100,0,99,99
Freddrick,M,100,0,99,99
Giovannie,M,100,0,99,99
Gweneth,F,100,99,0,99
Hamid,M,100,0,99,99
Ibrahima,M,100,0,99,99
Ilda,F,100,99,0,99
Ily,F,100,99,0,99
Imanol,M,100,0,99,99
Jabria,F,100,99,0,99
Jacquelynne,F,100,99,0,99
Jashon,M,100,0,99,99
Javonna,F,100,99,0,99
Jeanluc,M,100,0,99,99
Jerusha,F,100,99,0,99
Kainen,M,100,0,99,99
Kalem,M,100,0,99,99
Kalyssa,F,100,99,0,99
Katryna,F,100,99,0,99
Kendahl,F,88,87,12,99
Kenric,M,100,0,99,99
Kenyata,F,65,64,35,99
Kidus,M,100,0,99,99
Korah,F,100,99,0,99
Krislynn,F,100,99,0,99
Lindsie,F,100,99,0,99
Liyana,F,100,99,0,99
Marica,F,100,99,0,99
Marijane,F,100,99,0,99
Niomi,F,100,99,0,99
Pinchas,M,100,0,99,99
Ranger,M,100,0,99,99
Rashaan,M,100,0,99,99
Rea,F,100,99,0,99
Reghan,F,100,99,0,99
Rise,F,95,94,5,99
Rosslyn,F,100,99,0,99
Ryatt,M,93,7,92,99
Samyra,F,100,99,0,99
Sekou,M,100,0,99,99
Sharolyn,F,100,99,0,99
Shawntae,F,100,99,0,99
Shellee,F,100,99,0,99
Shylo,F,79,78,21,99
Sona,F,100,99,0,99
Taleen,F,100,99,0,99
Tiffiany,F,100,99,0,99
Verda,F,100,99,0,99
Yocelin,F,100,99,0,99
Yocelyn,F,100,99,0,99
Zahid,M,100,0,99,99
Adama,F,55,54,44,98
Aidin,M,100,0,98,98
Aixa,F,100,98,0,98
Akemi,F,100,98,0,98
Alon,M,100,0,98,98
Armonie,F,74,73,25,98
Authur,M,100,0,98,98
Aziel,M,100,0,98,98
Baya,F,100,98,0,98
Bayan,F,89,87,11,98
Caison,M,100,0,98,98
Daneen,F,100,98,0,98
Derrian,M,91,9,89,98
Donnis,F,55,54,44,98
Donyell,M,60,39,59,98
Emmarose,F,100,98,0,98
Fredi,M,92,8,90,98
Garron,M,100,0,98,98
Graeson,M,95,5,93,98
Heavyn,F,100,98,0,98
Jaelon,M,100,0,98,98
Jalena,F,100,98,0,98
Jalessa,F,100,98,0,98
Janylah,F,100,98,0,98
Jayvien,M,100,0,98,98
Jodene,F,100,98,0,98
Kaija,F,100,98,0,98
Kasper,M,100,0,98,98
Kassidee,F,100,98,0,98
Kieron,M,100,0,98,98
Klaudia,F,100,98,0,98
Lanee,F,100,98,0,98
Larsen,M,76,24,74,98
Laural,F,100,98,0,98
Libbie,F,100,98,0,98
Librado,M,100,0,98,98
Maiah,F,100,98,0,98
Marshaun,M,100,0,98,98
Maudie,F,100,98,0,98
Mehmet,M,100,0,98,98
Melea,F,100,98,0,98
Myrtis,F,100,98,0,98
Natalyn,F,100,98,0,98
Niklaus,M,100,0,98,98
Olan,M,100,0,98,98
Pace,M,100,0,98,98
Quintina,F,100,98,0,98
Raelin,F,100,98,0,98
Rajan,M,100,0,98,98
Ramir,M,100,0,98,98
Reis,M,87,13,85,98
Ronnette,F,100,98,0,98
Shadae,F,100,98,0,98
Shadi,M,79,21,77,98
Teofilo,M,100,0,98,98
Ulyses,M,100,0,98,98
Vander,M,100,0,98,98
Vi,F,85,83,15,98
Victoriano,M,100,0,98,98
Wenda,F,100,98,0,98
Zailey,F,100,98,0,98
Addelynn,F,100,97,0,97
Advik,M,100,0,97,97
Alainna,F,100,97,0,97
Alyxandra,F,100,97,0,97
Arick,M,100,0,97,97
Arletha,F,100,97,0,97
Aydenn,M,100,0,97,97
Citlally,F,100,97,0,97
Danella,F,100,97,0,97
Deavion,M,53,46,51,97
Devron,M,100,0,97,97
Domonick,M,100,0,97,97
Dyanne,F,100,97,0,97
Elmore,M,100,0,97,97
Emsley,F,100,97,0,97
Eriel,F,80,78,19,97
Gennie,F,90,87,10,97
Georgeanna,F,100,97,0,97
Gill,M,100,0,97,97
Horatio,M,100,0,97,97
Izik,M,100,0,97,97
Jabez,M,100,0,97,97
Jakson,M,100,0,97,97
Janalee,F,100,97,0,97
Jaquon,M,100,0,97,97
Jeanice,F,100,97,0,97
Jeter,M,100,0,97,97
Jettie,F,92,89,8,97
Johnthan,M,100,0,97,97
Kaan,M,100,0,97,97
Kani,M,72,27,70,97
Kaven,M,100,0,97,97
Kayliana,F,100,97,0,97
Kiva,F,95,92,5,97
Kortnie,F,100,97,0,97
Laquana,F,100,97,0,97
Lashanna,F,100,97,0,97
Latoshia,F,100,97,0,97
Lavera,F,100,97,0,97
Lenette,F,100,97,0,97
Lindi,F,100,97,0,97
Litzi,F,100,97,0,97
Luan,M,67,32,65,97
Lucrecia,F,100,97,0,97
Lyda,F,100,97,0,97
Lynley,F,100,97,0,97
Lyza,F,100,97,0,97
Madge,F,100,97,0,97
Morgann,F,100,97,0,97
Nathaneal,M,100,0,97,97
Neta,F,100,97,0,97
Oma,F,100,97,0,97
Quintavious,M,100,0,97,97
Risha,F,100,97,0,97
Sahir,M,100,0,97,97
Shalini,F,100,97,0,97
Shamaya,F,100,97,0,97
Sharina,F,100,97,0,97
Sherelle,F,100,97,0,97
Sherra,F,100,97,0,97
Shrey,M,100,0,97,97
Silvano,M,100,0,97,97
Sire,M,100,0,97,97
Somaya,F,100,97,0,97
Tahirah,F,100,97,0,97
Tayna,F,100,97,0,97
Terria,F,100,97,0,97
Thuy,F,100,97,0,97
Vallery,F,100,97,0,97
Velinda,F,100,97,0,97
Viviane,F,100,97,0,97
Zamora,F,100,97,0,97
Zaryah,F,100,97,0,97
Zya,F,100,97,0,97
Alexxa,F,100,96,0,96
Amr,M,100,0,96,96
Andon,M,100,0,96,96
Arelis,F,100,96,0,96
Aristotle,M,100,0,96,96
Arrington,M,68,31,65,96
Atom,M,100,0,96,96
Aviel,M,94,6,90,96
Benjie,M,94,6,90,96
Blimy,F,100,96,0,96
Bostyn,F,68,65,31,96
Brittini,F,100,96,0,96
Carlon,M,79,20,76,96
Chrissa,F,100,96,0,96
Christoher,M,100,0,96,96
Cloie,F,100,96,0,96
Coralyn,F,100,96,0,96
Cyrstal,F,100,96,0,96
Deborrah,F,100,96,0,96
Elanor,F,100,96,0,96
Electra,F,100,96,0,96
Ellamae,F,100,96,0,96
Emre,M,100,0,96,96
Ericson,M,100,0,96,96
Evert,M,100,0,96,96
Isayah,M,100,0,96,96
Ishika,F,100,96,0,96
Jaedan,M,85,14,82,96
Jaliya,F,100,96,0,96
Jedd,M,100,0,96,96
Jenai,F,100,96,0,96
Jonthan,M,100,0,96,96
Kaius,M,100,0,96,96
Kapri,F,100,96,0,96
Karas,M,100,0,96,96
Katja,F,100,96,0,96
Kean,M,100,0,96,96
Kong,M,100,0,96,96
Kortez,M,100,0,96,96
Krystine,F,100,96,0,96
Krystopher,M,100,0,96,96
Lamiya,F,100,96,0,96
Leandrew,M,100,0,96,96
Lekeisha,F,100,96,0,96
Leni,F,95,91,5,96
Lorelle,F,100,96,0,96
Makennah,F,100,96,0,96
Malynda,F,100,96,0,96
Mateus,M,100,0,96,96
Mckynzie,F,100,96,0,96
Mele,F,100,96,0,96
Morgyn,F,100,96,0,96
Nichola,F,89,85,11,96
Nnamdi,M,100,0,96,96
Ossie,M,71,28,68,96
Phong,M,100,0,96,96
Rayhan,M,100,0,96,96
Rielle,F,100,96,0,96
Sarahann,F,100,96,0,96
Sereniti,F,100,96,0,96
Shandon,M,88,12,84,96
Shanese,F,100,96,0,96
Shaquanna,F,100,96,0,96
Shmiel,M,100,0,96,96
Susette,F,100,96,0,96
Tafari,M,100,0,96,96
Taija,F,100,96,0,96
Talynn,F,100,96,0,96
Tammey,F,100,96,0,96
Thu,F,95,91,5,96
Timonthy,M,100,0,96,96
Trang,F,100,96,0,96
Tyrice,M,95,5,91,96
Wesly,M,100,0,96,96
Algernon,M,100,0,95,95
Allyse,F,100,95,0,95
Bertie,F,89,85,10,95
Briyana,F,100,95,0,95
Bucky,M,100,0,95,95
Carra,F,100,95,0,95
Carrissa,F,100,95,0,95
Clovis,M,91,9,86,95
Corinn,F,100,95,0,95
Corvin,M,100,0,95,95
Danzel,M,100,0,95,95
Davyn,M,89,10,85,95
Delayna,F,100,95,0,95
Dezmon,M,100,0,95,95
Dondre,M,100,0,95,95
Dyann,F,100,95,0,95
Elizah,F,78,74,21,95
Elysse,F,100,95,0,95
Finlee,F,89,85,10,95
Ilias,M,100,0,95,95
Jaritza,F,100,95,0,95
Jezebel,F,100,95,0,95
Joachim,M,100,0,95,95
Jonothan,M,100,0,95,95
July,F,76,72,23,95
Kalleigh,F,100,95,0,95
Keishawn,M,94,6,89,95
Keldrick,M,100,0,95,95
Keyaira,F,100,95,0,95
Kimo,M,100,0,95,95
Kirin,M,58,40,55,95
Kloee,F,100,95,0,95
Korra,F,100,95,0,95
Kristene,F,100,95,0,95
Lander,M,100,0,95,95
Laporsha,F,100,95,0,95
Laverna,F,100,95,0,95
Laysha,F,100,95,0,95
Madigan,F,100,95,0,95
Manisha,F,100,95,0,95
Maritsa,F,100,95,0,95
Marquitta,F,100,95,0,95
Nosson,M,100,0,95,95
Noura,F,100,95,0,95
Novah,F,77,73,22,95
Palma,F,100,95,0,95
Parisa,F,100,95,0,95
Pressley,F,83,79,16,95
Priscella,F,100,95,0,95
Ram,M,100,0,95,95
Rayfield,M,100,0,95,95
Renatta,F,100,95,0,95
Reynolds,M,88,11,84,95
Riot,M,85,14,81,95
Rosia,F,100,95,0,95
Rut,F,100,95,0,95
Ryver,M,57,41,54,95
Seirra,F,100,95,0,95
Selin,F,100,95,0,95
Severo,M,100,0,95,95
Shadonna,F,100,95,0,95
Shayaan,M,100,0,95,95
Shelsea,F,100,95,0,95
Sherise,F,100,95,0,95
Sherly,F,100,95,0,95
Shylee,F,100,95,0,95
Tammye,F,100,95,0,95
Tarell,M,100,0,95,95
Tenika,F,100,95,0,95
Treshaun,M,100,0,95,95
Triana,F,100,95,0,95
Tyeshia,F,100,95,0,95
Tyvon,M,100,0,95,95
Yadier,M,100,0,95,95
Yevette,F,100,95,0,95
Yides,F,100,95,0,95
Zophia,F,100,95,0,95
Ahsley,F,100,94,0,94
Alonda,F,100,94,0,94
Alyssah,F,100,94,0,94
Amrit,M,66,32,62,94
Anari,F,100,94,0,94
Antjuan,M,100,0,94,94
Aseel,F,83,78,16,94
Bionca,F,100,94,0,94
Bj,M,100,0,94,94
Caralee,F,100,94,0,94
Cassidi,F,100,94,0,94
Celesta,F,100,94,0,94
Channa,F,100,94,0,94
Cindee,F,100,94,0,94
Clarity,F,100,94,0,94
Claudie,M,64,34,60,94
Daytona,F,70,66,28,94
Dinora,F,100,94,0,94
Dock,M,100,0,94,94
Eureka,F,100,94,0,94
Fionna,F,100,94,0,94
Gautam,M,100,0,94,94
Gerrard,M,100,0,94,94
Hadrian,M,100,0,94,94
Hudsyn,F,51,48,46,94
Inaaya,F,100,94,0,94
Jadalynn,F,100,94,0,94
Jozlynn,F,100,94,0,94
Kadance,F,100,94,0,94
Kaliya,F,100,94,0,94
Kamyra,F,100,94,0,94
Kassy,F,100,94,0,94
Katrine,F,100,94,0,94
Khylie,F,100,94,0,94
Koral,F,100,94,0,94
Kynlie,F,100,94,0,94
Lenell,M,77,22,72,94
Lisbet,F,100,94,0,94
Lisseth,F,100,94,0,94
Lynsie,F,100,94,0,94
Maddy,F,100,94,0,94
Maki,M,65,33,61,94
Maraya,F,100,94,0,94
Marquice,M,100,0,94,94
Marvella,F,100,94,0,94
Matan,M,100,0,94,94
Mikelle,F,100,94,0,94
Ozell,M,94,6,88,94
Parks,M,100,0,94,94
Rasheda,F,100,94,0,94
Rockie,M,89,10,84,94
Rodriguez,M,95,5,89,94
Romana,F,100,94,0,94
Severin,M,100,0,94,94
Siana,F,100,94,0,94
Tahnee,F,100,94,0,94
Tailor,F,82,77,17,94
Takiya,F,100,94,0,94
Tamy,F,100,94,0,94
Terrilyn,F,100,94,0,94
Usher,M,100,0,94,94
Whitman,M,100,0,94,94
Yaneth,F,100,94,0,94
Yohanna,F,100,94,0,94
Zebadiah,M,100,0,94,94
Zylah,F,100,94,0,94
Airianna,F,100,93,0,93
Alaska,F,100,93,0,93
Alaynna,F,100,93,0,93
Alexandar,M,100,0,93,93
Ameria,F,100,93,0,93
Anmol,M,61,36,57,93
Annsley,F,100,93,0,93
Asmaa,F,100,93,0,93
Bee,M,84,15,78,93
Betina,F,100,93,0,93
Bralynn,F,78,73,20,93
Brittiany,F,100,93,0,93
Callee,F,100,93,0,93
Camile,F,100,93,0,93
Cesario,M,100,0,93,93
Charice,F,100,93,0,93
Charmain,F,100,93,0,93
Cobe,M,100,0,93,93
Corena,F,100,93,0,93
Daeshawn,M,100,0,93,93
Darah,F,100,93,0,93
Dezire,F,100,93,0,93
Diondra,F,95,88,5,93
Drexel,M,100,0,93,93
Earlean,F,100,93,0,93
Ector,M,100,0,93,93
Ellisa,F,100,93,0,93
Emmylou,F,100,93,0,93
Esta,F,100,93,0,93
Genavieve,F,100,93,0,93
Harlon,M,100,0,93,93
Henny,F,100,93,0,93
Jamaree,M,95,5,88,93
Jameria,F,100,93,0,93
Jara,F,100,93,0,93
Josalynn,F,100,93,0,93
Kaneshia,F,100,93,0,93
Kathe,F,100,93,0,93
Keston,M,100,0,93,93
Kimari,F,56,52,41,93
Kion,M,100,0,93,93
Koy,M,95,5,88,93
Larenzo,M,100,0,93,93
Larnell,M,100,0,93,93
Lashana,F,100,93,0,93
Lei,F,89,83,10,93
Liem,M,100,0,93,93
Lior,M,71,27,66,93
Makari,M,87,12,81,93
Mauri,F,82,76,17,93
Mayela,F,100,93,0,93
Nazario,M,100,0,93,93
Nicholos,M,100,0,93,93
Nieves,F,60,56,37,93
Pebbles,F,100,93,0,93
Penina,F,100,93,0,93
Peyten,F,82,76,17,93
Quaid,M,100,0,93,93
Radha,F,100,93,0,93
Railey,F,95,88,5,93
Ramie,F,73,68,25,93
Rayla,F,100,93,0,93
Romi,F,87,81,12,93
Ronesha,F,100,93,0,93
Sabryna,F,100,93,0,93
Shaka,M,78,20,73,93
Shamon,M,81,18,75,93
Taft,M,100,0,93,93
Tayven,M,91,8,85,93
Teresia,F,100,93,0,93
Terrace,M,95,5,88,93
Terrin,M,67,31,62,93
Tomasz,M,100,0,93,93
Tyrome,M,100,0,93,93
Xandria,F,100,93,0,93
Yakira,F,100,93,0,93
Zachry,M,100,0,93,93
Zavien,M,100,0,93,93
Zoltan,M,100,0,93,93
Zyanna,F,100,93,0,93
Abria,F,100,92,0,92
Albany,F,100,92,0,92
Amando,M,83,16,76,92
Amillia,F,100,92,0,92
Anastazia,F,100,92,0,92
Andreanna,F,100,92,0,92
Aneesah,F,100,92,0,92
Anneka,F,100,92,0,92
Antonios,M,100,0,92,92
Arina,F,100,92,0,92
Aubre,F,95,87,5,92
Avaleigh,F,100,92,0,92
Awa,F,100,92,0,92
Benzion,M,100,0,92,92
Bijan,M,91,8,84,92
Bransen,M,100,0,92,92
Brier,M,55,41,51,92
Brithany,F,100,92,0,92
Cainan,M,100,0,92,92
Camerin,M,72,26,66,92
Chaniya,F,100,92,0,92
Cloyd,M,100,0,92,92
Dayson,M,100,0,92,92
Deandria,F,100,92,0,92
Deseray,F,100,92,0,92
Divinity,F,100,92,0,92
Donica,F,100,92,0,92
Donnel,M,85,14,78,92
Eliya,F,80,74,18,92
Epiphany,F,100,92,0,92
Esabella,F,100,92,0,92
Evana,F,100,92,0,92
Faheem,M,100,0,92,92
Fatema,F,100,92,0,92
Gaines,M,100,0,92,92
Hisham,M,100,0,92,92
Janira,F,100,92,0,92
Jediah,M,100,0,92,92
Jule,F,67,62,30,92
Kamyla,F,100,92,0,92
Kassey,F,95,87,5,92
Kenli,F,100,92,0,92
Kenzington,F,100,92,0,92
Keriann,F,100,92,0,92
Kerrin,F,100,92,0,92
Kimberleigh,F,100,92,0,92
Laurynn,F,100,92,0,92
Laycee,F,100,92,0,92
Lean,F,83,76,16,92
Leasa,F,100,92,0,92
Leevi,M,100,0,92,92
Lenae,F,100,92,0,92
Leondra,F,100,92,0,92
Lexia,F,100,92,0,92
Luiza,F,100,92,0,92
Maguire,M,90,9,83,92
Makel,M,93,6,86,92
Marelyn,F,100,92,0,92
Marlayna,F,100,92,0,92
Montrel,M,100,0,92,92
Mylene,F,100,92,0,92
Navin,M,100,0,92,92
Nikos,M,100,0,92,92
Peterson,M,100,0,92,92
Saja,F,100,92,0,92
Sapphira,F,100,92,0,92
Sayde,F,100,92,0,92
Seleste,F,100,92,0,92
Selwyn,M,100,0,92,92
Serah,F,100,92,0,92
Shakiya,F,100,92,0,92
Shauntel,F,95,87,5,92
Shiva,M,64,33,59,92
Solara,F,100,92,0,92
Taggart,M,100,0,92,92
Tequilla,F,100,92,0,92
Terryn,F,72,66,26,92
Toryn,M,60,37,55,92
Tula,F,100,92,0,92
Tyrece,M,100,0,92,92
Tyrie,M,92,7,85,92
Velva,F,100,92,0,92
Viet,M,100,0,92,92
Vivi,F,100,92,0,92
Webb,M,100,0,92,92
Abubakar,M,100,0,91,91
Adithya,M,100,0,91,91
Aleigh,F,100,91,0,91
Amisha,F,100,91,0,91
Anastasios,M,100,0,91,91
Anthea,F,100,91,0,91
Artem,M,100,0,91,91
Auriel,F,92,84,7,91
Avionna,F,100,91,0,91
Ayannah,F,100,91,0,91
Azariyah,F,100,91,0,91
Barak,M,100,0,91,91
Bryonna,F,100,91,0,91
Camaron,M,95,5,86,91
Carlye,F,100,91,0,91
Carmin,F,95,86,5,91
Chancelor,M,100,0,91,91
Colene,F,100,91,0,91
Davante,M,100,0,91,91
Doria,F,100,91,0,91
Eboney,F,100,91,0,91
Emilynn,F,100,91,0,91
Emina,F,100,91,0,91
Eugena,F,100,91,0,91
Guiliana,F,100,91,0,91
Haylei,F,100,91,0,91
Honesti,F,100,91,0,91
Hortensia,F,100,91,0,91
Islam,M,84,15,76,91
Jalah,F,100,91,0,91
Jalicia,F,100,91,0,91
Jalisha,F,100,91,0,91
Jerimy,M,100,0,91,91
Jonita,F,100,91,0,91
Kamala,F,100,91,0,91
Kanani,F,100,91,0,91
Kaydan,M,85,14,77,91
Kaylinn,F,100,91,0,91
Kentavious,M,100,0,91,91
Kenzleigh,F,100,91,0,91
Keyera,F,100,91,0,91
Keyshaun,M,100,0,91,91
Keyton,M,100,0,91,91
Kourtnee,F,100,91,0,91
Landy,M,54,42,49,91
Lanesha,F,100,91,0,91
Lizzy,F,100,91,0,91
Manolo,M,100,0,91,91
Mariette,F,100,91,0,91
Merlene,F,100,91,0,91
Michelina,F,100,91,0,91
Nahom,M,100,0,91,91
Nefertiti,F,100,91,0,91
Nikkole,F,100,91,0,91
Oakleigh,F,100,91,0,91
Philipp,M,100,0,91,91
Pieter,M,100,0,91,91
Reanne,F,100,91,0,91
Romario,M,100,0,91,91
Rozanne,F,100,91,0,91
Rylinn,F,100,91,0,91
Shamiyah,F,100,91,0,91
Shatoya,F,100,91,0,91
Shyra,F,100,91,0,91
Sole,F,100,91,0,91
Tanay,M,58,38,53,91
Tran,F,74,67,24,91
Tya,F,100,91,0,91
Wheeler,M,100,0,91,91
Yobani,M,100,0,91,91
Youlanda,F,100,91,0,91
Yvonna,F,100,91,0,91
Zarria,F,100,91,0,91
Zebulun,M,100,0,91,91
Zeynep,F,100,91,0,91
Adrienna,F,100,90,0,90
Alayshia,F,100,90,0,90
Argelia,F,100,90,0,90
Arnette,F,94,85,5,90
Atharva,M,100,0,90,90
Auriana,F,100,90,0,90
Betsabe,F,100,90,0,90
Cadance,F,100,90,0,90
Caira,F,100,90,0,90
Carolanne,F,100,90,0,90
Chael,M,100,0,90,90
Charlean,F,100,90,0,90
Dadrian,M,100,0,90,90
Dalon,M,100,0,90,90
Devone,M,71,26,64,90
Dimitra,F,100,90,0,90
Drevon,M,100,0,90,90
Earvin,M,100,0,90,90
Elenora,F,100,90,0,90
Elston,M,100,0,90,90
Elyce,F,100,90,0,90
Eneida,F,100,90,0,90
Galvin,M,100,0,90,90
Graden,M,100,0,90,90
Hajar,F,100,90,0,90
Izac,M,100,0,90,90
Janayah,F,100,90,0,90
Jasmaine,F,100,90,0,90
Jeannetta,F,100,90,0,90
Jenner,M,94,5,85,90
Johnatan,M,100,0,90,90
Jolina,F,100,90,0,90
Julieth,F,100,90,0,90
Juliett,F,100,90,0,90
Kamira,F,100,90,0,90
Kashmir,F,67,60,30,90
Kavan,M,100,0,90,90
Kensleigh,F,100,90,0,90
Khayla,F,100,90,0,90
Koryn,F,100,90,0,90
Laroy,M,100,0,90,90
Latrese,F,100,90,0,90
Leidy,F,100,90,0,90
Liba,F,100,90,0,90
Lilianne,F,100,90,0,90
Lore,F,100,90,0,90
Lysander,M,100,0,90,90
Maddyn,F,94,85,5,90
Makaio,M,100,0,90,90
Makensie,F,100,90,0,90
Markee,M,91,8,82,90
Melenie,F,100,90,0,90
Mercer,M,76,22,68,90
Nandini,F,100,90,0,90
Naveed,M,100,0,90,90
Odie,M,92,7,83,90
Ouida,F,100,90,0,90
Padraig,M,100,0,90,90
Patrik,M,100,0,90,90
Radames,M,100,0,90,90
Ryo,M,100,0,90,90
Shamyra,F,100,90,0,90
Shonte,F,100,90,0,90
Stasha,F,100,90,0,90
Stavros,M,100,0,90,90
Tailyn,F,100,90,0,90
Tani,F,100,90,0,90
Tashawna,F,100,90,0,90
Teana,F,100,90,0,90
Teona,F,100,90,0,90
Townes,M,100,0,90,90
Viana,F,100,90,0,90
Yechezkel,M,100,0,90,90
Yovany,M,100,0,90,90
Yumi,F,100,90,0,90
Zamiya,F,100,90,0,90
Abhishek,M,100,0,89,89
Africa,F,100,89,0,89
Alicyn,F,100,89,0,89
Allisha,F,100,89,0,89
Analyse,F,100,89,0,89
Ankit,M,100,0,89,89
Anyiah,F,100,89,0,89
Arash,M,100,0,89,89
Avari,F,92,82,7,89
Ayat,F,100,89,0,89
Bethaney,F,100,89,0,89
Betzy,F,100,89,0,89
Brandis,F,78,69,20,89
Bridgitte,F,100,89,0,89
Briyanna,F,100,89,0,89
Cambri,F,100,89,0,89
Charlesetta,F,100,89,0,89
Cheyenna,F,100,89,0,89
Chirstopher,M,100,0,89,89
Conni,F,100,89,0,89
Corene,F,100,89,0,89
Criss,M,93,6,83,89
Daijon,M,100,0,89,89
Dawud,M,100,0,89,89
Dayami,F,100,89,0,89
Dayonna,F,100,89,0,89
Dayron,M,100,0,89,89
Demon,M,100,0,89,89
Denesha,F,100,89,0,89
Derrin,M,100,0,89,89
Dodge,M,100,0,89,89
Eastin,M,100,0,89,89
Elijha,M,100,0,89,89
Ellyse,F,100,89,0,89
Faithlynn,F,100,89,0,89
Farren,F,80,71,18,89
Jacklin,F,100,89,0,89
Jacobie,M,100,0,89,89
Jakeria,F,100,89,0,89
Jennalee,F,100,89,0,89
Jermal,M,100,0,89,89
Joleigh,F,100,89,0,89
Joyanna,F,100,89,0,89
Julious,M,100,0,89,89
Kaisley,F,100,89,0,89
Kameren,M,83,15,74,89
Kamry,F,100,89,0,89
Kareema,F,100,89,0,89
Kaseem,M,100,0,89,89
Katarzyna,F,100,89,0,89
Kolter,M,100,0,89,89
Kwesi,M,100,0,89,89
Laray,F,54,48,41,89
Lyna,F,100,89,0,89
Maire,F,100,89,0,89
Mandee,F,100,89,0,89
Markesha,F,100,89,0,89
Maryhelen,F,100,89,0,89
Marymargaret,F,100,89,0,89
Mechele,F,100,89,0,89
Natasia,F,100,89,0,89
Nolyn,M,94,5,84,89
Owyn,M,94,5,84,89
Pax,M,94,5,84,89
Paytin,F,100,89,0,89
Quenten,M,100,0,89,89
Rashan,M,94,5,84,89
Ronit,M,54,41,48,89
Sandor,M,100,0,89,89
Sebastiano,M,100,0,89,89
Selim,M,100,0,89,89
Senaida,F,100,89,0,89
Shaheem,M,100,0,89,89
Shaquanda,F,100,89,0,89
Sonam,F,81,72,17,89
Taevon,M,100,0,89,89
Tarun,M,100,0,89,89
Tashaun,M,92,7,82,89
Tawna,F,100,89,0,89
Tawnie,F,100,89,0,89
Taye,M,100,0,89,89
Teasia,F,100,89,0,89
Therman,M,100,0,89,89
Tirrell,M,100,0,89,89
Treavor,M,100,0,89,89
Trenity,F,100,89,0,89
Vu,M,100,0,89,89
Waymond,M,100,0,89,89
Wendee,F,100,89,0,89
Xyla,F,100,89,0,89
Yu,F,54,48,41,89
Zaedyn,M,100,0,89,89
Zamaria,F,100,89,0,89
Aaditya,M,100,0,88,88
Aaradhya,F,100,88,0,88
Aedyn,M,93,6,82,88
Aeriel,F,100,88,0,88
Alandra,F,100,88,0,88
Alayjah,F,100,88,0,88
Alfredia,F,100,88,0,88
Anyia,F,100,88,0,88
Arther,M,100,0,88,88
Berklee,F,100,88,0,88
Breeze,F,91,80,8,88
Brenan,M,100,0,88,88
Burnett,M,74,23,65,88
Caelin,F,53,47,41,88
Calan,M,100,0,88,88
Camilia,F,100,88,0,88
Casaundra,F,100,88,0,88
Coralynn,F,100,88,0,88
Corynn,F,100,88,0,88
Dayon,M,100,0,88,88
Derell,M,100,0,88,88
Desha,F,100,88,0,88
Devi,F,100,88,0,88
Eshaal,F,100,88,0,88
Faizan,M,100,0,88,88
Fareed,M,100,0,88,88
Hilarie,F,100,88,0,88
Jayliana,F,100,88,0,88
Jeffrie,M,94,5,83,88
Jillene,F,100,88,0,88
Joshlynn,F,100,88,0,88
Kahla,F,100,88,0,88
Kalise,F,100,88,0,88
Kama,F,100,88,0,88
Kammie,F,100,88,0,88
Karyna,F,100,88,0,88
Kathrina,F,100,88,0,88
Kawana,F,100,88,0,88
Khary,M,100,0,88,88
Kherington,F,100,88,0,88
Kyndell,F,83,73,15,88
Lalita,F,100,88,0,88
Lorilee,F,100,88,0,88
Lynnlee,F,100,88,0,88
Maddelyn,F,100,88,0,88
Maddilynn,F,100,88,0,88
Makhai,M,100,0,88,88
Matix,M,100,0,88,88
Mayci,F,100,88,0,88
Maylen,F,100,88,0,88
Miryam,F,100,88,0,88
Nadeem,M,100,0,88,88
Naiomi,F,100,88,0,88
Najma,F,100,88,0,88
Navi,F,70,62,26,88
Neri,M,72,25,63,88
Nyles,M,100,0,88,88
Rabecca,F,100,88,0,88
Raevyn,F,100,88,0,88
Railyn,F,100,88,0,88
Reily,M,65,31,57,88
Renny,M,84,14,74,88
Riggs,M,100,0,88,88
Roen,M,100,0,88,88
Rossi,F,66,58,30,88
Samy,M,100,0,88,88
Shakeem,M,100,0,88,88
Shavonna,F,100,88,0,88
Shayleigh,F,100,88,0,88
Skarlett,F,100,88,0,88
Talib,M,100,0,88,88
Tanae,F,100,88,0,88
Tayten,M,84,14,74,88
Thang,M,92,7,81,88
Uriyah,M,77,20,68,88
Valdemar,M,100,0,88,88
Valor,M,86,12,76,88
Yale,M,100,0,88,88
Yona,F,53,47,41,88
Zian,M,76,21,67,88
Zyasia,F,100,88,0,88
Adali,F,100,87,0,87
Adelyne,F,100,87,0,87
Adon,M,100,0,87,87
Akim,M,100,0,87,87
Akshaya,F,100,87,0,87
Alanda,F,100,87,0,87
Aleina,F,100,87,0,87
Anam,F,100,87,0,87
Antonietta,F,100,87,0,87
Arsh,M,100,0,87,87
Avie,F,100,87,0,87
Aydon,M,100,0,87,87
Brylen,M,92,7,80,87
Camrynn,F,94,82,5,87
Chanta,F,100,87,0,87
Charlynn,F,100,87,0,87
Christabel,F,100,87,0,87
Conlan,M,100,0,87,87
Cricket,F,100,87,0,87
Daniyal,M,100,0,87,87
Daphine,F,100,87,0,87
Darl,M,100,0,87,87
Daryan,M,84,14,73,87
Daviana,F,100,87,0,87
Dawsyn,F,61,53,34,87
Denine,F,100,87,0,87
Destynee,F,100,87,0,87
Dorina,F,100,87,0,87
Draco,M,100,0,87,87
Edilberto,M,100,0,87,87
Emrys,M,77,20,67,87
Erion,M,68,28,59,87
Ernst,M,100,0,87,87
Esteven,M,100,0,87,87
Gable,M,100,0,87,87
Haider,M,100,0,87,87
Haili,F,100,87,0,87
Heyward,M,100,0,87,87
Idaly,F,100,87,0,87
Jadeyn,F,94,82,5,87
Jadie,F,100,87,0,87
Jameir,M,100,0,87,87
Jamonte,M,100,0,87,87
Javaughn,M,100,0,87,87
Jaynee,F,100,87,0,87
Jenean,F,100,87,0,87
Jera,F,100,87,0,87
Jerelyn,F,100,87,0,87
Joane,F,100,87,0,87
Kavi,M,100,0,87,87
Kerby,M,91,8,79,87
Kymora,F,100,87,0,87
Lashauna,F,100,87,0,87
Lavonia,F,100,87,0,87
Leianna,F,100,87,0,87
Lindsi,F,100,87,0,87
Luzmaria,F,100,87,0,87
Mackensie,F,100,87,0,87
Maddalyn,F,100,87,0,87
Malaina,F,100,87,0,87
Marisabel,F,100,87,0,87
Marriah,F,100,87,0,87
Matheo,M,100,0,87,87
Mckynlee,F,100,87,0,87
Mikela,F,100,87,0,87
Mitchelle,F,71,62,25,87
Mykael,M,79,18,69,87
Mykia,F,100,87,0,87
Nadirah,F,100,87,0,87
Nykia,F,100,87,0,87
Paxtyn,F,51,44,43,87
Phoenyx,F,69,60,27,87
Quianna,F,100,87,0,87
Razan,F,100,87,0,87
Rorie,F,100,87,0,87
Sada,F,100,87,0,87
Samad,M,100,0,87,87
Shakirah,F,100,87,0,87
Shawnette,F,100,87,0,87
Sherley,F,100,87,0,87
Sigmund,M,100,0,87,87
Spirit,F,94,82,5,87
Tabbatha,F,100,87,0,87
Terrah,F,100,87,0,87
Thimothy,M,100,0,87,87
Travell,M,100,0,87,87
Tyon,M,100,0,87,87
Walden,M,100,0,87,87
Yelitza,F,100,87,0,87
Zacheriah,M,100,0,87,87
Zuleima,F,100,87,0,87
Agapito,M,100,0,86,86
Ahmet,M,100,0,86,86
Aleksa,F,100,86,0,86
Allante,M,74,22,64,86
Ameliah,F,100,86,0,86
Angelynn,F,100,86,0,86
Antonyo,M,100,0,86,86
Areanna,F,100,86,0,86
Arvid,M,100,0,86,86
Ashland,F,84,72,14,86
Avram,M,100,0,86,86
Billye,F,100,86,0,86
Briasia,F,100,86,0,86
Briel,F,100,86,0,86
Brittanee,F,100,86,0,86
Brittania,F,100,86,0,86
Calee,F,100,86,0,86
Ceanna,F,100,86,0,86
Cerissa,F,100,86,0,86
Chapman,M,100,0,86,86
Colbi,F,92,79,7,86
Cristel,F,100,86,0,86
Crystel,F,100,86,0,86
Cyndee,F,100,86,0,86
Daenerys,F,100,86,0,86
Danessa,F,100,86,0,86
Darrah,F,100,86,0,86
Dawnmarie,F,100,86,0,86
Demir,M,100,0,86,86
Donnita,F,100,86,0,86
Edwyn,M,100,0,86,86
Eiden,M,100,0,86,86
Eliora,F,100,86,0,86
Elza,F,65,56,30,86
Felipa,F,100,86,0,86
Geoffry,M,100,0,86,86
Gerrie,F,100,86,0,86
Ginna,F,100,86,0,86
Greidys,F,100,86,0,86
Halina,F,100,86,0,86
Helga,F,100,86,0,86
Hershy,M,100,0,86,86
Imaan,F,86,74,12,86
Jacquelene,F,100,86,0,86
Janyia,F,100,86,0,86
Jayron,M,100,0,86,86
Jenea,F,100,86,0,86
Joselito,M,100,0,86,86
Josemaria,M,100,0,86,86
Jotham,M,100,0,86,86
Kariann,F,100,86,0,86
Kelcee,F,100,86,0,86
Kenedi,F,100,86,0,86
Kila,F,100,86,0,86
Kileigh,F,100,86,0,86
Korrie,F,94,81,5,86
Lakendrick,M,100,0,86,86
Langley,F,94,81,5,86
Lessly,F,100,86,0,86
Lonell,M,100,0,86,86
Louanna,F,100,86,0,86
Madalynne,F,100,86,0,86
Maisey,F,100,86,0,86
Mariaguadalupe,F,100,86,0,86
Maribella,F,100,86,0,86
Mckenzee,F,100,86,0,86
Meloney,F,100,86,0,86
Merilyn,F,100,86,0,86
Mister,M,100,0,86,86
Nadene,F,100,86,0,86
Naji,M,100,0,86,86
Nicholis,M,100,0,86,86
Omri,M,100,0,86,86
Prentis,M,100,0,86,86
Prescilla,F,100,86,0,86
Puja,F,100,86,0,86
Raneem,F,100,86,0,86
Renne,F,86,74,12,86
Roisin,F,100,86,0,86
Rossana,F,100,86,0,86
Sabir,M,100,0,86,86
Samyah,F,100,86,0,86
Steffon,M,100,0,86,86
Sunil,M,100,0,86,86
Telia,F,100,86,0,86
Teyana,F,100,86,0,86
Tovah,F,100,86,0,86
Tynan,M,100,0,86,86
Yanni,M,77,20,66,86
Aahil,M,100,0,85,85
Amarri,F,51,43,42,85
Angelise,F,100,85,0,85
Annalicia,F,100,85,0,85
Ashraf,M,100,0,85,85
Baldomero,M,100,0,85,85
Benard,M,100,0,85,85
Binyamin,M,100,0,85,85
Bradey,M,100,0,85,85
Brexton,M,100,0,85,85
Breyonna,F,100,85,0,85
Brit,M,86,12,73,85
Brylon,M,100,0,85,85
Brynnley,F,100,85,0,85
Carrieann,F,100,85,0,85
Catherin,F,100,85,0,85
Clarinda,F,100,85,0,85
Clarita,F,100,85,0,85
Cleta,F,100,85,0,85
Coltan,M,100,0,85,85
Darling,F,100,85,0,85
Delroy,M,100,0,85,85
Demontae,M,100,0,85,85
Elyanna,F,100,85,0,85
Erendira,F,100,85,0,85
Georganna,F,100,85,0,85
Glenwood,M,100,0,85,85
Halia,F,100,85,0,85
Harman,M,81,16,69,85
Haylea,F,100,85,0,85
Jaquita,F,100,85,0,85
Javarius,M,100,0,85,85
Jenika,F,100,85,0,85
Jerilynn,F,100,85,0,85
Jessamyn,F,100,85,0,85
Joellyn,F,100,85,0,85
Joniel,M,100,0,85,85
Josselin,F,100,85,0,85
Kalysta,F,100,85,0,85
Karrah,F,100,85,0,85
Katerin,F,100,85,0,85
Katisha,F,100,85,0,85
Kavita,F,100,85,0,85
Kemarion,M,100,0,85,85
Kemp,M,100,0,85,85
Kerianne,F,100,85,0,85
Korri,F,93,79,6,85
Kourtnie,F,100,85,0,85
Kwabena,M,100,0,85,85
Kyria,F,100,85,0,85
Lakeitha,F,100,85,0,85
Lavaughn,M,86,12,73,85
Liseth,F,100,85,0,85
Loreli,F,100,85,0,85
Lyllian,F,100,85,0,85
Mahad,M,100,0,85,85
Maleena,F,100,85,0,85
Mikkel,M,100,0,85,85
Montell,M,100,0,85,85
Musab,M,100,0,85,85
Nalah,F,100,85,0,85
Natale,M,52,41,44,85
Ninette,F,100,85,0,85
Oliviah,F,100,85,0,85
Ontario,M,100,0,85,85
Quetzalli,F,100,85,0,85
Railynn,F,100,85,0,85
Reatha,F,100,85,0,85
Robinette,F,100,85,0,85
Rosaleen,F,100,85,0,85
Safwan,M,100,0,85,85
Sahra,F,100,85,0,85
Secret,F,100,85,0,85
Shareka,F,100,85,0,85
Sharol,F,100,85,0,85
Shenna,F,100,85,0,85
Shermaine,F,67,57,28,85
Shiree,F,100,85,0,85
Sylvana,F,100,85,0,85
Tamiah,F,100,85,0,85
Taniesha,F,100,85,0,85
Taria,F,94,80,5,85
Tilden,M,100,0,85,85
Tonika,F,100,85,0,85
Tyrelle,M,94,5,80,85
Viva,F,100,85,0,85
Whitlee,F,100,85,0,85
Wm,M,100,0,85,85
Yamir,M,100,0,85,85
Zaliyah,F,100,85,0,85
Zebedee,M,100,0,85,85
Ziggy,M,93,6,79,85
Zowie,F,100,85,0,85
Amilcar,M,100,0,84,84
Angeleah,F,100,84,0,84
Angelisa,F,100,84,0,84
Aran,M,100,0,84,84
Arisa,F,100,84,0,84
Armanda,F,100,84,0,84
Audreanna,F,100,84,0,84
Blenda,F,100,84,0,84
Bobbiejo,F,100,84,0,84
Braydyn,M,100,0,84,84
Brena,F,100,84,0,84
Caleah,F,100,84,0,84
Catlyn,F,100,84,0,84
Cesilia,F,100,84,0,84
Chayanne,M,60,34,50,84
Clementina,F,100,84,0,84
Corde,M,94,5,79,84
Coulter,M,100,0,84,84
Daequan,M,100,0,84,84
Dari,F,100,84,0,84
Darlin,F,100,84,0,84
Darran,M,100,0,84,84
Deklyn,M,76,20,64,84
Dennison,M,100,0,84,84
Denys,F,64,54,30,84
Dharma,F,100,84,0,84
Diangelo,M,100,0,84,84
Elizbeth,F,100,84,0,84
Emori,F,83,70,14,84
Fabienne,F,100,84,0,84
Gerrod,M,100,0,84,84
Ginnie,F,100,84,0,84
Habib,M,100,0,84,84
Habiba,F,100,84,0,84
Halston,M,75,21,63,84
Hera,F,100,84,0,84
Holton,M,100,0,84,84
Jacksen,M,100,0,84,84
Jalal,M,100,0,84,84
Jamille,M,54,39,45,84
Javar,M,100,0,84,84
Jazel,F,100,84,0,84
Jezabel,F,100,84,0,84
Joclyn,F,100,84,0,84
Jolanda,F,100,84,0,84
Jossie,F,93,78,6,84
Kasim,M,100,0,84,84
Kaylynne,F,100,84,0,84
Kendrea,F,100,84,0,84
Kerriann,F,100,84,0,84
Keshun,M,100,0,84,84
Kimya,F,100,84,0,84
Kymberlee,F,100,84,0,84
Lamond,M,100,0,84,84
Laurissa,F,100,84,0,84
Lavetta,F,100,84,0,84
Leiland,M,100,0,84,84
Lleyton,M,100,0,84,84
Lynnsey,F,100,84,0,84
Lysa,F,100,84,0,84
Maggi,F,100,84,0,84
Makylah,F,100,84,0,84
Marcellous,M,100,0,84,84
Marketta,F,100,84,0,84
Melchor,M,100,0,84,84
Meliah,F,100,84,0,84
Mesa,F,100,84,0,84
Miri,F,100,84,0,84
Montel,M,100,0,84,84
Mylinda,F,100,84,0,84
Nasya,F,100,84,0,84
Ole,M,100,0,84,84
Paeton,F,80,67,17,84
Philemon,M,100,0,84,84
Randolf,M,100,0,84,84
Recardo,M,100,0,84,84
Renell,F,88,74,10,84
Rhodes,M,92,7,77,84
Richa,F,100,84,0,84
Rogue,M,52,40,44,84
Rubye,F,100,84,0,84
Shalena,F,100,84,0,84
Shawnie,F,100,84,0,84
Sheneka,F,100,84,0,84
Sheniqua,F,100,84,0,84
Sherene,F,100,84,0,84
Skyleigh,F,100,84,0,84
Suhana,F,100,84,0,84
Swara,F,100,84,0,84
Talal,M,100,0,84,84
Tamora,F,100,84,0,84
Tariyah,F,100,84,0,84
Tasnim,F,100,84,0,84
Trajan,M,100,0,84,84
Westly,M,100,0,84,84
Yonah,M,100,0,84,84
Yzabella,F,100,84,0,84
Zachory,M,100,0,84,84
Aarnav,M,100,0,83,83
Abdelrahman,M,100,0,83,83
Abegail,F,100,83,0,83
Abree,F,100,83,0,83
Ainslie,F,100,83,0,83
Alexes,F,83,69,14,83
Alisyn,F,100,83,0,83
Allicia,F,100,83,0,83
Amyrah,F,100,83,0,83
Arcadio,M,100,0,83,83
Arjan,M,100,0,83,83
Arlando,M,100,0,83,83
Camella,F,100,83,0,83
Carolynne,F,100,83,0,83
Christobal,M,100,0,83,83
Clarise,F,100,83,0,83
Colvin,M,100,0,83,83
Derrica,F,100,83,0,83
Deshawna,F,100,83,0,83
Diontae,M,100,0,83,83
Dre,M,100,0,83,83
Dupree,M,100,0,83,83
Eleonora,F,100,83,0,83
Elliotte,F,100,83,0,83
Evanna,F,100,83,0,83
Falisha,F,100,83,0,83
Felita,F,100,83,0,83
France,F,87,72,11,83
Gasper,M,100,0,83,83
Georganne,F,100,83,0,83
Grahm,M,100,0,83,83
Granger,M,100,0,83,83
Harini,F,100,83,0,83
Howie,M,100,0,83,83
Jadrian,M,94,5,78,83
Jakhari,M,100,0,83,83
Jamelia,F,100,83,0,83
Jameshia,F,100,83,0,83
Jamyia,F,100,83,0,83
Jaquarius,M,100,0,83,83
Jaquetta,F,100,83,0,83
Javonta,M,100,0,83,83
Jezreel,M,80,17,66,83
Joseantonio,M,100,0,83,83
Jostin,M,100,0,83,83
Juanmanuel,M,100,0,83,83
Kaelie,F,100,83,0,83
Kailei,F,100,83,0,83
Kambry,F,100,83,0,83
Kathren,F,100,83,0,83
Keiko,F,100,83,0,83
Kenedy,F,100,83,0,83
Kennadee,F,100,83,0,83
Kenzlie,F,100,83,0,83
Keyvon,M,100,0,83,83
Khanh,F,52,43,40,83
Kou,M,94,5,78,83
Lenise,F,100,83,0,83
Lyndia,F,100,83,0,83
Makyah,F,100,83,0,83
Manfred,M,100,0,83,83
Marry,F,100,83,0,83
Mikaella,F,100,83,0,83
Nassir,M,100,0,83,83
Pamila,F,100,83,0,83
Pamla,F,100,83,0,83
Park,M,100,0,83,83
Peaches,F,100,83,0,83
Phillips,M,100,0,83,83
Queena,F,100,83,0,83
Rifka,F,100,83,0,83
Sabin,M,100,0,83,83
Santanna,F,100,83,0,83
Saphire,F,100,83,0,83
Sarkis,M,100,0,83,83
Sharry,F,100,83,0,83
Siarra,F,100,83,0,83
Sion,M,88,10,73,83
Skipper,M,100,0,83,83
Swayze,F,81,67,16,83
Tavish,M,94,5,78,83
Tevita,M,100,0,83,83
Traven,M,100,0,83,83
Tywon,M,100,0,83,83
Vanetta,F,100,83,0,83
Viggo,M,100,0,83,83
Willene,F,100,83,0,83
Winton,M,100,0,83,83
Adelie,F,100,82,0,82
Advay,M,100,0,82,82
Adyan,M,100,0,82,82
Alajah,F,100,82,0,82
Alauna,F,100,82,0,82
Alias,M,100,0,82,82
Ambra,F,100,82,0,82
Amery,F,88,72,10,82
Artur,M,100,0,82,82
Averey,F,71,58,24,82
Bexley,F,87,71,11,82
Brocha,F,100,82,0,82
Brockton,M,100,0,82,82
Brydon,M,100,0,82,82
Camiyah,F,100,82,0,82
Charle,M,84,13,69,82
Charlsie,F,100,82,0,82
Chrishawn,M,83,14,68,82
Cobey,M,100,0,82,82
Coree,F,62,51,31,82
Daesha,F,100,82,0,82
Damaya,F,100,82,0,82
Danay,F,100,82,0,82
Danaya,F,100,82,0,82
Danetta,F,100,82,0,82
Dariyah,F,100,82,0,82
Davita,F,100,82,0,82
Delphia,F,100,82,0,82
Demaris,F,71,58,24,82
Dene,F,91,75,7,82
Dotty,F,100,82,0,82
Dwana,F,100,82,0,82
Ekam,M,56,36,46,82
Elson,M,100,0,82,82
Esmae,F,100,82,0,82
Evany,F,100,82,0,82
Eviana,F,100,82,0,82
Genell,F,100,82,0,82
Genisis,F,100,82,0,82
Gerhard,M,100,0,82,82
Gershon,M,100,0,82,82
Giuseppina,F,100,82,0,82
Hanif,M,100,0,82,82
Harmoney,F,100,82,0,82
Hawk,M,100,0,82,82
Ilyssa,F,100,82,0,82
Jarrel,M,100,0,82,82
Jawon,M,100,0,82,82
Jerid,M,100,0,82,82
Jilian,F,100,82,0,82
Jiovani,M,100,0,82,82
Joss,M,57,35,47,82
Kagan,M,100,0,82,82
Kalliope,F,100,82,0,82
Kearstin,F,100,82,0,82
Keleigh,F,100,82,0,82
Kem,M,61,32,50,82
Kemoni,F,55,45,37,82
Kenly,F,100,82,0,82
Kesley,F,93,76,6,82
Kiyanna,F,100,82,0,82
Kynsley,F,100,82,0,82
Lania,F,100,82,0,82
Letecia,F,100,82,0,82
Makeba,F,100,82,0,82
Makhia,F,100,82,0,82
Maliq,M,100,0,82,82
Manley,M,100,0,82,82
Margarete,F,100,82,0,82
Marlan,M,100,0,82,82
Marrisa,F,100,82,0,82
Meriam,F,100,82,0,82
Misa,F,100,82,0,82
Nataliya,F,100,82,0,82
Obinna,M,100,0,82,82
Parnell,M,100,0,82,82
Parsa,M,100,0,82,82
Peace,F,76,62,20,82
Persia,F,100,82,0,82
Presten,M,100,0,82,82
Rafeal,M,100,0,82,82
Rahaf,F,100,82,0,82
Ramey,F,59,48,34,82
Rasha,F,100,82,0,82
Rishab,M,100,0,82,82
Saffron,F,100,82,0,82
Saleena,F,100,82,0,82
Sandeep,M,85,12,70,82
Sang,M,100,0,82,82
Senna,F,91,75,7,82
Sharlotte,F,100,82,0,82
Shaune,M,57,35,47,82
Shelita,F,100,82,0,82
Sherica,F,100,82,0,82
Sherill,F,100,82,0,82
Sherina,F,100,82,0,82
Sherlin,F,100,82,0,82
Shontae,F,100,82,0,82
Shyan,F,94,77,5,82
Shyloh,F,80,66,16,82
Soha,F,100,82,0,82
Sriram,M,100,0,82,82
Tamer,M,100,0,82,82
Tonita,F,100,82,0,82
Traevon,M,100,0,82,82
Tully,M,91,7,75,82
Tyrion,M,100,0,82,82
Willetta,F,100,82,0,82
Wrigley,M,60,33,49,82
Yul,M,100,0,82,82
Zahava,F,100,82,0,82
Aidee,F,100,81,0,81
Aleea,F,100,81,0,81
Aliesha,F,100,81,0,81
Alissia,F,100,81,0,81
Amey,F,100,81,0,81
Amogh,M,100,0,81,81
Analiz,F,100,81,0,81
Andreia,F,100,81,0,81
Annaly,F,100,81,0,81
Anoushka,F,100,81,0,81
Ariele,F,100,81,0,81
Avant,M,100,0,81,81
Avett,M,91,7,74,81
Barbi,F,100,81,0,81
Basya,F,100,81,0,81
Belicia,F,100,81,0,81
Bernardine,F,100,81,0,81
Brianny,F,100,81,0,81
Cheng,M,93,6,75,81
Chico,M,100,0,81,81
Chidera,F,69,56,25,81
Daliah,F,100,81,0,81
Daymond,M,100,0,81,81
Daysia,F,100,81,0,81
Deen,M,100,0,81,81
Dung,M,57,35,46,81
Elysha,F,94,76,5,81
Emelina,F,100,81,0,81
Eriq,M,100,0,81,81
Evann,M,59,33,48,81
Falicia,F,100,81,0,81
Finleigh,F,100,81,0,81
Froylan,M,100,0,81,81
Gaurav,M,100,0,81,81
Georgeanne,F,100,81,0,81
Giuliano,M,100,0,81,81
Jahvon,M,100,0,81,81
Jantzen,M,93,6,75,81
Jayah,F,100,81,0,81
Jayln,M,64,29,52,81
Jeaneen,F,100,81,0,81
Jeneva,F,100,81,0,81
Jhoana,F,100,81,0,81
Josiyah,M,100,0,81,81
Kamau,M,100,0,81,81
Kashif,M,100,0,81,81
Katera,F,100,81,0,81
Kaytie,F,100,81,0,81
Kelyn,F,56,45,36,81
Khaliq,M,100,0,81,81
Lakshmi,F,100,81,0,81
Langdon,M,100,0,81,81
Leighla,F,100,81,0,81
Lera,F,100,81,0,81
Malone,M,53,38,43,81
Marck,M,100,0,81,81
Marguerita,F,100,81,0,81
Mariea,F,100,81,0,81
Marit,F,100,81,0,81
Maryfrances,F,100,81,0,81
Mazin,M,100,0,81,81
Nakeya,F,100,81,0,81
Oluwatobi,M,73,22,59,81
Ramzi,M,100,0,81,81
Ronn,M,100,0,81,81
Rosalin,F,100,81,0,81
Rosette,F,100,81,0,81
Sevastian,M,100,0,81,81
Shyam,M,100,0,81,81
Siomara,F,100,81,0,81
Syrena,F,100,81,0,81
Tabbitha,F,100,81,0,81
Tarina,F,100,81,0,81
Taveon,M,100,0,81,81
Taylah,F,100,81,0,81
Taysha,F,100,81,0,81
Theotis,M,100,0,81,81
Trustin,M,100,0,81,81
Vena,F,100,81,0,81
Yadhira,F,100,81,0,81
Ysidro,M,100,0,81,81
Zulay,F,100,81,0,81
Zyonna,F,100,81,0,81
Alim,M,100,0,80,80
Alura,F,100,80,0,80
Anden,M,100,0,80,80
Annessa,F,100,80,0,80
Antonie,M,100,0,80,80
Anum,F,100,80,0,80
Aristeo,M,100,0,80,80
Ariza,F,100,80,0,80
Aryel,F,90,72,8,80
Avelino,M,100,0,80,80
Ayra,F,100,80,0,80
Berlynn,F,100,80,0,80
Bertina,F,100,80,0,80
Bobbye,F,100,80,0,80
Brelyn,F,92,74,6,80
Breyon,M,100,0,80,80
Burley,M,100,0,80,80
Cadie,F,100,80,0,80
Calob,M,100,0,80,80
Camara,F,92,74,6,80
Carlynn,F,100,80,0,80
Carston,M,100,0,80,80
Chanler,M,72,22,58,80
Chisom,F,79,63,17,80
Coletta,F,100,80,0,80
Conall,M,100,0,80,80
Cordae,M,100,0,80,80
Dalena,F,100,80,0,80
Delyla,F,100,80,0,80
Demarko,M,100,0,80,80
Deva,F,100,80,0,80
Deveon,M,100,0,80,80
Diem,F,90,72,8,80
Elease,F,100,80,0,80
Ezzard,M,100,0,80,80
Gabryel,M,74,21,59,80
Hally,F,100,80,0,80
Harlyn,F,78,62,18,80
Henrry,M,100,0,80,80
Ijeoma,F,100,80,0,80
Iven,M,100,0,80,80
Jaiya,F,100,80,0,80
Jaiyana,F,100,80,0,80
Jameela,F,100,80,0,80
Jamez,M,100,0,80,80
Jamisha,F,100,80,0,80
Janika,F,100,80,0,80
Jaryd,M,100,0,80,80
Jayshaun,M,100,0,80,80
Jebediah,M,100,0,80,80
Jennessa,F,100,80,0,80
Jerrald,M,100,0,80,80
Kaisha,F,100,80,0,80
Kaja,F,100,80,0,80
Kamarie,F,71,57,23,80
Katerine,F,100,80,0,80
Kayde,M,71,23,57,80
Kaylia,F,100,80,0,80
Keera,F,100,80,0,80
Kelechi,M,62,30,50,80
Kenza,F,100,80,0,80
Kevonte,M,100,0,80,80
Kyrell,M,100,0,80,80
Lacinda,F,100,80,0,80
Lazar,M,100,0,80,80
Lissett,F,100,80,0,80
Mackynzie,F,100,80,0,80
Margaretta,F,100,80,0,80
Marykay,F,100,80,0,80
Mattilyn,F,100,80,0,80
Mayzie,F,100,80,0,80
Meya,F,100,80,0,80
Naida,F,100,80,0,80
Nasim,M,71,23,57,80
Nishka,F,100,80,0,80
Nithya,F,100,80,0,80
Nizhoni,F,100,80,0,80
Nohely,F,100,80,0,80
Orlanda,M,78,18,62,80
Pratik,M,100,0,80,80
Rabia,F,100,80,0,80
Rahiem,M,100,0,80,80
Rasean,M,100,0,80,80
Remmy,M,52,38,42,80
Reymond,M,100,0,80,80
Rhythm,M,66,27,53,80
Ritika,F,100,80,0,80
Shalin,M,64,29,51,80
Shantavia,F,100,80,0,80
Sharay,F,100,80,0,80
Shatavia,F,100,80,0,80
Shelbey,F,100,80,0,80
Shontell,F,100,80,0,80
Silvester,M,100,0,80,80
Spiro,M,100,0,80,80
Svetlana,F,100,80,0,80
Talayah,F,100,80,0,80
Timm,M,100,0,80,80
Trayce,M,68,26,54,80
Trentyn,M,100,0,80,80
Tyann,F,100,80,0,80
Verlene,F,100,80,0,80
Warrick,M,100,0,80,80
Xaria,F,100,80,0,80
Yurem,M,100,0,80,80
Zianna,F,100,80,0,80
Ahmya,F,100,79,0,79
Alania,F,100,79,0,79
Aleesa,F,100,79,0,79
Alexsa,F,100,79,0,79
Alexy,F,62,49,30,79
Alin,F,76,60,19,79
Alliana,F,100,79,0,79
Ama,F,100,79,0,79
Ameir,M,100,0,79,79
Angad,M,100,0,79,79
Annisa,F,100,79,0,79
Anniyah,F,100,79,0,79
Antavious,M,100,0,79,79
Ardella,F,100,79,0,79
Arisbeth,F,100,79,0,79
Aubrei,F,100,79,0,79
Aviv,M,81,15,64,79
Benuel,M,100,0,79,79
Breena,F,100,79,0,79
Brianca,F,100,79,0,79
Cassadee,F,100,79,0,79
Catherina,F,100,79,0,79
Chanice,F,100,79,0,79
Charyl,F,100,79,0,79
Cintia,F,100,79,0,79
Coda,M,87,10,69,79
Daivon,M,100,0,79,79
Daizy,F,100,79,0,79
Dajanae,F,100,79,0,79
Damarco,M,100,0,79,79
Darriel,M,81,15,64,79
Denelle,F,100,79,0,79
Dortha,F,100,79,0,79
Drea,F,100,79,0,79
Earlie,M,70,24,55,79
Elektra,F,100,79,0,79
Elianah,F,100,79,0,79
Elka,F,100,79,0,79
Elynn,F,100,79,0,79
Emelin,F,100,79,0,79
Evony,F,100,79,0,79
Eythan,M,100,0,79,79
Felicitas,F,100,79,0,79
Frederico,M,100,0,79,79
Gaberiel,M,100,0,79,79
Giovana,F,100,79,0,79
Grettel,F,100,79,0,79
Hari,M,100,0,79,79
Heavenlee,F,100,79,0,79
Hercules,M,100,0,79,79
Infinity,F,100,79,0,79
Iriana,F,100,79,0,79
Ishita,F,100,79,0,79
Ivanka,F,100,79,0,79
Jalea,F,100,79,0,79
Jamien,M,100,0,79,79
Javonne,M,54,36,43,79
Juandiego,M,100,0,79,79
Jubal,M,100,0,79,79
Kallee,F,100,79,0,79
Kamber,F,100,79,0,79
Keefe,M,100,0,79,79
Kenard,M,100,0,79,79
Kennia,F,100,79,0,79
Kerrick,M,100,0,79,79
Lakiya,F,100,79,0,79
Lamaya,F,100,79,0,79
Lashan,F,90,71,8,79
Latonja,F,100,79,0,79
Leanora,F,100,79,0,79
Lenda,F,100,79,0,79
Lennis,M,82,14,65,79
Leone,F,66,52,27,79
Lukasz,M,100,0,79,79
Makana,M,66,27,52,79
Maleyah,F,100,79,0,79
Mannix,M,100,0,79,79
Marlea,F,100,79,0,79
Marlisa,F,100,79,0,79
Megann,F,100,79,0,79
Michelene,F,100,79,0,79
Neyda,F,100,79,0,79
Paytyn,F,100,79,0,79
Porche,F,100,79,0,79
Powell,M,100,0,79,79
Rajiv,M,100,0,79,79
Reesa,F,100,79,0,79
Renardo,M,92,6,73,79
Rodman,M,100,0,79,79
Sayla,F,100,79,0,79
Scotland,F,62,49,30,79
Sejal,F,100,79,0,79
Sian,F,78,62,17,79
Starlette,F,100,79,0,79
Suraya,F,100,79,0,79
Syble,F,100,79,0,79
Tabor,M,81,15,64,79
Tameeka,F,100,79,0,79
Tedra,F,100,79,0,79
Tehila,F,100,79,0,79
Tej,M,100,0,79,79
Tempestt,F,100,79,0,79
Trinton,M,100,0,79,79
Umberto,M,100,0,79,79
Verlon,M,91,7,72,79
Whisper,F,100,79,0,79
Winnifred,F,100,79,0,79
Wynette,F,100,79,0,79
Yasiel,M,100,0,79,79
Yatzari,F,100,79,0,79
Yer,F,84,66,13,79
Yoanna,F,100,79,0,79
Zeppelin,M,86,11,68,79
Aarion,M,86,11,67,78
Adryanna,F,100,78,0,78
Aneesha,F,100,78,0,78
Annelle,F,100,78,0,78
Anora,F,100,78,0,78
Arlett,F,100,78,0,78
Aveline,F,100,78,0,78
Avrey,F,58,45,33,78
Bellarose,F,100,78,0,78
Braleigh,F,100,78,0,78
Brecklyn,F,100,78,0,78
Brendin,M,100,0,78,78
Briah,F,100,78,0,78
Brieann,F,100,78,0,78
Caliana,F,100,78,0,78
Calyn,F,83,65,13,78
Caydon,M,100,0,78,78
Chanie,F,100,78,0,78
Chanin,F,100,78,0,78
Christia,F,100,78,0,78
Chuckie,M,100,0,78,78
Dannah,F,100,78,0,78
Dannika,F,100,78,0,78
Dashel,M,100,0,78,78
Dawnette,F,100,78,0,78
Destyn,M,73,21,57,78
Disha,F,100,78,0,78
Eri,F,53,41,37,78
Fransico,M,100,0,78,78
Genice,F,100,78,0,78
Haedyn,F,69,54,24,78
Harun,M,100,0,78,78
Hawkins,M,100,0,78,78
Herbie,M,100,0,78,78
Igor,M,100,0,78,78
Jafar,M,100,0,78,78
Jamecia,F,100,78,0,78
Jamese,F,100,78,0,78
Jamica,F,100,78,0,78
Jamile,F,62,48,30,78
Jannett,F,100,78,0,78
Jarian,M,100,0,78,78
Jaylanie,F,100,78,0,78
Jefrey,M,100,0,78,78
Jensyn,F,74,58,20,78
Jesslynn,F,100,78,0,78
Joeann,F,100,78,0,78
Kaedence,F,100,78,0,78
Kailer,M,94,5,73,78
Kalman,M,100,0,78,78
Karlin,F,53,41,37,78
Karston,M,100,0,78,78
Keldon,M,100,0,78,78
Kelliann,F,100,78,0,78
Khayden,M,92,6,72,78
Kindall,F,94,73,5,78
Kyasia,F,100,78,0,78
Lamees,F,100,78,0,78
Laquitta,F,100,78,0,78
Leandrea,F,100,78,0,78
Mallary,F,100,78,0,78
Maniya,F,100,78,0,78
Manon,F,100,78,0,78
Mardell,F,87,68,10,78
Marianela,F,100,78,0,78
Miliana,F,100,78,0,78
Modesta,F,100,78,0,78
Nakai,M,85,12,66,78
Nara,F,100,78,0,78
Ovidio,M,100,0,78,78
Pasha,F,65,51,27,78
Piero,M,100,0,78,78
Raelynne,F,100,78,0,78
Raynette,F,100,78,0,78
Reeves,M,92,6,72,78
Rendell,M,100,0,78,78
Romulo,M,100,0,78,78
Rylyn,F,81,63,15,78
Seeley,M,79,16,62,78
Serra,F,100,78,0,78
Shalamar,F,68,53,25,78
Shanette,F,100,78,0,78
Sharelle,F,100,78,0,78
Sharrie,F,100,78,0,78
Shawndra,F,100,78,0,78
Shaylen,F,100,78,0,78
Shaylie,F,100,78,0,78
Shem,M,94,5,73,78
Shirin,F,100,78,0,78
Steel,M,100,0,78,78
Talor,F,79,62,16,78
Taten,M,100,0,78,78
Taylore,F,100,78,0,78
Tiah,F,100,78,0,78
Tish,F,100,78,0,78
Tiyanna,F,100,78,0,78
Tramell,M,100,0,78,78
Trixie,F,100,78,0,78
Tuff,M,100,0,78,78
Tykeria,F,100,78,0,78
Tyneisha,F,100,78,0,78
Tynlee,F,100,78,0,78
Vaida,F,100,78,0,78
Veta,F,100,78,0,78
Vonna,F,100,78,0,78
Weylin,M,100,0,78,78
Xavia,F,92,72,6,78
Yashika,F,100,78,0,78
Zissy,F,100,78,0,78
Zuzanna,F,100,78,0,78
Aayla,F,100,77,0,77
Abdoulaye,M,100,0,77,77
Adien,M,100,0,77,77
Alder,M,100,0,77,77
Aldin,M,100,0,77,77
Aliyanna,F,100,77,0,77
Amariyah,F,100,77,0,77
Anabela,F,100,77,0,77
Anisah,F,100,77,0,77
Carita,F,100,77,0,77
Carlis,M,87,10,67,77
Cezar,M,100,0,77,77
Charnell,F,100,77,0,77
Chukwuemeka,M,100,0,77,77
Cletis,M,100,0,77,77
Cobi,M,79,16,61,77
Daevion,M,100,0,77,77
Daine,M,52,37,40,77
Delante,M,100,0,77,77
Demani,M,87,10,67,77
Derrel,M,100,0,77,77
Dilynn,F,82,63,14,77
Draya,F,100,77,0,77
Esmee,F,100,77,0,77
Francia,F,100,77,0,77
Gioia,F,100,77,0,77
Gurnoor,F,62,48,29,77
Isaiha,M,100,0,77,77
Jacqui,F,100,77,0,77
Jaia,F,100,77,0,77
Jakobie,M,100,0,77,77
Jamahl,M,100,0,77,77
Jamela,F,100,77,0,77
Jennafer,F,100,77,0,77
Jeric,M,100,0,77,77
Jermani,F,82,63,14,77
Jessilyn,F,100,77,0,77
Josee,F,100,77,0,77
Kalah,F,100,77,0,77
Kana,F,100,77,0,77
Karee,F,94,72,5,77
Karman,F,92,71,6,77
Keary,M,88,9,68,77
Khaleel,M,100,0,77,77
Kree,F,66,51,26,77
Kristena,F,100,77,0,77
Kyndle,F,92,71,6,77
Lataya,F,100,77,0,77
Layth,M,100,0,77,77
Leea,F,100,77,0,77
Lennard,M,100,0,77,77
Loris,F,94,72,5,77
Magdaleno,M,100,0,77,77
Maika,F,70,54,23,77
Manar,F,100,77,0,77
Maniyah,F,100,77,0,77
Matti,F,94,72,5,77
Mayleigh,F,100,77,0,77
Milca,F,100,77,0,77
Mittie,F,100,77,0,77
Naaman,M,100,0,77,77
Nainoa,M,100,0,77,77
Natilee,F,100,77,0,77
Neiko,M,100,0,77,77
Noeli,F,100,77,0,77
Nolberto,M,100,0,77,77
Orian,M,82,14,63,77
Otilia,F,100,77,0,77
Pollyanna,F,100,77,0,77
Quantez,M,100,0,77,77
Quest,M,100,0,77,77
Quintez,M,100,0,77,77
Raeven,F,100,77,0,77
Raheim,M,100,0,77,77
Rande,M,61,30,47,77
Rema,F,100,77,0,77
Renisha,F,100,77,0,77
Rihana,F,100,77,0,77
Rolan,M,100,0,77,77
Ryli,F,100,77,0,77
Saquan,M,100,0,77,77
Sharion,F,100,77,0,77
Sherlene,F,100,77,0,77
Sissy,F,100,77,0,77
Starlett,F,100,77,0,77
Starlyn,F,100,77,0,77
Sy,M,100,0,77,77
Tae,M,81,15,62,77
Tanish,M,94,5,72,77
Tariah,F,100,77,0,77
Towana,F,100,77,0,77
Trenna,F,100,77,0,77
Troi,F,74,57,20,77
Truly,F,100,77,0,77
Trung,M,100,0,77,77
Tyleah,F,100,77,0,77
Vanellope,F,100,77,0,77
Wali,M,100,0,77,77
Waseem,M,100,0,77,77
Wilhemina,F,100,77,0,77
Xayden,M,100,0,77,77
Yared,M,94,5,72,77
Yoni,M,100,0,77,77
Zurisadai,F,100,77,0,77
Zylen,M,100,0,77,77
Abdel,M,100,0,76,76
Ailee,F,100,76,0,76
Aissatou,F,100,76,0,76
Alexanderia,F,100,76,0,76
Apolinar,M,100,0,76,76
Arda,M,100,0,76,76
Ariyan,F,53,40,36,76
Atalia,F,100,76,0,76
Atziri,F,100,76,0,76
Ayrton,M,100,0,76,76
Bradi,F,100,76,0,76
Brailee,F,100,76,0,76
Brande,F,100,76,0,76
Breaunna,F,100,76,0,76
Caelen,M,84,12,64,76
Charmin,F,100,76,0,76
Chisa,F,100,76,0,76
Chucky,M,100,0,76,76
Cirilo,M,100,0,76,76
Daneisha,F,100,76,0,76
Darbi,F,100,76,0,76
Dariela,F,100,76,0,76
Darina,F,100,76,0,76
Deontre,M,100,0,76,76
Dewanna,F,100,76,0,76
Dietra,F,100,76,0,76
Emylee,F,100,76,0,76
Enola,F,100,76,0,76
Eunique,F,93,71,5,76
Fortino,M,100,0,76,76
Gissele,F,100,76,0,76
Hadeel,F,100,76,0,76
Hamad,M,100,0,76,76
Hieu,M,100,0,76,76
Idania,F,100,76,0,76
Ilsa,F,100,76,0,76
Irlanda,F,100,76,0,76
Iveth,F,100,76,0,76
Iyanah,F,100,76,0,76
Jadalyn,F,100,76,0,76
Jahi,M,100,0,76,76
Jaslin,F,100,76,0,76
Jasmen,F,100,76,0,76
Jaymeson,M,92,6,70,76
Jermane,M,100,0,76,76
Kamela,F,100,76,0,76
Kinnick,M,100,0,76,76
Kodee,F,51,39,37,76
Kramer,M,100,0,76,76
Laiba,F,100,76,0,76
Lanya,F,100,76,0,76
Leonides,M,100,0,76,76
Lysette,F,100,76,0,76
Lyvia,F,100,76,0,76
Maeleigh,F,100,76,0,76
Malanie,F,100,76,0,76
Marcene,F,100,76,0,76
Marquavious,M,100,0,76,76
Mattox,M,92,6,70,76
Maximillion,M,100,0,76,76
Melana,F,100,76,0,76
Mirta,F,100,76,0,76
Myiesha,F,100,76,0,76
Nandi,F,100,76,0,76
Narissa,F,100,76,0,76
Nataya,F,100,76,0,76
Nikoli,M,100,0,76,76
Nomar,M,100,0,76,76
Omid,M,100,0,76,76
Oumar,M,100,0,76,76
Robbyn,F,100,76,0,76
Roddrick,M,100,0,76,76
Ronita,F,100,76,0,76
Salwa,F,100,76,0,76
Shaheen,M,91,7,69,76
Sherre,F,100,76,0,76
Shunta,F,92,70,6,76
Sindi,F,100,76,0,76
Skylan,F,58,44,32,76
Sophya,F,100,76,0,76
Stephone,M,100,0,76,76
Su,F,100,76,0,76
Takesha,F,100,76,0,76
Tearra,F,100,76,0,76
Terriana,F,100,76,0,76
Timika,F,100,76,0,76
Tyreece,M,100,0,76,76
Tyriek,M,100,0,76,76
Tyus,M,100,0,76,76
Vanya,F,100,76,0,76
Vesper,F,100,76,0,76
Virgina,F,100,76,0,76
Xia,F,100,76,0,76
Xochil,F,100,76,0,76
Yeshaya,M,100,0,76,76
Yoseline,F,100,76,0,76
Zaara,F,100,76,0,76
Abdias,M,100,0,75,75
Abigaile,F,100,75,0,75
Adryana,F,100,75,0,75
Alexah,F,100,75,0,75
Alleigh,F,100,75,0,75
Alydia,F,100,75,0,75
Amarilis,F,100,75,0,75
Annica,F,100,75,0,75
Arianni,F,100,75,0,75
Aubryn,F,100,75,0,75
Ayari,F,100,75,0,75
Ayse,F,100,75,0,75
Baylin,M,59,31,44,75
Bettyann,F,100,75,0,75
Bodey,M,100,0,75,75
Caeli,F,100,75,0,75
Cathlene,F,100,75,0,75
Charlotta,F,100,75,0,75
Chelse,F,100,75,0,75
Clemmie,F,55,41,34,75
Cyncere,M,61,29,46,75
Dameion,M,100,0,75,75
Dandra,F,100,75,0,75
Darshan,M,100,0,75,75
Daymian,M,100,0,75,75
Deatrice,F,100,75,0,75
Delynn,F,93,70,5,75
Derryl,M,100,0,75,75
Dreyden,M,100,0,75,75
Duaa,F,100,75,0,75
Duy,M,100,0,75,75
Dylin,M,79,16,59,75
Elvina,F,100,75,0,75
Emorie,F,100,75,0,75
Feras,M,100,0,75,75
Gayland,M,100,0,75,75
Georges,M,100,0,75,75
Gertie,F,100,75,0,75
Gery,M,100,0,75,75
Gianmarco,M,100,0,75,75
Gio,M,100,0,75,75
Glendora,F,100,75,0,75
Gryphon,M,100,0,75,75
Heydi,F,100,75,0,75
Hobart,M,100,0,75,75
Issaiah,M,100,0,75,75
Jakeline,F,100,75,0,75
Jamaul,M,100,0,75,75
Jamerson,M,100,0,75,75
Janaiya,F,100,75,0,75
Jaspreet,F,57,43,32,75
Jenaro,M,100,0,75,75
Jesselyn,F,100,75,0,75
Jesusa,F,100,75,0,75
Joab,M,100,0,75,75
Joaquim,M,100,0,75,75
Johnney,M,100,0,75,75
Jordanna,F,100,75,0,75
Josemiguel,M,100,0,75,75
Kail,M,100,0,75,75
Kaitlen,F,100,75,0,75
Kania,F,100,75,0,75
Karmello,M,100,0,75,75
Keenon,M,100,0,75,75
Keionna,F,100,75,0,75
Keivon,M,100,0,75,75
Kierre,M,81,14,61,75
Klint,M,100,0,75,75
Knight,M,100,0,75,75
Kyaire,M,100,0,75,75
Kynley,F,100,75,0,75
Kynnedy,F,100,75,0,75
Lanelle,F,100,75,0,75
Lareina,F,100,75,0,75
Layal,F,100,75,0,75
Lelani,F,100,75,0,75
Lyndie,F,100,75,0,75
Madalyne,F,100,75,0,75
Mairin,F,100,75,0,75
Marchell,F,100,75,0,75
Marilin,F,100,75,0,75
Megen,F,100,75,0,75
Mychelle,F,100,75,0,75
Mynor,M,100,0,75,75
Mysti,F,100,75,0,75
Narda,F,100,75,0,75
Neoma,F,100,75,0,75
Ngoc,F,92,69,6,75
Nichele,F,100,75,0,75
Nicholus,M,100,0,75,75
Noora,F,100,75,0,75
November,F,100,75,0,75
Onna,F,100,75,0,75
Raissa,F,100,75,0,75
Regino,M,100,0,75,75
Richy,M,100,0,75,75
Ryken,M,100,0,75,75
Ryler,M,100,0,75,75
Sahib,M,100,0,75,75
Seymour,M,100,0,75,75
Shadrach,M,100,0,75,75
Shontel,F,100,75,0,75
Shreeya,F,100,75,0,75
Stori,F,100,75,0,75
Taffy,F,100,75,0,75
Tais,F,100,75,0,75
Taitum,F,76,57,18,75
Tanita,F,100,75,0,75
Tashana,F,100,75,0,75
Tyrah,F,100,75,0,75
Vallie,F,100,75,0,75
Yanelly,F,100,75,0,75
Zully,F,100,75,0,75
Ahmani,F,77,57,17,74
Alanie,F,100,74,0,74
Alyxandria,F,100,74,0,74
Amayrani,F,100,74,0,74
Amier,M,100,0,74,74
Andrue,M,100,0,74,74
Angello,M,100,0,74,74
Anila,F,100,74,0,74
Anjela,F,100,74,0,74
Aquilla,F,92,68,6,74
Ariyonna,F,100,74,0,74
Asaiah,M,100,0,74,74
Ashur,M,100,0,74,74
Belal,M,100,0,74,74
Charlisa,F,100,74,0,74
Charmane,F,100,74,0,74
Chrislyn,F,100,74,0,74
Christapher,M,100,0,74,74
Clio,F,100,74,0,74
Cobie,M,73,20,54,74
Cresencio,M,100,0,74,74
Damaria,F,82,61,13,74
Damiana,F,100,74,0,74
Darnelle,M,54,34,40,74
Demetrick,M,100,0,74,74
Derica,F,100,74,0,74
Donel,M,93,5,69,74
Donesha,F,100,74,0,74
Doni,F,82,61,13,74
Earnie,M,89,8,66,74
Eimy,F,100,74,0,74
Falynn,F,100,74,0,74
Floretta,F,100,74,0,74
Gehrig,M,100,0,74,74
Georgio,M,100,0,74,74
Graceyn,F,100,74,0,74
Gunther,M,100,0,74,74
Harlin,M,93,5,69,74
Hettie,F,100,74,0,74
Holdyn,M,93,5,69,74
Jaasiel,M,100,0,74,74
Jacqlyn,F,100,74,0,74
Jamarkus,M,100,0,74,74
Jannifer,F,100,74,0,74
Jerrika,F,100,74,0,74
Jonetta,F,100,74,0,74
Juliza,F,100,74,0,74
Kaeleb,M,100,0,74,74
Kao,M,57,32,42,74
Kaydyn,M,57,32,42,74
Keasha,F,100,74,0,74
Kennisha,F,100,74,0,74
Keoki,M,100,0,74,74
Kiri,F,100,74,0,74
Lavenia,F,100,74,0,74
Lavone,F,78,58,16,74
Lilie,F,100,74,0,74
Lugene,M,53,35,39,74
Maelle,F,100,74,0,74
Magdalyn,F,100,74,0,74
Mcclain,M,72,21,53,74
Meika,F,100,74,0,74
Mela,F,100,74,0,74
Mouhamed,M,100,0,74,74
Natania,F,100,74,0,74
Nikkie,F,100,74,0,74
Odilia,F,100,74,0,74
Olivea,F,100,74,0,74
Osborne,M,100,0,74,74
Ozias,M,100,0,74,74
Paislie,F,100,74,0,74
Phenix,M,57,32,42,74
Pheobe,F,100,74,0,74
Rafaella,F,100,74,0,74
Rahmel,M,100,0,74,74
Ranisha,F,100,74,0,74
Rhylie,F,100,74,0,74
Riann,F,100,74,0,74
Ritvik,M,100,0,74,74
Rj,M,100,0,74,74
Roney,M,100,0,74,74
Rosiland,F,100,74,0,74
Ruperto,M,100,0,74,74
Safiyah,F,100,74,0,74
Saint,M,100,0,74,74
Shaul,M,100,0,74,74
Tamarion,M,100,0,74,74
Tanea,F,100,74,0,74
Terena,F,100,74,0,74
Tiya,F,100,74,0,74
Tracen,M,100,0,74,74
Tzivia,F,100,74,0,74
Yalitza,F,100,74,0,74
Yovanni,M,100,0,74,74
Yulia,F,100,74,0,74
Zanaya,F,100,74,0,74
Zaydin,M,100,0,74,74
Ziona,F,100,74,0,74
Zoriah,F,100,74,0,74
Aalyah,F,100,73,0,73
Abdulahi,M,100,0,73,73
Aeron,M,93,5,68,73
Airiana,F,100,73,0,73
Alaisha,F,100,73,0,73
Aletta,F,100,73,0,73
Ankita,F,100,73,0,73
Antonius,M,100,0,73,73
Assata,F,100,73,0,73
Avyn,F,66,48,25,73
Benyamin,M,100,0,73,73
Breydon,M,100,0,73,73
Caia,F,100,73,0,73
Carlissa,F,100,73,0,73
Cerena,F,100,73,0,73
Cerise,F,100,73,0,73
Chaston,M,100,0,73,73
Cherese,F,100,73,0,73
Cheron,F,85,62,11,73
Dacota,M,59,30,43,73
Dantae,M,100,0,73,73
Daran,M,100,0,73,73
Darlean,F,100,73,0,73
Darra,F,100,73,0,73
Darwyn,M,100,0,73,73
Davianna,F,100,73,0,73
Davide,M,100,0,73,73
Davionna,F,100,73,0,73
Debanhi,F,100,73,0,73
Derius,M,100,0,73,73
Dorrie,F,100,73,0,73
Easten,M,100,0,73,73
Eldana,F,100,73,0,73
Elene,F,100,73,0,73
Eliab,M,100,0,73,73
Eran,M,86,10,63,73
Espen,M,93,5,68,73
Evaline,F,100,73,0,73
Evelio,M,100,0,73,73
Farley,M,100,0,73,73
Flannery,F,100,73,0,73
Germany,F,66,48,25,73
Gerren,M,88,9,64,73
Gita,F,100,73,0,73
Gloriana,F,100,73,0,73
Hadiyah,F,100,73,0,73
Hansen,M,100,0,73,73
Harbor,F,64,47,26,73
Hart,M,100,0,73,73
Hersh,M,100,0,73,73
Hillard,M,100,0,73,73
Hollee,F,100,73,0,73
Inayah,F,100,73,0,73
Indra,F,93,68,5,73
Jaelle,F,100,73,0,73
Jalina,F,100,73,0,73
Jamarie,M,85,11,62,73
Jamesia,F,100,73,0,73
Janique,F,100,73,0,73
Jannine,F,100,73,0,73
Kaedon,M,100,0,73,73
Kaidon,M,100,0,73,73
Kainan,M,100,0,73,73
Karilyn,F,100,73,0,73
Keeva,F,100,73,0,73
Kyzer,M,100,0,73,73
Lanyah,F,100,73,0,73
Leaha,F,100,73,0,73
Liliane,F,100,73,0,73
Linzie,F,89,65,8,73
Lizzeth,F,100,73,0,73
Londell,M,100,0,73,73
Madalena,F,100,73,0,73
Majid,M,100,0,73,73
Makalah,F,100,73,0,73
Makoa,M,100,0,73,73
Maksym,M,100,0,73,73
Mana,F,89,65,8,73
Mannat,F,100,73,0,73
Matty,F,81,59,14,73
Maurilio,M,100,0,73,73
Miraya,F,100,73,0,73
Moana,F,100,73,0,73
Morgana,F,100,73,0,73
Natia,F,100,73,0,73
Nishant,M,100,0,73,73
Noely,F,100,73,0,73
Orly,F,100,73,0,73
Peggi,F,100,73,0,73
Rainie,F,100,73,0,73
Reana,F,100,73,0,73
Riane,F,100,73,0,73
Roshunda,F,100,73,0,73
Rossie,F,55,40,33,73
Sadi,F,100,73,0,73
Shakeya,F,100,73,0,73
Shalimar,F,100,73,0,73
Shenise,F,100,73,0,73
Shlome,M,100,0,73,73
Subhan,M,100,0,73,73
Sunita,F,100,73,0,73
Taiya,F,100,73,0,73
Tarrell,M,93,5,68,73
Tayveon,M,100,0,73,73
Tennessee,F,52,38,35,73
Timur,M,100,0,73,73
Tinesha,F,100,73,0,73
Topanga,F,100,73,0,73
Vega,F,77,56,17,73
Woodie,M,92,6,67,73
Yatziry,F,100,73,0,73
Zedekiah,M,100,0,73,73
Ziaire,M,92,6,67,73
Zyra,F,100,73,0,73
Abrahim,M,100,0,72,72
Adamary,F,100,72,0,72
Adonijah,M,100,0,72,72
Adrea,F,100,72,0,72
Ailynn,F,100,72,0,72
Ajla,F,100,72,0,72
Alaijah,F,100,72,0,72
Aleck,M,100,0,72,72
Alexas,F,100,72,0,72
Amonte,M,100,0,72,72
Anndrea,F,100,72,0,72
Ashna,F,100,72,0,72
Athen,M,100,0,72,72
Aulani,F,100,72,0,72
Avyanna,F,100,72,0,72
Ayelet,F,100,72,0,72
Balinda,F,100,72,0,72
Barclay,M,93,5,67,72
Benedetto,M,100,0,72,72
Blakelyn,F,100,72,0,72
Brinleigh,F,100,72,0,72
Brinton,M,100,0,72,72
Brittain,M,57,31,41,72
Camber,F,88,63,9,72
Casyn,M,83,12,60,72
Collene,F,100,72,0,72
Cordale,M,100,0,72,72
Corley,F,56,40,32,72
Cyra,F,100,72,0,72
Cyrena,F,100,72,0,72
Dalana,F,100,72,0,72
Damontae,M,100,0,72,72
Dariah,F,100,72,0,72
Dawon,M,100,0,72,72
Dayani,F,100,72,0,72
Demia,F,100,72,0,72
Demonta,M,100,0,72,72
Devra,F,100,72,0,72
Dewanda,F,100,72,0,72
Eleyna,F,100,72,0,72
Ellisyn,F,100,72,0,72
Ellora,F,100,72,0,72
Emmelyn,F,100,72,0,72
Fabien,M,100,0,72,72
Florentina,F,100,72,0,72
Getsemani,F,100,72,0,72
Gurleen,F,100,72,0,72
Gwendolen,F,100,72,0,72
Hannibal,M,100,0,72,72
Helana,F,100,72,0,72
Hero,M,53,34,38,72
Herson,M,100,0,72,72
Hillery,F,81,58,14,72
Iann,M,100,0,72,72
Idalis,F,100,72,0,72
Isidore,M,100,0,72,72
Israa,F,100,72,0,72
Itati,F,100,72,0,72
Jackey,M,93,5,67,72
Jahniya,F,100,72,0,72
Jaivon,M,100,0,72,72
Jakelin,F,100,72,0,72
Janielle,F,100,72,0,72
Jaxston,M,100,0,72,72
Jinny,F,100,72,0,72
Jodell,F,100,72,0,72
Jordanne,F,100,72,0,72
Josmar,M,100,0,72,72
Kaile,F,100,72,0,72
Kamerin,M,68,23,49,72
Kaycen,M,93,5,67,72
Kodey,M,100,0,72,72
Koree,F,56,40,32,72
Kriste,F,100,72,0,72
Kristyna,F,100,72,0,72
Kyera,F,100,72,0,72
Kynli,F,100,72,0,72
Lanier,M,93,5,67,72
Lavita,F,100,72,0,72
Lelah,F,100,72,0,72
Leondre,M,100,0,72,72
Liliann,F,100,72,0,72
Logyn,F,53,38,34,72
Lonie,F,50,36,36,72
Maddalena,F,100,72,0,72
Marshon,M,86,10,62,72
Meher,F,100,72,0,72
Merci,F,100,72,0,72
Merna,F,100,72,0,72
Miasia,F,100,72,0,72
Moesha,F,100,72,0,72
Mora,F,100,72,0,72
Mostafa,M,100,0,72,72
Nat,M,100,0,72,72
Nikolay,M,100,0,72,72
Oaklie,F,100,72,0,72
Pamula,F,100,72,0,72
Piotr,M,100,0,72,72
Ramin,M,100,0,72,72
Raygen,F,88,63,9,72
Riddick,M,100,0,72,72
Rushil,M,100,0,72,72
Ruston,M,100,0,72,72
Sallyann,F,100,72,0,72
Sarenity,F,100,72,0,72
Sayge,F,71,51,21,72
Sayler,F,100,72,0,72
Severiano,M,100,0,72,72
Shameika,F,100,72,0,72
Sheria,F,100,72,0,72
Shilpa,F,100,72,0,72
Srikar,M,100,0,72,72
Stepanie,F,100,72,0,72
Tamaria,F,100,72,0,72
Tawnia,F,100,72,0,72
Tayana,F,100,72,0,72
Teasha,F,100,72,0,72
Terren,M,92,6,66,72
Tiani,F,100,72,0,72
Torren,M,100,0,72,72
Tosh,M,100,0,72,72
Trenda,F,100,72,0,72
Trequan,M,100,0,72,72
Treyden,M,100,0,72,72
Tyris,M,100,0,72,72
Verlinda,F,100,72,0,72
Yaslin,F,100,72,0,72
Aadyn,M,100,0,71,71
Aalia,F,100,71,0,71
Adlee,F,100,71,0,71
Alainah,F,100,71,0,71
Alandria,F,100,71,0,71
Alcides,M,100,0,71,71
Alexey,M,87,9,62,71
Alexyss,F,100,71,0,71
Allura,F,100,71,0,71
Alys,F,100,71,0,71
Angelin,F,100,71,0,71
Annarose,F,100,71,0,71
Arland,M,93,5,66,71
Arleigh,F,89,63,8,71
Arletta,F,100,71,0,71
Arnel,M,100,0,71,71
Arno,M,100,0,71,71
Autry,M,93,5,66,71
Aymee,F,100,71,0,71
Bradd,M,100,0,71,71
Brittiny,F,100,71,0,71
Camarion,M,100,0,71,71
Camiya,F,100,71,0,71
Cammi,F,100,71,0,71
Carianne,F,100,71,0,71
Cuyler,M,100,0,71,71
Danton,M,100,0,71,71
Dashia,F,100,71,0,71
Daveion,M,100,0,71,71
Dawan,M,100,0,71,71
Daya,F,100,71,0,71
Deetta,F,100,71,0,71
Dj,M,100,0,71,71
Domanick,M,100,0,71,71
Dondra,F,92,65,6,71
Dua,F,100,71,0,71
Duron,M,100,0,71,71
Ellise,F,100,71,0,71
Ellissa,F,100,71,0,71
Emmanuela,F,100,71,0,71
Erielle,F,100,71,0,71
Esmerelda,F,100,71,0,71
Everton,M,100,0,71,71
Feliz,M,58,30,41,71
Ferrell,M,100,0,71,71
Graison,M,82,13,58,71
Haydyn,F,63,45,26,71
Ikea,F,100,71,0,71
Isom,M,100,0,71,71
Jacqulin,F,100,71,0,71
Jamarri,M,100,0,71,71
Jamen,M,100,0,71,71
Jamielynn,F,100,71,0,71
Jazmynn,F,100,71,0,71
Jerzie,F,100,71,0,71
Katee,F,100,71,0,71
Kee,M,86,10,61,71
Keniya,F,100,71,0,71
Khoa,M,100,0,71,71
Khoi,M,92,6,65,71
Konstantin,M,100,0,71,71
Laban,M,100,0,71,71
Lanay,F,100,71,0,71
Latrece,F,100,71,0,71
Linna,F,100,71,0,71
Logann,F,92,65,6,71
Lynzee,F,100,71,0,71
Madai,F,100,71,0,71
Mailee,F,100,71,0,71
Majd,M,93,5,66,71
Malasia,F,100,71,0,71
Margarite,F,100,71,0,71
Martavius,M,100,0,71,71
Meleny,F,100,71,0,71
Merced,M,73,19,52,71
Mercede,F,100,71,0,71
Moise,M,100,0,71,71
Myeshia,F,100,71,0,71
Nabiha,F,100,71,0,71
Nataley,F,100,71,0,71
Natanya,F,100,71,0,71
Nguyen,M,86,10,61,71
Nicanor,M,100,0,71,71
Nuri,M,56,31,40,71
Oshea,M,92,6,65,71
Oumou,F,100,71,0,71
Perez,M,100,0,71,71
Phillipe,M,100,0,71,71
Rainee,F,100,71,0,71
Rainier,M,100,0,71,71
Rajesh,M,100,0,71,71
Ranveer,M,100,0,71,71
Rechelle,F,100,71,0,71
Riddhi,F,100,71,0,71
Riggin,M,100,0,71,71
Sarayu,F,100,71,0,71
Shahid,M,100,0,71,71
Shanteria,F,100,71,0,71
Shanyia,F,100,71,0,71
Sharde,F,100,71,0,71
Shatia,F,100,71,0,71
Sherod,M,100,0,71,71
Skylie,F,100,71,0,71
Slate,M,100,0,71,71
Soliana,F,100,71,0,71
Suleiman,M,100,0,71,71
Tan,M,92,6,65,71
Tarryn,F,93,66,5,71
Tela,F,100,71,0,71
Tondra,F,100,71,0,71
Vidhi,F,100,71,0,71
Witten,M,100,0,71,71
Yamilette,F,100,71,0,71
Zakk,M,100,0,71,71
Zanya,F,100,71,0,71
Zehra,F,100,71,0,71
Zury,F,100,71,0,71
Adalena,F,100,70,0,70
Aleiah,F,100,70,0,70
Alliah,F,100,70,0,70
Amaziah,M,76,17,53,70
Anaid,F,100,70,0,70
Analucia,F,100,70,0,70
Analyn,F,100,70,0,70
Anicia,F,100,70,0,70
Anina,F,100,70,0,70
Antwann,M,100,0,70,70
Arantxa,F,100,70,0,70
Arushi,F,100,70,0,70
Avonte,M,100,0,70,70
Azaleah,F,100,70,0,70
Bellah,F,100,70,0,70
Berniece,F,100,70,0,70
Bray,M,100,0,70,70
Carlisha,F,100,70,0,70
Cherrelle,F,100,70,0,70
Colman,M,100,0,70,70
Constantinos,M,100,0,70,70
Corri,F,91,64,6,70
Cylis,M,100,0,70,70
Daejah,F,100,70,0,70
Dallon,M,100,0,70,70
Dalynn,F,84,59,11,70
Desaree,F,100,70,0,70
Dorion,M,100,0,70,70
Dreshawn,M,100,0,70,70
Enedelia,F,100,70,0,70
Evianna,F,100,70,0,70
Firas,M,100,0,70,70
Gemini,F,60,42,28,70
Hailyn,F,100,70,0,70
Hale,M,100,0,70,70
Heron,M,100,0,70,70
Hoang,M,100,0,70,70
Ikenna,M,100,0,70,70
Irfan,M,100,0,70,70
Iver,M,100,0,70,70
Jackalyn,F,100,70,0,70
Jahsir,M,100,0,70,70
Jailee,F,100,70,0,70
Jailine,F,100,70,0,70
Jamyla,F,100,70,0,70
Jayshon,M,100,0,70,70
Jesusita,F,100,70,0,70
Jeziah,M,93,5,65,70
Kagen,M,100,0,70,70
Kaidance,F,100,70,0,70
Kamori,F,67,47,23,70
Kanaan,M,100,0,70,70
Karinna,F,100,70,0,70
Kashmere,F,69,48,22,70
Kayleah,F,100,70,0,70
Keene,M,100,0,70,70
Kendle,F,54,38,32,70
Kendrix,M,100,0,70,70
Keneisha,F,100,70,0,70
Kenslie,F,100,70,0,70
Kobey,M,100,0,70,70
Krysti,F,100,70,0,70
Kyesha,F,100,70,0,70
Larena,F,100,70,0,70
Leala,F,100,70,0,70
Leeza,F,100,70,0,70
Liara,F,100,70,0,70
Lizandra,F,100,70,0,70
Lya,F,100,70,0,70
Mailey,F,100,70,0,70
Mariaisabel,F,100,70,0,70
Maribell,F,100,70,0,70
Maurita,F,100,70,0,70
Maxximus,M,100,0,70,70
Mckensie,F,100,70,0,70
Mical,M,63,26,44,70
Mikalah,F,100,70,0,70
Miroslava,F,100,70,0,70
Miyana,F,100,70,0,70
Munir,M,100,0,70,70
Nadiah,F,100,70,0,70
Nakiah,F,100,70,0,70
Nakoa,M,93,5,65,70
Natallie,F,100,70,0,70
Nataniel,M,100,0,70,70
Niylah,F,100,70,0,70
Noell,F,84,59,11,70
Nuha,F,100,70,0,70
Rishika,F,100,70,0,70
Rodd,M,100,0,70,70
Rodell,M,100,0,70,70
Rutha,F,100,70,0,70
Saliyah,F,100,70,0,70
Salvadore,M,100,0,70,70
Stryder,M,100,0,70,70
Tage,M,100,0,70,70
Tapanga,F,100,70,0,70
Taralyn,F,100,70,0,70
Telvin,M,100,0,70,70
Terre,F,100,70,0,70
Tonna,F,100,70,0,70
Tri,M,100,0,70,70
Tyna,F,100,70,0,70
Waldemar,M,100,0,70,70
Xzander,M,100,0,70,70
Yarelis,F,100,70,0,70
Yuritzi,F,100,70,0,70
Aariana,F,100,69,0,69
Abena,F,100,69,0,69
Acelyn,F,93,64,5,69
Adira,F,100,69,0,69
Aerianna,F,100,69,0,69
Alayiah,F,100,69,0,69
Aleece,F,100,69,0,69
Alyia,F,100,69,0,69
Amiri,M,81,13,56,69
Anaia,F,100,69,0,69
Annaka,F,100,69,0,69
Artez,M,100,0,69,69
Aundria,F,100,69,0,69
Avika,F,100,69,0,69
Avneet,F,100,69,0,69
Bayne,M,100,0,69,69
Breannah,F,100,69,0,69
Bren,M,75,17,52,69
Brittyn,F,100,69,0,69
Carlson,M,100,0,69,69
Carrick,M,100,0,69,69
Cecilie,F,100,69,0,69
Chriss,M,75,17,52,69
Ciani,F,100,69,0,69
Cicily,F,100,69,0,69
Cing,F,100,69,0,69
Collis,M,100,0,69,69
Constantina,F,100,69,0,69
Daelin,M,75,17,52,69
Daila,F,100,69,0,69
Dajour,M,100,0,69,69
Danille,F,100,69,0,69
Darilyn,F,100,69,0,69
Deaven,M,75,17,52,69
Delayne,F,93,64,5,69
Delene,F,100,69,0,69
Devontay,M,100,0,69,69
Dodi,F,100,69,0,69
Elihu,M,100,0,69,69
Eliu,M,100,0,69,69
Ellaina,F,100,69,0,69
Ellyanna,F,100,69,0,69
Fae,F,100,69,0,69
Fate,M,64,25,44,69
Frederik,M,100,0,69,69
Genine,F,100,69,0,69
Gryffin,M,100,0,69,69
Haddon,M,100,0,69,69
Haidee,F,100,69,0,69
Heily,F,100,69,0,69
Hernando,M,100,0,69,69
Ima,F,100,69,0,69
Ivett,F,100,69,0,69
Jacorian,M,100,0,69,69
Jaeger,M,100,0,69,69
Jaleen,F,52,36,33,69
Jaquavious,M,100,0,69,69
Jari,F,57,39,30,69
Jeanell,F,100,69,0,69
Jeanett,F,100,69,0,69
Jemel,M,100,0,69,69
Jiraiya,M,100,0,69,69
Joelyn,F,100,69,0,69
Josephus,M,100,0,69,69
Kaiah,F,100,69,0,69
Kaisa,F,100,69,0,69
Kathlynn,F,100,69,0,69
Kaylena,F,100,69,0,69
Keevin,M,100,0,69,69
Keilly,F,100,69,0,69
Kelani,F,88,61,8,69
Kesia,F,100,69,0,69
Kimerly,F,100,69,0,69
Klinton,M,100,0,69,69
Kota,M,83,12,57,69
Kymari,M,68,22,47,69
Laneisha,F,100,69,0,69
Lelan,M,100,0,69,69
Levell,M,100,0,69,69
Liev,M,100,0,69,69
Ligia,F,100,69,0,69
Maayan,F,100,69,0,69
Madylin,F,100,69,0,69
Mahlia,F,100,69,0,69
Maily,F,100,69,0,69
Marija,F,100,69,0,69
Marily,F,100,69,0,69
Mayme,F,100,69,0,69
Mckaylee,F,100,69,0,69
Merrell,M,93,5,64,69
Merton,M,100,0,69,69
Meyah,F,100,69,0,69
Modesty,F,100,69,0,69
Munira,F,100,69,0,69
Nabila,F,100,69,0,69
Nachman,M,100,0,69,69
Nalia,F,100,69,0,69
Naman,M,100,0,69,69
Natalynn,F,100,69,0,69
Nayah,F,100,69,0,69
Newman,M,100,0,69,69
Nuria,F,100,69,0,69
Orla,F,100,69,0,69
Pang,F,93,64,5,69
Perseus,M,93,5,64,69
Phelan,M,93,5,64,69
Quanda,F,100,69,0,69
Raffi,M,100,0,69,69
Reagen,F,86,59,10,69
Rebeckah,F,100,69,0,69
Roselle,F,100,69,0,69
Ruvim,M,100,0,69,69
Shamaria,F,100,69,0,69
Shant,M,100,0,69,69
Sharnell,F,100,69,0,69
Sheily,F,100,69,0,69
Sherrel,F,100,69,0,69
Stevon,M,100,0,69,69
Sundra,F,100,69,0,69
Svea,F,100,69,0,69
Sydnei,F,100,69,0,69
Tava,F,100,69,0,69
Terilyn,F,100,69,0,69
Teyanna,F,100,69,0,69
Tiny,F,90,62,7,69
Tremell,M,100,0,69,69
Twilla,F,100,69,0,69
Vaibhav,M,100,0,69,69
Vibha,F,100,69,0,69
Yaniel,M,100,0,69,69
Yliana,F,100,69,0,69
Zaila,F,100,69,0,69
Zamaya,F,100,69,0,69
Zeno,M,100,0,69,69
Zvi,M,100,0,69,69
Aashna,F,100,68,0,68
Abi,F,100,68,0,68
Abra,F,100,68,0,68
Adalene,F,100,68,0,68
Adarsh,M,100,0,68,68
Ailany,F,100,68,0,68
Ala,F,91,62,6,68
Alban,M,100,0,68,68
Amaiah,F,100,68,0,68
Ambre,F,100,68,0,68
Amori,F,54,37,31,68
Angelly,F,100,68,0,68
Annali,F,100,68,0,68
Antwanette,F,100,68,0,68
Avigayil,F,100,68,0,68
Ayumi,F,100,68,0,68
Azlan,M,100,0,68,68
Bless,M,53,32,36,68
Bodee,M,93,5,63,68
Bradleigh,F,100,68,0,68
Breelynn,F,100,68,0,68
Brennah,F,100,68,0,68
Briton,M,93,5,63,68
Caelynn,F,100,68,0,68
Camela,F,100,68,0,68
Chani,F,100,68,0,68
Chardonnay,F,100,68,0,68
Charnelle,F,100,68,0,68
Chiamaka,F,100,68,0,68
Cinderella,F,100,68,0,68
Dalan,M,100,0,68,68
Dalyla,F,100,68,0,68
Danie,M,93,5,63,68
Danise,F,100,68,0,68
Daun,F,100,68,0,68
Davone,M,100,0,68,68
Demiyah,F,100,68,0,68
Denard,M,100,0,68,68
Deni,F,84,57,11,68
Dillen,M,93,5,63,68
Dravin,M,100,0,68,68
Dulcie,F,100,68,0,68
Durwood,M,100,0,68,68
Elizabella,F,100,68,0,68
Elois,F,100,68,0,68
Emad,M,100,0,68,68
Emilyann,F,100,68,0,68
Emmalea,F,100,68,0,68
Esaias,M,100,0,68,68
Filippo,M,100,0,68,68
Geroge,M,100,0,68,68
Iana,F,100,68,0,68
Irais,F,100,68,0,68
Jaheem,M,100,0,68,68
Jahmel,M,100,0,68,68
Jamilyn,F,100,68,0,68
Jayd,F,65,44,24,68
Jayvyn,M,100,0,68,68
Jazaria,F,100,68,0,68
Jerin,M,84,11,57,68
Jeromie,M,100,0,68,68
Johnhenry,M,100,0,68,68
Josslynn,F,100,68,0,68
Josua,M,100,0,68,68
Juna,F,100,68,0,68
Kamdon,M,100,0,68,68
Kamoni,F,62,42,26,68
Kassia,F,100,68,0,68
Keanan,M,100,0,68,68
Keeghan,M,72,19,49,68
Kelleen,F,100,68,0,68
Kemya,F,100,68,0,68
Kendrah,F,100,68,0,68
Kerstyn,F,100,68,0,68
Kiaira,F,100,68,0,68
Kirill,M,100,0,68,68
Korban,M,100,0,68,68
Kristalyn,F,100,68,0,68
Laren,F,66,45,23,68
Lekesha,F,100,68,0,68
Liani,F,100,68,0,68
Liviana,F,100,68,0,68
Lorenda,F,100,68,0,68
Lysandra,F,100,68,0,68
Ma,F,100,68,0,68
Malachy,M,100,0,68,68
Marshay,F,100,68,0,68
Marybel,F,100,68,0,68
Maverik,M,100,0,68,68
Mckennah,F,100,68,0,68
Meliyah,F,100,68,0,68
Mianna,F,100,68,0,68
Michaeline,F,100,68,0,68
Mihika,F,100,68,0,68
Myanna,F,100,68,0,68
Naina,F,100,68,0,68
Nathanel,M,100,0,68,68
Niyla,F,100,68,0,68
Pearlene,F,100,68,0,68
Pranavi,F,100,68,0,68
Primitivo,M,100,0,68,68
Rakan,M,100,0,68,68
Rashanda,F,100,68,0,68
Raymone,M,100,0,68,68
Renette,F,100,68,0,68
Reshawn,M,82,12,56,68
Riaan,M,100,0,68,68
Rigel,M,93,5,63,68
Rinda,F,100,68,0,68
Robel,M,100,0,68,68
Rumaldo,M,100,0,68,68
Salima,F,100,68,0,68
Sandria,F,100,68,0,68
Sathvik,M,100,0,68,68
Shailee,F,100,68,0,68
Shalana,F,100,68,0,68
Shaley,F,100,68,0,68
Shannell,F,100,68,0,68
Sharayah,F,100,68,0,68
Siddhant,M,100,0,68,68
Siham,F,100,68,0,68
Starling,M,65,24,44,68
Sujey,F,100,68,0,68
Syriah,F,100,68,0,68
Tabytha,F,100,68,0,68
Taniqua,F,100,68,0,68
Tarrence,M,100,0,68,68
Taura,F,100,68,0,68
Teria,F,100,68,0,68
Thadeus,M,100,0,68,68
Theadora,F,100,68,0,68
Thom,M,100,0,68,68
Tobiah,M,100,0,68,68
Torsten,M,100,0,68,68
Trishia,F,100,68,0,68
Vladislav,M,100,0,68,68
Yatzil,F,100,68,0,68
Zealand,M,85,10,58,68
Zeena,F,100,68,0,68
Zeeshan,M,100,0,68,68
Zuly,F,100,68,0,68
Adaly,F,100,67,0,67
Adrion,M,100,0,67,67
Aeva,F,100,67,0,67
Ahsan,M,100,0,67,67
Ainsleigh,F,100,67,0,67
Akili,M,54,31,36,67
Akirah,F,100,67,0,67
Alejo,M,100,0,67,67
Alexandru,M,100,0,67,67
Alexx,M,63,25,42,67
Allizon,F,100,67,0,67
Amberley,F,100,67,0,67
Anecia,F,100,67,0,67
Arush,M,100,0,67,67
Ave,F,100,67,0,67
Azura,F,100,67,0,67
Balin,M,100,0,67,67
Berton,M,100,0,67,67
Boy,M,100,0,67,67
Brenae,F,100,67,0,67
Brylin,M,63,25,42,67
Brynli,F,100,67,0,67
Caeley,F,100,67,0,67
Caio,M,100,0,67,67
Cauy,M,100,0,67,67
Caydin,M,93,5,62,67
Charlese,F,100,67,0,67
Charm,F,100,67,0,67
Chastin,M,76,16,51,67
Chirag,M,100,0,67,67
Cire,M,67,22,45,67
Cortnee,F,100,67,0,67
Daksh,M,100,0,67,67
Darcee,F,100,67,0,67
Deaglan,M,100,0,67,67
Deklin,M,100,0,67,67
Delmas,M,100,0,67,67
Devery,M,67,22,45,67
Diva,F,100,67,0,67
Elanna,F,100,67,0,67
Eligah,M,100,0,67,67
Elleigh,F,100,67,0,67
Elwyn,M,100,0,67,67
Emberlee,F,100,67,0,67
Endy,M,85,10,57,67
Enriqueta,F,100,67,0,67
Envy,F,100,67,0,67
Enza,F,100,67,0,67
Eudora,F,100,67,0,67
Fabrice,M,100,0,67,67
Florida,F,100,67,0,67
Glena,F,100,67,0,67
Graycee,F,100,67,0,67
Graycie,F,100,67,0,67
Haneef,M,100,0,67,67
Harsh,M,100,0,67,67
Hong,F,64,43,24,67
Huong,F,100,67,0,67
Hutson,M,100,0,67,67
Ilaria,F,100,67,0,67
Jabbar,M,100,0,67,67
Jakelyn,F,100,67,0,67
Janica,F,100,67,0,67
Jaselyn,F,100,67,0,67
Jaun,M,100,0,67,67
Jeniah,F,100,67,0,67
Jerret,M,100,0,67,67
Jillianne,F,100,67,0,67
Joani,F,100,67,0,67
Johanne,F,100,67,0,67
Johncarlos,M,100,0,67,67
Johney,M,100,0,67,67
Joshawa,M,100,0,67,67
Josseline,F,100,67,0,67
Jossue,M,100,0,67,67
Kaileen,F,100,67,0,67
Kateland,F,100,67,0,67
Katheleen,F,100,67,0,67
Kedra,F,100,67,0,67
Kenady,F,100,67,0,67
Kenta,M,100,0,67,67
Kenzee,F,100,67,0,67
Khyler,M,84,11,56,67
Koreen,F,100,67,0,67
Kyre,M,91,6,61,67
Lamario,M,100,0,67,67
Liliya,F,100,67,0,67
Lorren,F,64,43,24,67
Lourie,F,100,67,0,67
Mackie,M,75,17,50,67
Magdaline,F,100,67,0,67
Malaysha,F,100,67,0,67
Malori,F,100,67,0,67
Mansi,F,100,67,0,67
Marchello,M,100,0,67,67
Mariadejesus,F,100,67,0,67
Marki,F,91,61,6,67
Marshae,F,100,67,0,67
Martino,M,100,0,67,67
Marycruz,F,100,67,0,67
Maximos,M,100,0,67,67
Maybelle,F,100,67,0,67
Maylie,F,100,67,0,67
Mayumi,F,100,67,0,67
Megumi,F,100,67,0,67
Mi,F,100,67,0,67
Miana,F,100,67,0,67
Micael,M,100,0,67,67
Mikai,M,93,5,62,67
Ming,M,66,23,44,67
Mirza,M,84,11,56,67
Najae,F,70,47,20,67
Naseer,M,100,0,67,67
Neev,M,100,0,67,67
Nephi,M,100,0,67,67
Nickolus,M,100,0,67,67
Nyasha,F,100,67,0,67
Peder,M,100,0,67,67
Petros,M,100,0,67,67
Porshia,F,100,67,0,67
Rayshon,M,100,0,67,67
Rheagan,F,100,67,0,67
Robyne,F,100,67,0,67
Sabreena,F,100,67,0,67
Sahira,F,100,67,0,67
Sebrena,F,100,67,0,67
Shakima,F,100,67,0,67
Shamiah,F,100,67,0,67
Sheril,F,100,67,0,67
Sidnee,F,100,67,0,67
Tacy,F,100,67,0,67
Takyra,F,100,67,0,67
Tarynn,F,100,67,0,67
Tedrick,M,100,0,67,67
Telly,M,100,0,67,67
Thurmond,M,100,0,67,67
Titiana,F,100,67,0,67
Toriana,F,100,67,0,67
Trayson,M,100,0,67,67
Trecia,F,100,67,0,67
Tresha,F,100,67,0,67
Tymber,F,100,67,0,67
Valeska,F,100,67,0,67
Xylia,F,100,67,0,67
Yehudah,M,100,0,67,67
Yen,F,90,60,7,67
Ysabelle,F,100,67,0,67
Zaquan,M,100,0,67,67
Zuria,F,100,67,0,67
Zyanya,F,100,67,0,67
Zyir,M,100,0,67,67
Abdulmalik,M,100,0,66,66
Abeer,F,100,66,0,66
Adalyne,F,100,66,0,66
Addam,M,100,0,66,66
Aidric,M,100,0,66,66
Ailish,F,100,66,0,66
Akela,F,100,66,0,66
Albina,F,100,66,0,66
Aleecia,F,100,66,0,66
Alinah,F,100,66,0,66
Allyanna,F,100,66,0,66
Almeda,F,100,66,0,66
Alyn,F,64,42,24,66
Analie,F,100,66,0,66
Angila,F,100,66,0,66
Anilah,F,100,66,0,66
Annalea,F,100,66,0,66
Anvita,F,100,66,0,66
Ariston,M,100,0,66,66
Arlington,M,92,5,61,66
Aryia,F,100,66,0,66
Auna,F,100,66,0,66
Author,M,100,0,66,66
Brenlee,F,100,66,0,66
Bryceson,M,100,0,66,66
Brylynn,F,100,66,0,66
Calix,M,100,0,66,66
Caston,M,100,0,66,66
Dacoda,M,79,14,52,66
Daeja,F,100,66,0,66
Dakayla,F,100,66,0,66
Danyal,M,71,19,47,66
Darnella,F,100,66,0,66
Darnesha,F,100,66,0,66
Dashun,M,100,0,66,66
Deatra,F,100,66,0,66
Demetruis,M,100,0,66,66
Denilson,M,100,0,66,66
Diania,F,100,66,0,66
Dinorah,F,100,66,0,66
Dmari,M,100,0,66,66
Donovon,M,100,0,66,66
Estell,F,71,47,19,66
Faraz,M,100,0,66,66
Farida,F,100,66,0,66
Hadasa,F,100,66,0,66
Harlowe,F,100,66,0,66
Henrique,M,100,0,66,66
Hollyann,F,100,66,0,66
Hudsen,M,91,6,60,66
Inessa,F,100,66,0,66
Itzae,M,79,14,52,66
Ivania,F,100,66,0,66
Jaeson,M,100,0,66,66
Jahdiel,M,100,0,66,66
Jailin,M,55,30,36,66
Jaydenn,M,91,6,60,66
Jayke,M,100,0,66,66
Jese,M,100,0,66,66
Jinger,F,100,66,0,66
Jocelynne,F,100,66,0,66
Kayshawn,M,100,0,66,66
Keisy,F,100,66,0,66
Kemon,M,100,0,66,66
Kenn,M,100,0,66,66
Keonta,M,91,6,60,66
Keylen,M,64,24,42,66
Keyonte,M,100,0,66,66
Khara,F,100,66,0,66
Kiaan,M,100,0,66,66
Letticia,F,100,66,0,66
Lord,M,100,0,66,66
Lyana,F,100,66,0,66
Maddisen,F,100,66,0,66
Madix,M,100,0,66,66
Maheen,F,100,66,0,66
Makinlee,F,100,66,0,66
Marea,F,100,66,0,66
Mariellen,F,100,66,0,66
Marykatherine,F,100,66,0,66
Melida,F,100,66,0,66
Merita,F,100,66,0,66
Meryem,F,100,66,0,66
Michail,M,100,0,66,66
Montae,M,100,0,66,66
Myrah,F,100,66,0,66
Nadav,M,100,0,66,66
Nahshon,M,100,0,66,66
Narek,M,100,0,66,66
Niema,F,100,66,0,66
Nyia,F,100,66,0,66
Nyisha,F,100,66,0,66
Olamide,M,52,32,34,66
Pascale,F,100,66,0,66
Pixie,F,100,66,0,66
Prisila,F,100,66,0,66
Prisilla,F,100,66,0,66
Rishik,M,100,0,66,66
Rosaisela,F,100,66,0,66
Sadiq,M,100,0,66,66
Sameul,M,100,0,66,66
Sandrea,F,100,66,0,66
Saori,F,100,66,0,66
Sativa,F,100,66,0,66
Satya,F,80,53,13,66
Shahd,F,100,66,0,66
Shaleen,F,100,66,0,66
Shamica,F,100,66,0,66
Shauntae,F,100,66,0,66
Sho,M,100,0,66,66
Shyenne,F,100,66,0,66
Sivan,F,100,66,0,66
Sonal,F,100,66,0,66
Sonni,F,100,66,0,66
Sufyan,M,100,0,66,66
Tajuan,M,100,0,66,66
Talicia,F,100,66,0,66
Tamila,F,100,66,0,66
Tamitha,F,100,66,0,66
Taras,M,100,0,66,66
Tatem,F,55,36,30,66
Terressa,F,100,66,0,66
Tiphanie,F,100,66,0,66
Tracia,F,100,66,0,66
Trynity,F,100,66,0,66
Xaviera,F,100,66,0,66
Yakelin,F,100,66,0,66
Yalanda,F,100,66,0,66
Yeimi,F,100,66,0,66
Yunus,M,100,0,66,66
Zaccheus,M,100,0,66,66
Zaylah,F,100,66,0,66
Airabella,F,100,65,0,65
Ajia,F,100,65,0,65
Alante,M,89,7,58,65
Aldric,M,100,0,65,65
Alenna,F,100,65,0,65
Alexiah,F,100,65,0,65
Allysia,F,100,65,0,65
Amanuel,M,100,0,65,65
Amelya,F,100,65,0,65
Andera,F,100,65,0,65
Andrian,M,89,7,58,65
Anesha,F,100,65,0,65
Anjana,F,100,65,0,65
Ankur,M,100,0,65,65
Annasophia,F,100,65,0,65
Aparna,F,100,65,0,65
Arhaan,M,100,0,65,65
Arif,M,100,0,65,65
Arly,F,82,53,12,65
Arnett,M,92,5,60,65
Arrie,F,83,54,11,65
Arsema,F,100,65,0,65
Athalia,F,100,65,0,65
Attila,M,100,0,65,65
Auri,F,100,65,0,65
Barnett,M,100,0,65,65
Beata,F,100,65,0,65
Berna,F,100,65,0,65
Bernhard,M,100,0,65,65
Blakley,F,89,58,7,65
Bracken,M,100,0,65,65
Braelon,M,100,0,65,65
Braven,M,100,0,65,65
Breya,F,100,65,0,65
Brieanne,F,100,65,0,65
Callaway,M,55,29,36,65
Calysta,F,100,65,0,65
Camora,F,100,65,0,65
Carisma,F,100,65,0,65
Cerina,F,100,65,0,65
Chevon,F,100,65,0,65
Chrisopher,M,100,0,65,65
Cynda,F,100,65,0,65
Dacey,F,100,65,0,65
Dagmar,F,100,65,0,65
Dallan,M,100,0,65,65
Daric,M,100,0,65,65
Davonne,M,51,32,33,65
Dayquan,M,100,0,65,65
Demarious,M,100,0,65,65
Derris,M,100,0,65,65
Dhani,M,71,19,46,65
Donovin,M,100,0,65,65
Dunia,F,100,65,0,65
Eesa,M,100,0,65,65
Eion,M,100,0,65,65
Elonda,F,100,65,0,65
Emelda,F,100,65,0,65
Emillio,M,100,0,65,65
Emmaly,F,100,65,0,65
Evian,F,57,37,28,65
Faithlyn,F,100,65,0,65
Finian,M,100,0,65,65
Fraser,M,100,0,65,65
Hania,F,100,65,0,65
Hina,F,100,65,0,65
Hira,F,100,65,0,65
Ieisha,F,100,65,0,65
Illyana,F,100,65,0,65
Izzabelle,F,100,65,0,65
Jarryd,M,100,0,65,65
Jawuan,M,100,0,65,65
Jencarlo,M,100,0,65,65
Jenene,F,100,65,0,65
Joesiah,M,100,0,65,65
Kadrian,M,100,0,65,65
Kaidin,M,92,5,60,65
Kajuan,M,100,0,65,65
Kaleen,F,100,65,0,65
Kaleia,F,100,65,0,65
Kammy,F,100,65,0,65
Kasidy,F,100,65,0,65
Kathrynn,F,100,65,0,65
Kayra,F,100,65,0,65
Kelise,F,100,65,0,65
Kennis,M,89,7,58,65
Kodiak,M,100,0,65,65
Koji,M,100,0,65,65
Korynn,F,100,65,0,65
Lanise,F,100,65,0,65
Latecia,F,100,65,0,65
Latrelle,F,52,34,31,65
Lawayne,M,92,5,60,65
Lisett,F,100,65,0,65
Madilynne,F,100,65,0,65
Maeva,F,100,65,0,65
Manish,M,100,0,65,65
Manu,M,100,0,65,65
Marilena,F,100,65,0,65
Marisella,F,100,65,0,65
Marjean,F,100,65,0,65
Markeese,M,100,0,65,65
Marlei,F,100,65,0,65
Maryjean,F,100,65,0,65
Mateen,M,100,0,65,65
Mayda,F,100,65,0,65
Mckinnley,F,92,60,5,65
Meghna,F,100,65,0,65
Menno,M,100,0,65,65
Mirel,F,100,65,0,65
Muhamed,M,100,0,65,65
Nathali,F,100,65,0,65
Nayana,F,100,65,0,65
Oz,M,100,0,65,65
Payal,F,100,65,0,65
Pinkie,F,100,65,0,65
Placido,M,100,0,65,65
Presli,F,100,65,0,65
Raeshawn,M,60,26,39,65
Raychelle,F,100,65,0,65
Rica,F,100,65,0,65
Rockford,M,100,0,65,65
Roselin,F,100,65,0,65
Ruslan,M,100,0,65,65
Ryla,F,100,65,0,65
Samera,F,100,65,0,65
Sarika,F,100,65,0,65
Saydie,F,100,65,0,65
Shakina,F,100,65,0,65
Shantrell,F,100,65,0,65
Sharone,F,83,54,11,65
Sharrod,M,100,0,65,65
Shauni,F,100,65,0,65
Sheli,F,100,65,0,65
Sophi,F,100,65,0,65
Stanly,M,100,0,65,65
Stirling,M,100,0,65,65
Sundus,F,100,65,0,65
Suzzette,F,100,65,0,65
Sydne,F,100,65,0,65
Taiwan,M,92,5,60,65
Tamieka,F,100,65,0,65
Tao,M,85,10,55,65
Terrye,F,100,65,0,65
Towanna,F,100,65,0,65
Trini,F,72,47,18,65
Uchenna,M,74,17,48,65
Vadhir,M,100,0,65,65
Veena,F,100,65,0,65
Vernette,F,100,65,0,65
Vicent,M,100,0,65,65
Viliami,M,100,0,65,65
Xandra,F,100,65,0,65
Zakiah,F,72,47,18,65
Zamar,M,100,0,65,65
Zandria,F,100,65,0,65
Zayleigh,F,100,65,0,65
Zyriah,F,100,65,0,65
Adric,M,100,0,64,64
Aeson,M,100,0,64,64
Aimie,F,100,64,0,64
Aleks,M,100,0,64,64
Alexiana,F,100,64,0,64
Algie,M,100,0,64,64
Alizon,F,100,64,0,64
Almira,F,100,64,0,64
Anelise,F,100,64,0,64
Angelette,F,100,64,0,64
Anthany,M,100,0,64,64
Ariani,F,100,64,0,64
Arjen,M,100,0,64,64
Arlee,F,77,49,15,64
Aunna,F,100,64,0,64
Berit,F,100,64,0,64
Biagio,M,100,0,64,64
Bogdan,M,100,0,64,64
Brinn,F,100,64,0,64
Camri,F,100,64,0,64
Cana,F,100,64,0,64
Catalaya,F,100,64,0,64
Cecila,F,100,64,0,64
Cecillia,F,100,64,0,64
Ciel,F,61,39,25,64
Claretha,F,100,64,0,64
Cloud,M,100,0,64,64
Consuella,F,100,64,0,64
Deaira,F,100,64,0,64
Decklan,M,100,0,64,64
Delorise,F,100,64,0,64
Denell,F,80,51,13,64
Devika,F,100,64,0,64
Dimitris,M,100,0,64,64
Donnovan,M,100,0,64,64
Draper,M,100,0,64,64
Edina,F,100,64,0,64
Ellana,F,100,64,0,64
Elpidio,M,100,0,64,64
Esli,F,92,59,5,64
Estee,F,100,64,0,64
Even,M,100,0,64,64
Fionn,M,100,0,64,64
Florene,F,100,64,0,64
Frimet,F,100,64,0,64
Gaynelle,F,100,64,0,64
Hatcher,M,100,0,64,64
Hayat,F,100,64,0,64
Hershell,M,100,0,64,64
Ilah,F,100,64,0,64
Jacion,M,100,0,64,64
Jackelyne,F,100,64,0,64
Janan,F,100,64,0,64
Jaselle,F,100,64,0,64
Jasey,F,100,64,0,64
Jaymin,M,100,0,64,64
Jayro,M,100,0,64,64
Jazlyne,F,100,64,0,64
Jeimy,F,100,64,0,64
Jian,M,92,5,59,64
Jontavious,M,100,0,64,64
Kaegan,M,67,21,43,64
Kaylanie,F,100,64,0,64
Kayln,F,100,64,0,64
Keaghan,M,80,13,51,64
Kealani,F,100,64,0,64
Kenderick,M,100,0,64,64
Kento,M,100,0,64,64
Kerissa,F,100,64,0,64
Keshawna,F,100,64,0,64
Klynn,F,100,64,0,64
Kristle,F,100,64,0,64
Kristofor,M,100,0,64,64
Lafonda,F,100,64,0,64
Latasia,F,100,64,0,64
Lathen,M,100,0,64,64
Lawerance,M,100,0,64,64
Laykin,F,100,64,0,64
Lilya,F,100,64,0,64
Lua,F,100,64,0,64
Mackinley,M,52,31,33,64
Mahina,F,100,64,0,64
Maurizio,M,100,0,64,64
Maygan,F,100,64,0,64
Michon,F,91,58,6,64
Mikko,M,100,0,64,64
Mily,F,100,64,0,64
Missie,F,100,64,0,64
Nael,M,91,6,58,64
Najwa,F,100,64,0,64
Nickalas,M,100,0,64,64
Nitin,M,100,0,64,64
Nyoka,F,100,64,0,64
Oleta,F,100,64,0,64
Omarr,M,100,0,64,64
Oral,M,100,0,64,64
Percell,M,100,0,64,64
Perel,F,100,64,0,64
Rainbow,F,100,64,0,64
Rajveer,M,100,0,64,64
Rakia,F,100,64,0,64
Rayland,M,100,0,64,64
Rosenda,F,100,64,0,64
Rossy,F,100,64,0,64
Safiyyah,F,100,64,0,64
Sakeena,F,100,64,0,64
Samina,F,100,64,0,64
Shadia,F,100,64,0,64
Shalaya,F,100,64,0,64
Sharda,F,100,64,0,64
Sharene,F,100,64,0,64
Sharise,F,100,64,0,64
Sharisse,F,100,64,0,64
Shenell,F,100,64,0,64
Solei,F,100,64,0,64
Steffi,F,100,64,0,64
Stephanee,F,100,64,0,64
Surina,F,100,64,0,64
Tammra,F,100,64,0,64
Tauna,F,100,64,0,64
Taylour,F,89,57,7,64
Tywana,F,100,64,0,64
Uvaldo,M,100,0,64,64
Valene,F,100,64,0,64
Victorio,M,100,0,64,64
Whitaker,M,92,5,59,64
Worth,M,100,0,64,64
Wynton,M,100,0,64,64
Yamilett,F,100,64,0,64
Zykia,F,100,64,0,64
Abelino,M,100,0,63,63
Adalin,F,100,63,0,63
Afnan,F,84,53,10,63
Aimar,F,86,54,9,63
Aissa,F,100,63,0,63
Aleem,M,100,0,63,63
Alfie,M,86,9,54,63
Ambree,F,100,63,0,63
Annice,F,100,63,0,63
Anuhea,F,100,63,0,63
Arlana,F,100,63,0,63
Aryonna,F,100,63,0,63
Asheley,F,100,63,0,63
Aydrian,M,92,5,58,63
Barnabas,M,100,0,63,63
Barri,F,89,56,7,63
Baylea,F,100,63,0,63
Braelin,M,54,29,34,63
Breahna,F,100,63,0,63
Briston,M,100,0,63,63
Burrell,M,100,0,63,63
Cailen,M,51,31,32,63
Camisha,F,100,63,0,63
Carlitos,M,100,0,63,63
Carola,F,100,63,0,63
Char,F,100,63,0,63
Charlyne,F,100,63,0,63
Cheyene,F,100,63,0,63
Christo,M,100,0,63,63
Creston,M,100,0,63,63
Cristoval,M,100,0,63,63
Crystalyn,F,100,63,0,63
Damarys,F,100,63,0,63
Daniah,F,100,63,0,63
Daphnee,F,100,63,0,63
Darik,M,100,0,63,63
Dasan,M,100,0,63,63
Declyn,M,67,21,42,63
Deepak,M,100,0,63,63
Deryck,M,100,0,63,63
Dewan,M,100,0,63,63
Diamante,M,67,21,42,63
Dmitry,M,100,0,63,63
Doron,M,100,0,63,63
Drayson,M,100,0,63,63
Elexa,F,100,63,0,63
Ellory,F,100,63,0,63
Elna,F,100,63,0,63
Elspeth,F,100,63,0,63
Elyzabeth,F,100,63,0,63
Esa,M,90,6,57,63
Esty,F,100,63,0,63
Etty,F,100,63,0,63
Geanna,F,100,63,0,63
Genene,F,100,63,0,63
Genevia,F,100,63,0,63
Genevive,F,100,63,0,63
Gerad,M,100,0,63,63
Gerrick,M,100,0,63,63
Glennon,M,100,0,63,63
Gordan,M,100,0,63,63
Hailley,F,100,63,0,63
Hoa,M,59,26,37,63
Izael,M,100,0,63,63
Jaevon,M,100,0,63,63
Jeniece,F,100,63,0,63
Jervon,M,100,0,63,63
Jhene,F,100,63,0,63
Jonn,M,100,0,63,63
Judit,F,100,63,0,63
Jvon,M,100,0,63,63
Kaisyn,M,75,16,47,63
Keeleigh,F,100,63,0,63
Keita,M,67,21,42,63
Keithen,M,100,0,63,63
Kendy,F,92,58,5,63
Keyri,F,100,63,0,63
Krishiv,M,100,0,63,63
Kristee,F,100,63,0,63
Kwan,M,89,7,56,63
Kwasi,M,100,0,63,63
Ladona,F,100,63,0,63
Lakesia,F,100,63,0,63
Latisa,F,100,63,0,63
Lendell,M,100,0,63,63
Lilliam,F,100,63,0,63
Loring,M,92,5,58,63
Lovella,F,100,63,0,63
Ludwig,M,100,0,63,63
Maelie,F,100,63,0,63
Mahima,F,100,63,0,63
Makailah,F,100,63,0,63
Manual,M,100,0,63,63
Marcee,F,100,63,0,63
Maresa,F,100,63,0,63
Mariane,F,100,63,0,63
Marlane,F,100,63,0,63
Maryana,F,100,63,0,63
Maryclaire,F,100,63,0,63
Maurissa,F,100,63,0,63
Meeka,F,100,63,0,63
Michaelanthony,M,100,0,63,63
Mileah,F,100,63,0,63
Monico,M,100,0,63,63
Monigue,F,100,63,0,63
Morelia,F,100,63,0,63
Nalayah,F,100,63,0,63
Nason,M,100,0,63,63
Naziah,F,67,42,21,63
Neah,F,100,63,0,63
Paxson,M,100,0,63,63
Pharoah,M,100,0,63,63
Porchia,F,100,63,0,63
Raechelle,F,100,63,0,63
Raveen,F,100,63,0,63
Renarda,F,92,58,5,63
Reynard,M,100,0,63,63
Rondale,M,100,0,63,63
Rui,M,100,0,63,63
Rulon,M,100,0,63,63
Sarra,F,100,63,0,63
Saryah,F,100,63,0,63
Sha,F,87,55,8,63
Shakari,F,100,63,0,63
Shawntay,F,90,57,6,63
Sheyanne,F,100,63,0,63
Sidharth,M,100,0,63,63
Sofi,F,100,63,0,63
Sohum,M,100,0,63,63
Solon,M,100,0,63,63
Steward,M,100,0,63,63
Sumaiya,F,100,63,0,63
Suzzanne,F,100,63,0,63
Tajanae,F,100,63,0,63
Taji,M,71,18,45,63
Tally,F,90,57,6,63
Tavarius,M,100,0,63,63
Tevis,M,78,14,49,63
Toinette,F,100,63,0,63
Tomekia,F,100,63,0,63
Trayvion,M,100,0,63,63
Tywanna,F,100,63,0,63
Uzziel,M,100,0,63,63
Valkyrie,F,100,63,0,63
Vinton,M,100,0,63,63
Vlad,M,100,0,63,63
Yareth,M,56,28,35,63
York,M,100,0,63,63
Yuma,M,79,13,50,63
Zakir,M,100,0,63,63
Zeta,F,100,63,0,63
Zeyad,M,100,0,63,63
Zori,F,100,63,0,63
Adalind,F,100,62,0,62
Advika,F,100,62,0,62
Ailsa,F,100,62,0,62
Akyra,F,100,62,0,62
Alanzo,M,100,0,62,62
Aletheia,F,100,62,0,62
Alinna,F,100,62,0,62
Analaura,F,100,62,0,62
Analyssa,F,100,62,0,62
Angi,F,100,62,0,62
Anjuli,F,100,62,0,62
Aprile,F,100,62,0,62
Aquila,F,100,62,0,62
Asif,M,100,0,62,62
Asusena,F,100,62,0,62
Avaree,F,100,62,0,62
Axell,M,100,0,62,62
Ayme,F,100,62,0,62
Batya,F,100,62,0,62
Bibi,F,100,62,0,62
Binta,F,100,62,0,62
Blase,M,100,0,62,62
Brandalyn,F,100,62,0,62
Braysen,M,100,0,62,62
Bryelle,F,100,62,0,62
Buckley,M,100,0,62,62
Callia,F,100,62,0,62
Camia,F,100,62,0,62
Camya,F,100,62,0,62
Chimene,F,100,62,0,62
Cianni,F,100,62,0,62
Colm,M,100,0,62,62
Connar,M,100,0,62,62
Crist,M,100,0,62,62
Cymone,F,100,62,0,62
Daishawn,M,100,0,62,62
Daman,M,100,0,62,62
Dayveon,M,100,0,62,62
Dereka,F,100,62,0,62
Deryk,M,100,0,62,62
Dex,M,100,0,62,62
Deyonna,F,100,62,0,62
Dionta,M,100,0,62,62
Donyale,F,74,46,16,62
Doreatha,F,100,62,0,62
Dorita,F,100,62,0,62
Dorman,M,100,0,62,62
Dulcemaria,F,100,62,0,62
Edris,M,63,23,39,62
Elexia,F,100,62,0,62
Ellasyn,F,100,62,0,62
Erroll,M,100,0,62,62
Estefanie,F,100,62,0,62
Ezabella,F,100,62,0,62
Floria,F,100,62,0,62
Foy,M,92,5,57,62
Froilan,M,100,0,62,62
Gaberial,M,92,5,57,62
Graylin,M,81,12,50,62
Gwenivere,F,100,62,0,62
Hamdi,F,77,48,14,62
Izek,M,100,0,62,62
Jager,M,100,0,62,62
Jahan,M,100,0,62,62
Jaidin,M,63,23,39,62
Jamisen,M,77,14,48,62
Jasmeen,F,100,62,0,62
Jatavious,M,100,0,62,62
Jaxten,M,100,0,62,62
Jaylynne,F,100,62,0,62
Jaysa,F,100,62,0,62
Jazlynne,F,100,62,0,62
Jb,M,100,0,62,62
Jemimah,F,100,62,0,62
Jenah,F,100,62,0,62
Jeovanni,M,100,0,62,62
Jerame,M,100,0,62,62
Jermon,M,100,0,62,62
Jestine,F,100,62,0,62
Jevan,M,100,0,62,62
Jeyson,M,100,0,62,62
Jibreel,M,100,0,62,62
Jud,M,100,0,62,62
Kadon,M,100,0,62,62
Kalub,M,100,0,62,62
Kammi,F,100,62,0,62
Karessa,F,100,62,0,62
Kato,M,100,0,62,62
Kaylana,F,100,62,0,62
Keyontae,M,100,0,62,62
Kharter,M,84,10,52,62
Khia,F,100,62,0,62
Kiari,F,92,57,5,62
Kinzey,F,100,62,0,62
Kitai,M,100,0,62,62
Kyon,M,100,0,62,62
Lakecia,F,100,62,0,62
Lateshia,F,100,62,0,62
Latham,M,100,0,62,62
Lazaria,F,100,62,0,62
Leelan,M,100,0,62,62
Leoncio,M,100,0,62,62
Liat,F,100,62,0,62
Linzi,F,100,62,0,62
Madelon,F,100,62,0,62
Maralee,F,100,62,0,62
Marketa,F,100,62,0,62
Marylouise,F,100,62,0,62
Maxen,M,100,0,62,62
Michaelyn,F,100,62,0,62
Mickenzie,F,100,62,0,62
Mikka,F,100,62,0,62
Monifa,F,100,62,0,62
Moya,F,100,62,0,62
Namir,M,100,0,62,62
Narada,M,89,7,55,62
Oluwadarasimi,F,55,34,28,62
Orie,M,100,0,62,62
Patterson,M,84,10,52,62
Reann,F,100,62,0,62
Remigio,M,100,0,62,62
Remus,M,100,0,62,62
Richele,F,100,62,0,62
Riona,F,100,62,0,62
Ronold,M,100,0,62,62
Sabah,F,100,62,0,62
Saddie,F,100,62,0,62
Sagar,M,100,0,62,62
Saharsh,M,100,0,62,62
Saydi,F,100,62,0,62
Shakeema,F,100,62,0,62
Shaneika,F,100,62,0,62
Shatoria,F,100,62,0,62
Shirly,F,100,62,0,62
Shontay,F,100,62,0,62
Siraj,M,100,0,62,62
Tamryn,F,92,57,5,62
Teairra,F,100,62,0,62
Tehani,F,100,62,0,62
Thaddius,M,100,0,62,62
Tidus,M,100,0,62,62
Toma,M,74,16,46,62
Tycen,M,100,0,62,62
Tynia,F,100,62,0,62
Vihan,M,100,0,62,62
Violett,F,100,62,0,62
Yassine,M,100,0,62,62
Yennifer,F,100,62,0,62
Zalmen,M,100,0,62,62
Aasiyah,F,100,61,0,61
Alixandria,F,100,61,0,61
Alizee,F,100,61,0,61
Amaru,M,100,0,61,61
Anagha,F,100,61,0,61
Aneisha,F,100,61,0,61
Angelis,F,100,61,0,61
Arch,M,100,0,61,61
Arilyn,F,100,61,0,61
Ashliegh,F,100,61,0,61
Asiel,M,90,6,55,61
Atalie,F,100,61,0,61
Athanasia,F,100,61,0,61
Avangeline,F,100,61,0,61
Avri,F,90,55,6,61
Betania,F,100,61,0,61
Billyjoe,M,100,0,61,61
Blanch,F,100,61,0,61
Brandilyn,F,100,61,0,61
Brazil,F,89,54,7,61
Brette,F,82,50,11,61
Brilyn,F,79,48,13,61
Catriona,F,100,61,0,61
Cayenne,F,89,54,7,61
Charlet,F,100,61,0,61
Corynne,F,100,61,0,61
Cullin,M,100,0,61,61
Cyler,M,100,0,61,61
Cyndie,F,100,61,0,61
Dailen,M,100,0,61,61
Danice,F,100,61,0,61
Danne,F,77,47,14,61
Dannica,F,100,61,0,61
Dannon,M,100,0,61,61
Dason,M,100,0,61,61
Decarlo,M,100,0,61,61
Deema,F,100,61,0,61
Demonica,F,100,61,0,61
Dennys,M,100,0,61,61
Diandre,M,87,8,53,61
Dicky,M,100,0,61,61
Dilyn,M,64,22,39,61
Dmarion,M,100,0,61,61
Dshawn,M,100,0,61,61
Ehsan,M,100,0,61,61
Elizaveta,F,100,61,0,61
Elyssia,F,100,61,0,61
Farron,M,100,0,61,61
Fredrica,F,100,61,0,61
Gabryelle,F,100,61,0,61
Garrin,M,100,0,61,61
Geovanna,F,100,61,0,61
Haisley,F,100,61,0,61
Halbert,M,100,0,61,61
Hasaan,M,100,0,61,61
Heavenleigh,F,100,61,0,61
Hobie,M,100,0,61,61
Honora,F,100,61,0,61
Hyman,M,100,0,61,61
Iden,M,100,0,61,61
Issak,M,100,0,61,61
Izell,M,100,0,61,61
Jadynn,F,92,56,5,61
Jaedin,M,92,5,56,61
Jahnae,F,100,61,0,61
Jak,M,100,0,61,61
Jamare,M,100,0,61,61
Jamea,F,100,61,0,61
Jamirah,F,100,61,0,61
Jannel,F,100,61,0,61
Janyiah,F,100,61,0,61
Jaquavion,M,100,0,61,61
Jaretzy,F,100,61,0,61
Jayren,M,100,0,61,61
Jazzmyne,F,100,61,0,61
Jeremia,M,100,0,61,61
Jerra,F,100,61,0,61
Jerrin,M,100,0,61,61
Jerzey,F,92,56,5,61
Jj,M,100,0,61,61
Jonica,F,100,61,0,61
Junious,M,100,0,61,61
Junita,F,100,61,0,61
Kaelani,F,100,61,0,61
Kalum,M,100,0,61,61
Kamrie,F,100,61,0,61
Karimah,F,100,61,0,61
Karrigan,F,100,61,0,61
Kasaundra,F,100,61,0,61
Katelyne,F,100,61,0,61
Kaysi,F,100,61,0,61
Keia,F,100,61,0,61
Kellianne,F,100,61,0,61
Khristine,F,100,61,0,61
Kimbery,F,100,61,0,61
Kindle,F,100,61,0,61
Korrin,F,100,61,0,61
Kreed,M,100,0,61,61
Kriti,F,100,61,0,61
Kymberli,F,100,61,0,61
Lahoma,F,100,61,0,61
Laiza,F,100,61,0,61
Lasean,M,74,16,45,61
Lashayla,F,100,61,0,61
Lazer,M,100,0,61,61
Lestat,M,100,0,61,61
Letrice,F,100,61,0,61
Leverne,M,64,22,39,61
Lus,F,100,61,0,61
Lutricia,F,100,61,0,61
Maalik,M,100,0,61,61
Maddax,M,100,0,61,61
Maleya,F,100,61,0,61
Margene,F,100,61,0,61
Marine,F,100,61,0,61
Marten,M,100,0,61,61
Martyn,M,100,0,61,61
Mathilde,F,100,61,0,61
Mert,M,100,0,61,61
Miliani,F,100,61,0,61
Myana,F,100,61,0,61
Nur,F,80,49,12,61
Nyema,F,100,61,0,61
Odyssey,F,100,61,0,61
Ondrea,F,100,61,0,61
Pinchus,M,100,0,61,61
Quanesha,F,100,61,0,61
Quintyn,M,100,0,61,61
Ragen,F,100,61,0,61
Rajeev,M,100,0,61,61
Raysean,M,100,0,61,61
Reo,M,100,0,61,61
Reyli,M,100,0,61,61
Ronetta,F,100,61,0,61
Ronnald,M,100,0,61,61
Rosangela,F,100,61,0,61
Saketh,M,100,0,61,61
Scarleth,F,100,61,0,61
Seanmichael,M,100,0,61,61
Seferino,M,100,0,61,61
Selby,M,56,27,34,61
Sequoyah,F,79,48,13,61
Shanie,F,100,61,0,61
Sharlet,F,100,61,0,61
Shayn,M,100,0,61,61
Sherian,F,100,61,0,61
Shi,F,75,46,15,61
Shyheim,M,100,0,61,61
Son,M,100,0,61,61
Tasheena,F,100,61,0,61
Tavoris,M,100,0,61,61
Tenlee,F,100,61,0,61
Thora,F,100,61,0,61
Threasa,F,100,61,0,61
Tighe,M,100,0,61,61
Tresean,M,100,0,61,61
Trianna,F,100,61,0,61
Tyara,F,100,61,0,61
Tyresha,F,100,61,0,61
Valda,F,100,61,0,61
Vernal,M,100,0,61,61
Viviann,F,100,61,0,61
Xaviar,M,100,0,61,61
Xzavior,M,100,0,61,61
Yaser,M,100,0,61,61
Yeng,M,80,12,49,61
Zadok,M,100,0,61,61
Zair,M,100,0,61,61
Zalen,M,100,0,61,61
Zan,M,90,6,55,61
Zayah,F,90,55,6,61
Adeena,F,100,60,0,60
Adonay,M,100,0,60,60
Aesha,F,100,60,0,60
Aizah,F,100,60,0,60
Alany,F,100,60,0,60
Alasdair,M,100,0,60,60
Alayja,F,100,60,0,60
Amorette,F,100,60,0,60
Andrena,F,100,60,0,60
Anglia,F,100,60,0,60
Annia,F,100,60,0,60
Antawn,M,100,0,60,60
Antoin,M,100,0,60,60
Arella,F,100,60,0,60
Arvel,M,100,0,60,60
Arvind,M,100,0,60,60
Aryanah,F,100,60,0,60
Athziri,F,100,60,0,60
Aveah,F,100,60,0,60
Bebe,F,100,60,0,60
Bowman,M,100,0,60,60
Braya,F,100,60,0,60
Brayla,F,100,60,0,60
Brendalee,F,100,60,0,60
Calina,F,100,60,0,60
Ceaira,F,100,60,0,60
Chavonne,F,100,60,0,60
Cherrish,F,100,60,0,60
Chrysta,F,100,60,0,60
Colyn,M,100,0,60,60
Curren,M,100,0,60,60
Daiquan,M,100,0,60,60
Dalylah,F,100,60,0,60
Degan,M,100,0,60,60
Delphina,F,100,60,0,60
Deziray,F,100,60,0,60
Dillyn,M,57,26,34,60
Dmarco,M,100,0,60,60
Dmario,M,100,0,60,60
Domenique,F,83,50,10,60
Drequan,M,100,0,60,60
Edelyn,F,100,60,0,60
Edlyn,F,100,60,0,60
Elanie,F,100,60,0,60
Emiyah,F,100,60,0,60
Enrigue,M,100,0,60,60
Esgar,M,100,0,60,60
Evalee,F,100,60,0,60
Evonna,F,100,60,0,60
Faithe,F,100,60,0,60
Faiz,M,100,0,60,60
Fatuma,F,100,60,0,60
Feather,F,100,60,0,60
Gaelle,F,100,60,0,60
Gari,F,72,43,17,60
Gerilyn,F,100,60,0,60
Graziella,F,100,60,0,60
Hafsah,F,100,60,0,60
Hai,M,100,0,60,60
Hazael,M,100,0,60,60
Heinrich,M,100,0,60,60
Hien,F,53,32,28,60
Idan,M,100,0,60,60
Ieasha,F,100,60,0,60
Ioanna,F,100,60,0,60
Ivyanna,F,100,60,0,60
Jaevion,M,100,0,60,60
Jaiven,M,100,0,60,60
Jakya,F,100,60,0,60
Jaleyah,F,100,60,0,60
Jamond,M,100,0,60,60
Janvi,F,100,60,0,60
Jasia,F,100,60,0,60
Jaymar,M,100,0,60,60
Jen,F,53,32,28,60
Jeran,M,100,0,60,60
Jesi,F,100,60,0,60
Jiovanny,M,100,0,60,60
Jonel,F,50,30,30,60
Josefine,F,100,60,0,60
Jt,M,100,0,60,60
Jumana,F,100,60,0,60
Kajsa,F,100,60,0,60
Kameran,M,78,13,47,60
Kashia,F,100,60,0,60
Kea,F,100,60,0,60
Kealy,F,100,60,0,60
Kinsler,M,88,7,53,60
Kiyon,M,100,0,60,60
Kohlton,M,100,0,60,60
Korinna,F,100,60,0,60
Kynadee,F,100,60,0,60
Lagina,F,100,60,0,60
Lam,M,87,8,52,60
Lama,F,100,60,0,60
Lamesha,F,100,60,0,60
Lanea,F,100,60,0,60
Lanessa,F,100,60,0,60
Lang,M,100,0,60,60
Lasya,F,100,60,0,60
Lateefah,F,100,60,0,60
Leane,F,100,60,0,60
Lizzet,F,100,60,0,60
Lliam,M,100,0,60,60
Loida,F,100,60,0,60
Lorrine,F,100,60,0,60
Lucilla,F,100,60,0,60
Lynzi,F,100,60,0,60
Mailen,F,100,60,0,60
Maisen,M,63,22,38,60
Malarie,F,100,60,0,60
Manpreet,F,57,34,26,60
Maretta,F,100,60,0,60
Markham,M,100,0,60,60
Mars,M,100,0,60,60
Marylu,F,100,60,0,60
Mauricia,F,100,60,0,60
Mayce,F,100,60,0,60
Meng,M,100,0,60,60
Menucha,F,100,60,0,60
Merit,F,58,35,25,60
Meshell,F,100,60,0,60
Mikia,F,100,60,0,60
Monic,F,100,60,0,60
Monnie,F,70,42,18,60
Montoya,F,88,53,7,60
Monya,F,100,60,0,60
Moria,F,100,60,0,60
Nasario,M,100,0,60,60
Navia,F,100,60,0,60
Naziyah,F,100,60,0,60
Nekia,F,100,60,0,60
Ngozi,F,90,54,6,60
Percival,M,100,0,60,60
Petar,M,100,0,60,60
Quartez,M,100,0,60,60
Quashawn,M,100,0,60,60
Quavon,M,100,0,60,60
Quinnton,M,100,0,60,60
Quintrell,M,100,0,60,60
Rafi,M,100,0,60,60
Rakiyah,F,100,60,0,60
Ranell,F,62,37,23,60
Rawley,M,100,0,60,60
Rei,M,57,26,34,60
Remmington,M,57,26,34,60
Reuel,M,100,0,60,60
Rosaleigh,F,100,60,0,60
Ruthy,F,100,60,0,60
Rydell,M,100,0,60,60
Sabre,F,80,48,12,60
Samika,F,100,60,0,60
Sapna,F,100,60,0,60
Sharlee,F,100,60,0,60
Shavone,F,100,60,0,60
Shruthi,F,100,60,0,60
Taevion,M,100,0,60,60
Talesha,F,100,60,0,60
Teigen,M,65,21,39,60
Telicia,F,100,60,0,60
Teodora,F,100,60,0,60
Teshia,F,100,60,0,60
Tiffanee,F,100,60,0,60
Tilda,F,100,60,0,60
Tinika,F,100,60,0,60
Torianna,F,100,60,0,60
Tyneshia,F,100,60,0,60
Tywanda,F,100,60,0,60
Vana,F,100,60,0,60
Viveca,F,100,60,0,60
Wanya,M,100,0,60,60
Whit,M,100,0,60,60
Xoe,F,100,60,0,60
Yanitza,F,100,60,0,60
Yuval,M,70,18,42,60
Zaeden,M,100,0,60,60
Zubair,M,100,0,60,60
Aaric,M,100,0,59,59
Adelaine,F,100,59,0,59
Adya,F,100,59,0,59
Akila,F,100,59,0,59
Alexya,F,100,59,0,59
Amarissa,F,100,59,0,59
Amberleigh,F,100,59,0,59
Amita,F,100,59,0,59
Analissa,F,100,59,0,59
Andreah,F,100,59,0,59
Anjelina,F,100,59,0,59
Annslee,F,100,59,0,59
Ariann,F,100,59,0,59
Armanii,F,68,40,19,59
Ashanta,F,100,59,0,59
Astin,M,75,15,44,59
Atziry,F,100,59,0,59
Avree,F,100,59,0,59
Baillie,F,100,59,0,59
Basel,M,100,0,59,59
Bauer,M,100,0,59,59
Becket,M,100,0,59,59
Bobbette,F,100,59,0,59
Braxtin,M,100,0,59,59
Breyona,F,100,59,0,59
Brittainy,F,100,59,0,59
Brucha,F,100,59,0,59
Canton,M,100,0,59,59
Carmelia,F,100,59,0,59
Carolena,F,100,59,0,59
Cayetano,M,100,0,59,59
Chong,F,54,32,27,59
Clea,F,100,59,0,59
Cortlyn,F,92,54,5,59
Corwyn,M,100,0,59,59
Crayton,M,100,0,59,59
Cuong,M,100,0,59,59
Dalin,M,81,11,48,59
Danee,F,100,59,0,59
Dayan,M,61,23,36,59
Demetre,M,100,0,59,59
Dominika,F,100,59,0,59
Donavyn,M,100,0,59,59
Durward,M,100,0,59,59
Elidia,F,100,59,0,59
Emri,F,100,59,0,59
Fancy,F,100,59,0,59
Ferman,M,100,0,59,59
Finneas,M,100,0,59,59
Fredda,F,100,59,0,59
Gautham,M,100,0,59,59
Geremiah,M,100,0,59,59
Grayling,M,100,0,59,59
Hiawatha,M,76,14,45,59
Hiro,M,100,0,59,59
Ivery,M,71,17,42,59
Jaccob,M,100,0,59,59
Jahmere,M,100,0,59,59
Jannice,F,100,59,0,59
Jedadiah,M,100,0,59,59
Jeneane,F,100,59,0,59
Jennavieve,F,100,59,0,59
Jennika,F,100,59,0,59
Jennipher,F,100,59,0,59
Jeromey,M,100,0,59,59
Jeyden,M,100,0,59,59
Jissel,F,100,59,0,59
Johnthomas,M,100,0,59,59
Joycelynn,F,100,59,0,59
Joylynn,F,100,59,0,59
Juanantonio,M,100,0,59,59
Kahli,F,92,54,5,59
Kalab,M,100,0,59,59
Karna,F,90,53,6,59
Kassaundra,F,100,59,0,59
Kayin,M,83,10,49,59
Keelee,F,100,59,0,59
Keneshia,F,100,59,0,59
Keng,M,100,0,59,59
Kessa,F,100,59,0,59
Kessler,M,90,6,53,59
Ketan,M,100,0,59,59
Khalani,F,92,54,5,59
Kharma,F,100,59,0,59
Kimberlea,F,100,59,0,59
Konstantine,M,100,0,59,59
Koran,M,100,0,59,59
Koty,M,90,6,53,59
Kruze,M,100,0,59,59
Kyliegh,F,100,59,0,59
Lachandra,F,100,59,0,59
Lalena,F,100,59,0,59
Larinda,F,100,59,0,59
Lashaundra,F,100,59,0,59
Latrica,F,100,59,0,59
Lauralyn,F,100,59,0,59
Leelah,F,100,59,0,59
Leotis,M,100,0,59,59
Lesslie,F,100,59,0,59
Lezlee,F,100,59,0,59
Linsay,F,100,59,0,59
Ludivina,F,100,59,0,59
Maiyah,F,100,59,0,59
Makaiya,F,100,59,0,59
Mandela,M,100,0,59,59
Marizol,F,100,59,0,59
Marleni,F,100,59,0,59
Massiel,F,100,59,0,59
Maximilliano,M,100,0,59,59
Mckenley,F,90,53,6,59
Meela,F,100,59,0,59
Meia,F,100,59,0,59
Meka,F,100,59,0,59
Mercades,F,100,59,0,59
Meshach,M,100,0,59,59
Michae,M,100,0,59,59
Mindee,F,100,59,0,59
Mkayla,F,100,59,0,59
Monna,F,100,59,0,59
Mosiah,M,100,0,59,59
Moxie,F,100,59,0,59
Najla,F,100,59,0,59
Nalleli,F,100,59,0,59
Nashla,F,100,59,0,59
Nazaria,F,100,59,0,59
Nazier,M,100,0,59,59
Nesha,F,100,59,0,59
Nichols,M,100,0,59,59
Nickolai,M,100,0,59,59
Nura,F,100,59,0,59
Princella,F,100,59,0,59
Quang,M,100,0,59,59
Quoc,M,100,0,59,59
Radford,M,100,0,59,59
Rece,M,100,0,59,59
Renesha,F,100,59,0,59
Revonda,F,100,59,0,59
Roark,M,100,0,59,59
Robi,F,66,39,20,59
Rohin,M,100,0,59,59
Rook,M,100,0,59,59
Roseline,F,100,59,0,59
Rubina,F,100,59,0,59
Saachi,F,100,59,0,59
Sabreen,F,100,59,0,59
Safaa,F,100,59,0,59
Samiha,F,100,59,0,59
Sergey,M,100,0,59,59
Sharia,F,100,59,0,59
Sharmon,F,100,59,0,59
Sheamus,M,100,0,59,59
Sheela,F,100,59,0,59
Shenequa,F,100,59,0,59
Sherrita,F,100,59,0,59
Shreyan,M,100,0,59,59
Skai,F,90,53,6,59
Soila,F,100,59,0,59
Syria,F,100,59,0,59
Tallen,M,100,0,59,59
Tanzania,F,100,59,0,59
Tayon,M,100,0,59,59
Tayte,M,90,6,53,59
Tereza,F,100,59,0,59
Terin,F,59,35,24,59
Terrika,F,100,59,0,59
Titania,F,100,59,0,59
Tonio,M,100,0,59,59
Toyia,F,100,59,0,59
Trevaughn,M,100,0,59,59
Treyvion,M,100,0,59,59
Tylah,F,100,59,0,59
Tylia,F,100,59,0,59
Vivan,M,59,24,35,59
Wenona,F,100,59,0,59
Wesam,M,100,0,59,59
Wright,M,100,0,59,59
Yazlin,F,100,59,0,59
Yvanna,F,100,59,0,59
Ziare,M,90,6,53,59
Aaralynn,F,100,58,0,58
Adaeze,F,100,58,0,58
Agastya,M,100,0,58,58
Akai,M,88,7,51,58
Alayia,F,100,58,0,58
Amarachi,F,100,58,0,58
Amirra,F,100,58,0,58
Anastasiya,F,100,58,0,58
Angla,F,100,58,0,58
Annalese,F,100,58,0,58
Aristides,M,100,0,58,58
Arlean,F,100,58,0,58
Ary,M,72,16,42,58
Aziya,F,100,58,0,58
Bradie,F,72,42,16,58
Braidon,M,100,0,58,58
Caedyn,M,88,7,51,58
Carvin,M,100,0,58,58
Chaundra,F,100,58,0,58
Chipper,M,100,0,58,58
Chrystina,F,100,58,0,58
Cieara,F,100,58,0,58
Cleotha,M,79,12,46,58
Cullan,M,100,0,58,58
Daylyn,M,55,26,32,58
Defne,F,100,58,0,58
Demarquis,M,100,0,58,58
Denay,F,100,58,0,58
Devlyn,M,59,24,34,58
Deyon,M,100,0,58,58
Duana,F,100,58,0,58
Dyron,M,100,0,58,58
Elis,F,52,30,28,58
Emin,M,100,0,58,58
Emya,F,100,58,0,58
Evah,F,100,58,0,58
Evren,M,100,0,58,58
Glorianna,F,100,58,0,58
Harlynn,F,100,58,0,58
Havilah,F,100,58,0,58
Haydan,M,67,19,39,58
Imad,M,100,0,58,58
Jamaar,M,100,0,58,58
Jamani,M,55,26,32,58
Jarah,F,100,58,0,58
Jassmine,F,100,58,0,58
Javell,M,100,0,58,58
Jawaun,M,100,0,58,58
Jazariah,F,100,58,0,58
Jeremaih,M,100,0,58,58
Johari,F,50,29,29,58
Jolin,F,71,41,17,58
Jquan,M,100,0,58,58
Kariana,F,100,58,0,58
Karole,F,100,58,0,58
Kelleigh,F,100,58,0,58
Kendi,F,100,58,0,58
Kennya,F,100,58,0,58
Kimia,F,100,58,0,58
Kingsten,M,100,0,58,58
Kisa,F,100,58,0,58
Konstantina,F,100,58,0,58
Kord,M,100,0,58,58
Kristoff,M,100,0,58,58
Lain,M,100,0,58,58
Lantz,M,100,0,58,58
Latishia,F,100,58,0,58
Latresa,F,100,58,0,58
Leesha,F,100,58,0,58
Lemont,M,100,0,58,58
Lexee,F,100,58,0,58
Lynnell,F,100,58,0,58
Madisynn,F,100,58,0,58
Maila,F,100,58,0,58
Majorie,F,100,58,0,58
Makynli,F,100,58,0,58
Malick,M,100,0,58,58
Malisha,F,100,58,0,58
Mayeli,F,100,58,0,58
Meklit,F,100,58,0,58
Melessa,F,100,58,0,58
Mellody,F,100,58,0,58
Mishael,M,79,12,46,58
Miyanna,F,100,58,0,58
Mizuki,F,90,52,6,58
Mohsin,M,100,0,58,58
Mustapha,M,100,0,58,58
Nalaya,F,100,58,0,58
Nasia,F,100,58,0,58
Natavia,F,100,58,0,58
Natoya,F,100,58,0,58
Naydelin,F,100,58,0,58
Nikeya,F,100,58,0,58
Nikkita,F,100,58,0,58
Nikkolas,M,100,0,58,58
Nizar,M,100,0,58,58
Olando,M,100,0,58,58
Otho,M,100,0,58,58
Paulene,F,100,58,0,58
Payslee,F,100,58,0,58
Paz,F,71,41,17,58
Raidyn,M,83,10,48,58
Raini,F,100,58,0,58
Raiven,F,100,58,0,58
Rajah,M,81,11,47,58
Rashun,M,91,5,53,58
Rifky,F,100,58,0,58
Roben,M,52,28,30,58
Roneisha,F,100,58,0,58
Roselia,F,100,58,0,58
Saidah,F,100,58,0,58
Saud,M,100,0,58,58
Saulo,M,100,0,58,58
Selia,F,100,58,0,58
Sendy,F,100,58,0,58
Shann,F,52,30,28,58
Shariff,M,100,0,58,58
Shariyah,F,100,58,0,58
Shaunice,F,100,58,0,58
Shayleen,F,100,58,0,58
Shelle,F,100,58,0,58
Sherrye,F,100,58,0,58
Shevon,F,100,58,0,58
Spiros,M,100,0,58,58
Tadhg,M,100,0,58,58
Talaysia,F,100,58,0,58
Tanijah,F,100,58,0,58
Taresa,F,100,58,0,58
Tashika,F,100,58,0,58
Terrelle,M,100,0,58,58
Tommaso,M,100,0,58,58
Turquoise,F,100,58,0,58
Tykia,F,100,58,0,58
Tymon,M,100,0,58,58
Uzair,M,100,0,58,58
Valecia,F,100,58,0,58
Vansh,M,100,0,58,58
Xian,M,78,13,45,58
Yee,M,62,22,36,58
Yeray,M,100,0,58,58
Zanyah,F,100,58,0,58
Adanna,F,100,57,0,57
Akshar,M,100,0,57,57
Aldrin,M,100,0,57,57
Alee,F,91,52,5,57
Aleiyah,F,100,57,0,57
Alishba,F,100,57,0,57
Amaar,M,100,0,57,57
Amarianna,F,100,57,0,57
Ambrosio,M,100,0,57,57
Amirrah,F,100,57,0,57
Aneta,F,100,57,0,57
Angell,F,91,52,5,57
Annelyse,F,100,57,0,57
Anvitha,F,100,57,0,57
Apolonia,F,100,57,0,57
Aricka,F,100,57,0,57
Arlon,M,100,0,57,57
Arna,F,100,57,0,57
Arshia,F,84,48,9,57
Artin,M,100,0,57,57
Arvil,M,100,0,57,57
Aryelle,F,100,57,0,57
Ascher,M,100,0,57,57
Ashira,F,100,57,0,57
Aviance,F,100,57,0,57
Aylee,F,100,57,0,57
Azeem,M,100,0,57,57
Bhavya,F,74,42,15,57
Bianey,F,100,57,0,57
Braddock,M,100,0,57,57
Brekken,M,100,0,57,57
Brewer,M,100,0,57,57
Brin,F,91,52,5,57
Calib,M,100,0,57,57
Charlea,F,100,57,0,57
Chevonne,F,100,57,0,57
Cira,F,100,57,0,57
Claiborne,M,100,0,57,57
Cristela,F,100,57,0,57
Cruise,M,100,0,57,57
Daena,F,100,57,0,57
Dallana,F,100,57,0,57
Damarian,M,100,0,57,57
Damin,M,100,0,57,57
Dashawna,F,100,57,0,57
Dat,M,100,0,57,57
Delanee,F,100,57,0,57
Delwyn,M,100,0,57,57
Demetrus,M,100,0,57,57
Deniyah,F,100,57,0,57
Donathan,M,100,0,57,57
Donzella,F,100,57,0,57
Dorrian,M,100,0,57,57
Dryden,M,100,0,57,57
Eberardo,M,100,0,57,57
Elika,F,100,57,0,57
Emran,M,100,0,57,57
Enrrique,M,100,0,57,57
Eoghan,M,100,0,57,57
Ezriel,M,100,0,57,57
Georg,M,100,0,57,57
Gianina,F,100,57,0,57
Giulio,M,100,0,57,57
Hadia,F,100,57,0,57
Hanh,F,91,52,5,57
Haze,M,100,0,57,57
Hebert,M,100,0,57,57
Hermes,M,100,0,57,57
Hunner,M,100,0,57,57
Ikechukwu,M,100,0,57,57
Ilijah,M,100,0,57,57
Indica,F,100,57,0,57
Isabeau,F,100,57,0,57
Ishana,F,100,57,0,57
Jaala,F,100,57,0,57
Jacarri,M,100,0,57,57
Jadzia,F,100,57,0,57
Jalaysia,F,100,57,0,57
Jamian,M,100,0,57,57
Jamiee,F,100,57,0,57
Janece,F,100,57,0,57
Janne,F,100,57,0,57
Janny,F,100,57,0,57
Jaziya,F,100,57,0,57
Jerre,M,72,16,41,57
Jhoan,M,100,0,57,57
Jimmey,M,100,0,57,57
Johnston,M,100,0,57,57
Joley,F,100,57,0,57
Josedejesus,M,100,0,57,57
Junie,F,100,57,0,57
Kaelah,F,100,57,0,57
Kaizen,M,100,0,57,57
Kalley,F,100,57,0,57
Kaniah,F,100,57,0,57
Kanya,F,100,57,0,57
Keairra,F,100,57,0,57
Keefer,M,100,0,57,57
Kellyanne,F,100,57,0,57
Kemuel,M,100,0,57,57
Keola,M,100,0,57,57
Kevontae,M,100,0,57,57
Laasya,F,100,57,0,57
Lamanda,F,100,57,0,57
Leeya,F,100,57,0,57
Leina,F,100,57,0,57
Leslieann,F,100,57,0,57
Madasyn,F,100,57,0,57
Maxamillion,M,100,0,57,57
Mehreen,F,100,57,0,57
Mone,F,100,57,0,57
Monzerrat,F,100,57,0,57
Nadina,F,100,57,0,57
Nami,F,100,57,0,57
Natally,F,100,57,0,57
Nayan,M,100,0,57,57
Naylah,F,100,57,0,57
Netta,F,100,57,0,57
Nikolette,F,100,57,0,57
Nishan,M,100,0,57,57
Norvell,M,100,0,57,57
Nyelle,F,100,57,0,57
Nyra,F,100,57,0,57
Onika,F,100,57,0,57
Orlin,M,100,0,57,57
Paiten,F,100,57,0,57
Rayma,F,100,57,0,57
Rayon,M,91,5,52,57
Reeva,F,100,57,0,57
Renelle,F,100,57,0,57
Rochele,F,100,57,0,57
Rody,M,100,0,57,57
Sameerah,F,100,57,0,57
Sanda,F,100,57,0,57
Satori,F,91,52,5,57
Shaliyah,F,100,57,0,57
Sharday,F,100,57,0,57
Shawntell,F,100,57,0,57
Shelba,F,100,57,0,57
Shereka,F,100,57,0,57
Solimar,F,100,57,0,57
Sophee,F,100,57,0,57
Srinidhi,F,100,57,0,57
Stephnie,F,100,57,0,57
Taber,M,91,5,52,57
Tajae,F,53,30,27,57
Tamarcus,M,100,0,57,57
Tatia,F,100,57,0,57
Tiasia,F,100,57,0,57
Tiauna,F,100,57,0,57
Timara,F,100,57,0,57
Timesha,F,100,57,0,57
Townsend,M,100,0,57,57
Trenise,F,100,57,0,57
Tristain,M,100,0,57,57
Tyliyah,F,100,57,0,57
Tyric,M,100,0,57,57
Undra,M,82,10,47,57
Vadim,M,100,0,57,57
Vester,M,88,7,50,57
Vikas,M,100,0,57,57
Whitnee,F,100,57,0,57
Yannis,M,65,20,37,57
Zaylon,M,100,0,57,57
Zohaib,M,100,0,57,57
Adrik,M,100,0,56,56
Aeriana,F,100,56,0,56
Allysson,F,100,56,0,56
Anahita,F,100,56,0,56
Ananias,M,100,0,56,56
Aryiah,F,100,56,0,56
Arynn,F,100,56,0,56
Asani,F,68,38,18,56
Atlanta,F,100,56,0,56
Ayanah,F,100,56,0,56
Baylei,F,100,56,0,56
Bayler,M,73,15,41,56
Bevan,M,88,7,49,56
Briane,F,71,40,16,56
Briceida,F,100,56,0,56
Bridgid,F,100,56,0,56
Brittanny,F,100,56,0,56
Carlen,F,84,47,9,56
Cartez,M,100,0,56,56
Ceirra,F,100,56,0,56
Chau,F,100,56,0,56
Cherith,F,100,56,0,56
Chery,F,100,56,0,56
Colbey,M,100,0,56,56
Crystina,F,100,56,0,56
Cydni,F,100,56,0,56
Daisie,F,100,56,0,56
Davine,F,75,42,14,56
Delmy,F,100,56,0,56
Denika,F,100,56,0,56
Deshay,F,59,33,23,56
Dhara,F,100,56,0,56
Dhriti,F,100,56,0,56
Diantha,F,100,56,0,56
Dillinger,M,100,0,56,56
Dove,F,100,56,0,56
Dyane,F,100,56,0,56
Elim,M,57,24,32,56
Elleanor,F,100,56,0,56
Emanual,M,100,0,56,56
Emmelia,F,100,56,0,56
Emon,M,79,12,44,56
Estel,M,82,10,46,56
Eyvonne,F,100,56,0,56
Fintan,M,100,0,56,56
Garion,M,100,0,56,56
Gavon,M,100,0,56,56
Giavana,F,100,56,0,56
Hashem,M,100,0,56,56
Hasini,F,100,56,0,56
Heith,M,100,0,56,56
Ihsan,M,100,0,56,56
Ishaq,M,100,0,56,56
Jadarian,M,100,0,56,56
Jalee,F,100,56,0,56
Janissa,F,100,56,0,56
Jaquel,M,64,20,36,56
Jasline,F,100,56,0,56
Jeannene,F,100,56,0,56
Jeannett,F,100,56,0,56
Jemar,M,100,0,56,56
Jenel,F,100,56,0,56
Jennavecia,F,100,56,0,56
Johnae,F,100,56,0,56
Jurgen,M,100,0,56,56
Jyaire,M,100,0,56,56
Kadija,F,100,56,0,56
Kadijah,F,100,56,0,56
Kaleem,M,100,0,56,56
Kaleyah,F,100,56,0,56
Kalilah,F,100,56,0,56
Karene,F,100,56,0,56
Katalaya,F,100,56,0,56
Katiria,F,100,56,0,56
Katriel,F,82,46,10,56
Kayse,F,100,56,0,56
Kaytee,F,100,56,0,56
Kedar,M,100,0,56,56
Keiron,M,100,0,56,56
Keirstin,F,100,56,0,56
Kemora,F,100,56,0,56
Kennetha,F,100,56,0,56
Kerem,M,100,0,56,56
Keygan,M,100,0,56,56
Laketa,F,100,56,0,56
Lamari,M,62,21,35,56
Lannette,F,100,56,0,56
Laquinton,M,100,0,56,56
Lauree,F,100,56,0,56
Ledarius,M,100,0,56,56
Li,M,54,26,30,56
Locklyn,F,91,51,5,56
Logun,M,100,0,56,56
Loleta,F,100,56,0,56
Louden,M,100,0,56,56
Loura,F,100,56,0,56
Lyncoln,M,62,21,35,56
Lyon,M,100,0,56,56
Maaz,M,100,0,56,56
Maimouna,F,100,56,0,56
Mala,F,100,56,0,56
Mayli,F,100,56,0,56
Meggie,F,100,56,0,56
Melayna,F,100,56,0,56
Merary,F,100,56,0,56
Merl,M,100,0,56,56
Mikiah,F,70,39,17,56
Mitra,F,100,56,0,56
Myson,M,100,0,56,56
Namon,M,100,0,56,56
Nevayah,F,100,56,0,56
Nickalus,M,100,0,56,56
Nirav,M,100,0,56,56
Nivia,F,100,56,0,56
Paysen,F,73,41,15,56
Pola,F,100,56,0,56
Precilla,F,100,56,0,56
Primo,M,100,0,56,56
Quamir,M,100,0,56,56
Quanita,F,100,56,0,56
Quinley,F,100,56,0,56
Rahil,M,100,0,56,56
Ralston,M,100,0,56,56
Redmond,M,100,0,56,56
Reshma,F,100,56,0,56
Reyanna,F,100,56,0,56
Rielly,M,57,24,32,56
Rithik,M,100,0,56,56
Rosaly,F,100,56,0,56
Roshell,F,100,56,0,56
Rosilyn,F,100,56,0,56
Roxi,F,100,56,0,56
Salih,M,100,0,56,56
Scotti,F,66,37,19,56
Sebastain,M,100,0,56,56
Semira,F,100,56,0,56
Shanley,F,100,56,0,56
Sheilla,F,100,56,0,56
Shirelle,F,100,56,0,56
Shloime,M,100,0,56,56
Shraga,M,100,0,56,56
Shunda,F,100,56,0,56
Silva,F,100,56,0,56
Sueanne,F,100,56,0,56
Syniah,F,100,56,0,56
Taia,F,100,56,0,56
Takeya,F,100,56,0,56
Tallie,F,100,56,0,56
Tameca,F,100,56,0,56
Tatjana,F,100,56,0,56
Teghan,F,84,47,9,56
Terika,F,100,56,0,56
Termaine,M,91,5,51,56
Thorne,M,100,0,56,56
Tigran,M,100,0,56,56
Tinlee,F,100,56,0,56
Tonyia,F,100,56,0,56
Torah,F,100,56,0,56
Torrian,M,100,0,56,56
Tramel,M,100,0,56,56
Tyronda,F,100,56,0,56
Vashon,M,100,0,56,56
Verlyn,M,75,14,42,56
Victorya,F,100,56,0,56
Xiana,F,100,56,0,56
Yareni,F,100,56,0,56
Yetta,F,100,56,0,56
Yordi,M,100,0,56,56
Yossi,M,100,0,56,56
Yui,F,100,56,0,56
Yuliza,F,100,56,0,56
Yuvan,M,100,0,56,56
Zaelyn,M,52,27,29,56
Zaidan,M,100,0,56,56
Zalman,M,100,0,56,56
Aamiyah,F,100,55,0,55
Abdulla,M,100,0,55,55
Acen,M,100,0,55,55
Adelbert,M,100,0,55,55
Adlai,M,84,9,46,55
Affan,M,100,0,55,55
Akiyah,F,100,55,0,55
Alease,F,100,55,0,55
Alegandro,M,100,0,55,55
Alegra,F,100,55,0,55
Alexiss,F,100,55,0,55
Alexiz,M,58,23,32,55
Allayna,F,100,55,0,55
Allyana,F,100,55,0,55
Allysen,F,100,55,0,55
Amandeep,M,62,21,34,55
Amour,F,85,47,8,55
Analis,F,100,55,0,55
Analynn,F,100,55,0,55
Andrews,M,100,0,55,55
Ashleen,F,100,55,0,55
Aureliano,M,100,0,55,55
Auther,M,100,0,55,55
Ayiana,F,100,55,0,55
Baili,F,100,55,0,55
Bassam,M,100,0,55,55
Berenise,F,100,55,0,55
Bethlehem,F,100,55,0,55
Beverlyn,F,100,55,0,55
Bodi,M,100,0,55,55
Branch,M,100,0,55,55
Breezy,F,100,55,0,55
Bronte,F,91,50,5,55
Bruna,F,100,55,0,55
Cephus,M,100,0,55,55
Chadley,M,100,0,55,55
Chaquita,F,100,55,0,55
Charish,F,100,55,0,55
Chrislynn,F,100,55,0,55
Clairissa,F,100,55,0,55
Corianna,F,100,55,0,55
Cotton,M,100,0,55,55
Courtny,F,100,55,0,55
Crystall,F,100,55,0,55
Dalis,F,91,50,5,55
Damyan,M,100,0,55,55
Danea,F,100,55,0,55
Dareen,F,91,50,5,55
Dariya,F,100,55,0,55
Darlyne,F,100,55,0,55
Dawsen,M,100,0,55,55
Delorse,F,100,55,0,55
Denasia,F,100,55,0,55
Derika,F,100,55,0,55
Desiderio,M,100,0,55,55
Dhilan,M,100,0,55,55
Dickey,M,100,0,55,55
Donatello,M,100,0,55,55
Donyae,F,53,29,26,55
Dymon,F,82,45,10,55
Ebrahim,M,100,0,55,55
Edel,M,100,0,55,55
Elesha,F,100,55,0,55
Eliane,F,100,55,0,55
Emerick,M,100,0,55,55
Ericca,F,100,55,0,55
Erving,M,100,0,55,55
Friedrich,M,100,0,55,55
Giannah,F,100,55,0,55
Glyn,M,100,0,55,55
Grafton,M,100,0,55,55
Ibeth,F,100,55,0,55
Ilena,F,100,55,0,55
Inge,F,100,55,0,55
Inna,F,100,55,0,55
Jaaziel,M,100,0,55,55
Jairon,M,100,0,55,55
Jakayden,M,100,0,55,55
Jaleigha,F,100,55,0,55
Jamaris,M,73,15,40,55
Janelis,F,100,55,0,55
Jaylenn,M,51,27,28,55
Jayli,F,100,55,0,55
Jessejames,M,100,0,55,55
Jessicca,F,100,55,0,55
Jihan,F,91,50,5,55
Jorell,M,100,0,55,55
Juda,M,73,15,40,55
Junaid,M,100,0,55,55
Junia,F,100,55,0,55
Kaidynce,F,100,55,0,55
Kaleel,M,100,0,55,55
Kandee,F,100,55,0,55
Karmella,F,100,55,0,55
Kayelynn,F,100,55,0,55
Keirah,F,100,55,0,55
Kenyada,F,87,48,7,55
Kinnley,F,100,55,0,55
Kolson,M,100,0,55,55
Kutter,M,100,0,55,55
Lala,F,100,55,0,55
Lamiah,F,100,55,0,55
Lanai,F,100,55,0,55
Larina,F,100,55,0,55
Lashonna,F,100,55,0,55
Lateasha,F,100,55,0,55
Latif,M,100,0,55,55
Laveda,F,100,55,0,55
Lawernce,M,100,0,55,55
Leilana,F,100,55,0,55
Lemarcus,M,100,0,55,55
Lissete,F,100,55,0,55
Lorriane,F,100,55,0,55
Loukas,M,100,0,55,55
Lundon,F,76,42,13,55
Maeli,F,100,55,0,55
Malakye,M,100,0,55,55
Malichi,M,100,0,55,55
Maree,F,100,55,0,55
Margherita,F,100,55,0,55
Marlinda,F,100,55,0,55
Marney,F,100,55,0,55
Matia,F,91,50,5,55
Maybelline,F,100,55,0,55
Mechell,F,100,55,0,55
Mersadies,F,100,55,0,55
Milka,F,100,55,0,55
Mirabel,F,100,55,0,55
Mystique,F,100,55,0,55
Naeemah,F,100,55,0,55
Nakya,F,100,55,0,55
Nance,F,100,55,0,55
Nathania,F,100,55,0,55
Nichalos,M,100,0,55,55
Nicholi,M,100,0,55,55
Nykeria,F,100,55,0,55
Olivya,F,100,55,0,55
Oluwademilade,M,62,21,34,55
Parke,M,100,0,55,55
Paulett,F,100,55,0,55
Ramiya,F,100,55,0,55
Raniah,F,100,55,0,55
Rickard,M,100,0,55,55
Riku,M,100,0,55,55
Ritu,F,100,55,0,55
Robet,M,100,0,55,55
Rosevelt,M,100,0,55,55
Rue,F,89,49,6,55
Saadia,F,100,55,0,55
Sadaf,F,100,55,0,55
Saran,F,91,50,5,55
Sareena,F,100,55,0,55
Sergei,M,100,0,55,55
Shailynn,F,100,55,0,55
Shaira,F,100,55,0,55
Shakila,F,100,55,0,55
Shaneeka,F,100,55,0,55
Sharena,F,100,55,0,55
Sharlette,F,100,55,0,55
Sheina,F,100,55,0,55
Shelagh,F,100,55,0,55
Sonji,F,100,55,0,55
Srinika,F,100,55,0,55
Stiles,M,100,0,55,55
Talyah,F,100,55,0,55
Tamim,M,100,0,55,55
Tanasha,F,100,55,0,55
Tanda,F,100,55,0,55
Taneesha,F,100,55,0,55
Tarence,M,100,0,55,55
Tashi,F,85,47,8,55
Teesha,F,100,55,0,55
Temiloluwa,F,56,31,24,55
Tenna,F,100,55,0,55
Terril,M,75,14,41,55
Timofey,M,100,0,55,55
Trebor,M,100,0,55,55
Trevell,M,100,0,55,55
Tyiesha,F,100,55,0,55
Valisha,F,100,55,0,55
Vella,F,100,55,0,55
Vergie,F,100,55,0,55
Vinita,F,100,55,0,55
Waynette,F,100,55,0,55
Weslie,F,55,30,25,55
Yaira,F,100,55,0,55
Yaiza,F,100,55,0,55
Yazmeen,F,100,55,0,55
Zadyn,M,100,0,55,55
Zakira,F,100,55,0,55
Ziara,F,100,55,0,55
Zymere,M,100,0,55,55
Aadit,M,100,0,54,54
Aaminah,F,100,54,0,54
Aariyah,F,100,54,0,54
Abdoul,M,100,0,54,54
Adonnis,M,100,0,54,54
Agustine,M,100,0,54,54
Ahaan,M,100,0,54,54
Aidon,M,100,0,54,54
Aishani,F,100,54,0,54
Alanni,F,100,54,0,54
Alexandr,M,100,0,54,54
Amariya,F,100,54,0,54
Andreus,M,100,0,54,54
Anshul,M,100,0,54,54
Aracelia,F,100,54,0,54
Areej,F,100,54,0,54
Arizbeth,F,100,54,0,54
Arnez,M,100,0,54,54
Arsen,M,100,0,54,54
Ashle,F,100,54,0,54
Aubryana,F,100,54,0,54
Axcel,M,100,0,54,54
Banesa,F,100,54,0,54
Becker,M,100,0,54,54
Braydn,M,100,0,54,54
Brihana,F,100,54,0,54
Caedon,M,100,0,54,54
Celestia,F,100,54,0,54
Chavy,F,100,54,0,54
Chelsae,F,100,54,0,54
Cherell,F,100,54,0,54
Cheskel,M,100,0,54,54
Chyler,F,81,44,10,54
Cyd,F,100,54,0,54
Daisia,F,100,54,0,54
Damauri,M,100,0,54,54
Danel,M,56,24,30,54
Danney,M,91,5,49,54
Darcell,F,76,41,13,54
Daymien,M,100,0,54,54
Devansh,M,100,0,54,54
Diavian,F,91,49,5,54
Donold,M,100,0,54,54
Dontaye,M,100,0,54,54
Duan,M,100,0,54,54
Durwin,M,100,0,54,54
Elane,F,100,54,0,54
Elijio,M,100,0,54,54
Elita,F,100,54,0,54
Essa,M,100,0,54,54
Everlyn,F,100,54,0,54
Franciso,M,100,0,54,54
Gaylan,M,76,13,41,54
Genessa,F,100,54,0,54
Ghassan,M,100,0,54,54
Grabiel,M,100,0,54,54
Grabiela,F,100,54,0,54
Guthrie,M,100,0,54,54
Halimah,F,100,54,0,54
Harlo,F,78,42,12,54
Helina,F,100,54,0,54
Hilliard,M,100,0,54,54
Iban,M,100,0,54,54
Ifeoluwa,F,70,38,16,54
Illeana,F,100,54,0,54
Ivyana,F,100,54,0,54
Iyanla,F,100,54,0,54
Izabellah,F,100,54,0,54
Jabar,M,100,0,54,54
Jacquiline,F,100,54,0,54
Jakiah,F,91,49,5,54
Jamella,F,100,54,0,54
Jamire,M,100,0,54,54
Janneth,F,100,54,0,54
Jasin,M,100,0,54,54
Javarious,M,100,0,54,54
Javid,M,100,0,54,54
Javoris,M,100,0,54,54
Jaxtin,M,100,0,54,54
Jaydence,F,52,28,26,54
Jeniyah,F,100,54,0,54
Jenne,F,100,54,0,54
Jeramey,M,100,0,54,54
Jeren,M,100,0,54,54
Jerren,M,100,0,54,54
Jozette,F,100,54,0,54
Kaheem,M,100,0,54,54
Kamon,M,100,0,54,54
Karenna,F,100,54,0,54
Kashvi,F,100,54,0,54
Kayonna,F,100,54,0,54
Kearsten,F,100,54,0,54
Keilana,F,100,54,0,54
Keiley,F,100,54,0,54
Kemiyah,F,100,54,0,54
Kendre,M,81,10,44,54
Keno,M,100,0,54,54
Kenyah,F,100,54,0,54
Keone,M,100,0,54,54
Kilah,F,100,54,0,54
Kimoni,F,54,29,25,54
Klee,F,100,54,0,54
Komal,F,100,54,0,54
Kwaku,M,100,0,54,54
Kyanne,F,100,54,0,54
Kypton,M,100,0,54,54
Ladena,F,100,54,0,54
Laia,F,100,54,0,54
Lanah,F,100,54,0,54
Laquandra,F,100,54,0,54
Linken,M,100,0,54,54
Lynnda,F,100,54,0,54
Madalin,F,100,54,0,54
Mahika,F,100,54,0,54
Makoto,M,100,0,54,54
Maleka,F,100,54,0,54
Malyssa,F,100,54,0,54
Manahil,F,100,54,0,54
Manasseh,M,100,0,54,54
Marland,M,100,0,54,54
Marlenne,F,100,54,0,54
Marvina,F,100,54,0,54
Maylynn,F,100,54,0,54
Megyn,F,100,54,0,54
Merisa,F,100,54,0,54
Meylin,F,100,54,0,54
Mickaela,F,100,54,0,54
Mikiyah,F,100,54,0,54
Mirah,F,100,54,0,54
Monay,F,100,54,0,54
Mozell,F,63,34,20,54
Mushka,F,100,54,0,54
Naftuli,M,100,0,54,54
Nataliah,F,100,54,0,54
Nature,F,76,41,13,54
Nikka,F,100,54,0,54
Nolin,M,100,0,54,54
Ociel,M,100,0,54,54
Oracio,M,100,0,54,54
Orland,M,100,0,54,54
Osmin,M,100,0,54,54
Ousmane,M,100,0,54,54
Paulita,F,100,54,0,54
Rael,F,52,28,26,54
Raeleen,F,100,54,0,54
Raeya,F,100,54,0,54
Raheen,M,100,0,54,54
Rakesh,M,100,0,54,54
Ramell,M,100,0,54,54
Raymund,M,100,0,54,54
Ridwan,M,100,0,54,54
Rosamond,F,100,54,0,54
Saima,F,100,54,0,54
Sakari,F,85,46,8,54
Sanam,F,100,54,0,54
Sarafina,F,100,54,0,54
Satvik,M,100,0,54,54
Shabnam,F,100,54,0,54
Shantee,F,100,54,0,54
Shazia,F,100,54,0,54
Siddarth,M,100,0,54,54
Sigourney,F,100,54,0,54
Socrates,M,100,0,54,54
Sonda,F,100,54,0,54
Sotero,M,100,0,54,54
Sruthi,F,100,54,0,54
Stacye,F,100,54,0,54
Styles,M,100,0,54,54
Suhail,M,87,7,47,54
Suki,F,100,54,0,54
Susi,F,100,54,0,54
Tacara,F,100,54,0,54
Taijah,F,100,54,0,54
Tangi,F,100,54,0,54
Terez,M,81,10,44,54
Tharon,M,89,6,48,54
Thunder,M,100,0,54,54
Thyra,F,100,54,0,54
Tiarah,F,100,54,0,54
Timothey,M,100,0,54,54
Tinleigh,F,100,54,0,54
Tomasita,F,100,54,0,54
Tomica,F,100,54,0,54
Travaris,M,100,0,54,54
Travonte,M,100,0,54,54
Trenell,M,59,22,32,54
Treyon,M,100,0,54,54
Tyden,M,100,0,54,54
Tyheem,M,100,0,54,54
Tylisha,F,100,54,0,54
Tylynn,F,89,48,6,54
Tyreik,M,100,0,54,54
Umair,M,100,0,54,54
Venetta,F,100,54,0,54
Vianka,F,100,54,0,54
Winson,M,100,0,54,54
Yanelli,F,100,54,0,54
Yanina,F,100,54,0,54
Yanna,F,100,54,0,54
Yezenia,F,100,54,0,54
Yoshua,M,100,0,54,54
Yuritzy,F,100,54,0,54
Yvetta,F,100,54,0,54
Zakee,M,100,0,54,54
Zarriah,F,100,54,0,54
Zarya,F,100,54,0,54
Zoraya,F,100,54,0,54
Abcde,F,100,53,0,53
Abeni,F,100,53,0,53
Aishia,F,100,53,0,53
Aiyanah,F,100,53,0,53
Aleda,F,100,53,0,53
Aleister,M,100,0,53,53
Alfonse,M,100,0,53,53
Alitza,F,100,53,0,53
Angelyna,F,100,53,0,53
Anjolie,F,100,53,0,53
Annaclaire,F,100,53,0,53
Annaleise,F,100,53,0,53
Annora,F,100,53,0,53
Antoniette,F,100,53,0,53
Any,F,100,53,0,53
Apollonia,F,100,53,0,53
Artemus,M,100,0,53,53
Athony,M,100,0,53,53
Avel,M,100,0,53,53
Avyan,M,100,0,53,53
Balian,M,100,0,53,53
Banner,M,91,5,48,53
Bradan,M,100,0,53,53
Braeleigh,F,100,53,0,53
Braycen,M,100,0,53,53
Brittin,F,81,43,10,53
Caige,M,100,0,53,53
Calise,F,100,53,0,53
Calogero,M,100,0,53,53
Ceira,F,100,53,0,53
Celestial,F,100,53,0,53
Chardae,F,100,53,0,53
Charnita,F,100,53,0,53
Chaun,M,100,0,53,53
Chianne,F,100,53,0,53
Choua,F,70,37,16,53
Claritza,F,100,53,0,53
Cully,M,100,0,53,53
Cylee,F,100,53,0,53
Daelen,M,100,0,53,53
Dalya,F,100,53,0,53
Danyla,F,100,53,0,53
Daquon,M,100,0,53,53
Darcia,F,100,53,0,53
Davetta,F,100,53,0,53
Dayja,F,100,53,0,53
Daylee,F,100,53,0,53
Dericka,F,100,53,0,53
Derrill,M,100,0,53,53
Deziyah,F,100,53,0,53
Dominico,M,100,0,53,53
Donnalee,F,100,53,0,53
Dugan,M,100,0,53,53
Earleen,F,100,53,0,53
Eleena,F,100,53,0,53
Eleuterio,M,100,0,53,53
Ellijah,M,100,0,53,53
Elvera,F,100,53,0,53
Elvie,F,58,31,22,53
Elya,M,57,23,30,53
Emiya,F,100,53,0,53
Eniya,F,100,53,0,53
Evee,F,100,53,0,53
Exodus,M,68,17,36,53
Eydie,F,100,53,0,53
Eytan,M,100,0,53,53
Gaius,M,100,0,53,53
Gauri,F,100,53,0,53
Gean,M,64,19,34,53
Genea,F,100,53,0,53
Geordan,M,91,5,48,53
Giani,M,55,24,29,53
Gilford,M,100,0,53,53
Gregery,M,100,0,53,53
Gregoria,F,100,53,0,53
Hyacinth,F,100,53,0,53
Ilyanna,F,100,53,0,53
Imara,F,100,53,0,53
Inell,F,100,53,0,53
Isys,F,100,53,0,53
Ivee,F,100,53,0,53
Ivor,M,100,0,53,53
Jakarri,M,100,0,53,53
Jalecia,F,100,53,0,53
Jayani,F,100,53,0,53
Jeilyn,F,100,53,0,53
Jeovany,M,100,0,53,53
Jericka,F,100,53,0,53
Jermichael,M,100,0,53,53
Jessia,F,100,53,0,53
Jewelz,F,70,37,16,53
Jisel,F,100,53,0,53
Joanthan,M,100,0,53,53
Johnanthony,M,100,0,53,53
Johnluke,M,100,0,53,53
Juleen,F,100,53,0,53
Kadiatou,F,100,53,0,53
Kahealani,F,100,53,0,53
Kaige,M,100,0,53,53
Kamaree,M,60,21,32,53
Kassius,M,100,0,53,53
Kelvon,M,100,0,53,53
Keria,F,100,53,0,53
Keyasia,F,100,53,0,53
Kimara,F,100,53,0,53
Kort,M,100,0,53,53
Kristyne,F,100,53,0,53
Krizia,F,100,53,0,53
Kylor,M,100,0,53,53
Kynslie,F,100,53,0,53
Lakeith,M,100,0,53,53
Lando,M,100,0,53,53
Laretta,F,100,53,0,53
Latorya,F,100,53,0,53
Laurena,F,100,53,0,53
Lenee,F,100,53,0,53
Lennix,M,64,19,34,53
Lizmarie,F,100,53,0,53
Lorianna,F,100,53,0,53
Macoy,M,100,0,53,53
Madhav,M,100,0,53,53
Makaylin,F,100,53,0,53
Maks,M,100,0,53,53
Mart,M,100,0,53,53
Meron,F,100,53,0,53
Michaiah,F,83,44,9,53
Michiko,F,100,53,0,53
Missael,M,100,0,53,53
Murl,M,100,0,53,53
Myrtice,F,100,53,0,53
Nani,F,100,53,0,53
Naylani,F,100,53,0,53
Noni,F,100,53,0,53
Oluwadamilola,F,72,38,15,53
Orli,F,100,53,0,53
Palmira,F,100,53,0,53
Panagiota,F,100,53,0,53
Pavan,M,100,0,53,53
Perian,F,100,53,0,53
Perrion,M,100,0,53,53
Philbert,M,100,0,53,53
Pranay,M,100,0,53,53
Prem,M,100,0,53,53
Quamaine,M,100,0,53,53
Quindarius,M,100,0,53,53
Raiza,F,100,53,0,53
Ramiah,F,100,53,0,53
Rickia,F,100,53,0,53
Rithika,F,100,53,0,53
Ruba,F,100,53,0,53
Sabrine,F,100,53,0,53
Sadye,F,100,53,0,53
Seann,M,100,0,53,53
Sesar,M,100,0,53,53
Sharissa,F,100,53,0,53
Shelbee,F,100,53,0,53
Shellia,F,100,53,0,53
Sherif,M,100,0,53,53
Sherria,F,100,53,0,53
Siddhartha,M,100,0,53,53
Simmie,M,81,10,43,53
Stephano,M,100,0,53,53
Suann,F,100,53,0,53
Suhaib,M,100,0,53,53
Syerra,F,100,53,0,53
Syon,M,100,0,53,53
Syretta,F,100,53,0,53
Tahari,F,66,35,18,53
Tandi,F,100,53,0,53
Tashauna,F,100,53,0,53
Taysia,F,100,53,0,53
Terrian,M,100,0,53,53
Terriann,F,100,53,0,53
Terrianna,F,100,53,0,53
Thelonious,M,100,0,53,53
Tiahna,F,100,53,0,53
Travelle,M,100,0,53,53
Trigg,M,100,0,53,53
Trisa,F,100,53,0,53
Tylie,F,100,53,0,53
Unity,F,100,53,0,53
Vraj,M,100,0,53,53
Wendelyn,F,100,53,0,53
Zackaria,M,100,0,53,53
Zanna,F,100,53,0,53
Zephan,M,100,0,53,53
Adithi,F,100,52,0,52
Advait,M,100,0,52,52
Ahad,M,100,0,52,52
Akbar,M,100,0,52,52
Akiya,F,100,52,0,52
Akshita,F,100,52,0,52
Alexxus,F,100,52,0,52
Alonte,M,88,6,46,52
Alysen,F,100,52,0,52
Amye,F,100,52,0,52
Analilia,F,100,52,0,52
Andrik,M,100,0,52,52
Anjeanette,F,100,52,0,52
Anni,F,100,52,0,52
Antwine,M,100,0,52,52
Ariany,F,100,52,0,52
Armandina,F,100,52,0,52
Ashar,M,100,0,52,52
Ashford,M,100,0,52,52
Audi,F,54,28,24,52
Avanti,F,90,47,5,52
Avrum,M,100,0,52,52
Bader,M,100,0,52,52
Baldwin,M,100,0,52,52
Bre,F,100,52,0,52
Breianna,F,100,52,0,52
Brek,M,100,0,52,52
Brigett,F,100,52,0,52
Bryley,F,90,47,5,52
Bunnie,F,100,52,0,52
Caelum,M,100,0,52,52
Cala,F,100,52,0,52
Calab,M,100,0,52,52
Camrie,F,100,52,0,52
Carder,M,100,0,52,52
Carine,F,100,52,0,52
Chalice,F,100,52,0,52
Charbel,M,100,0,52,52
Cherrell,F,100,52,0,52
Copper,M,71,15,37,52
Cynitha,F,100,52,0,52
Dalaney,F,100,52,0,52
Dametrius,M,100,0,52,52
Daphane,F,100,52,0,52
Daphanie,F,100,52,0,52
Dawanna,F,100,52,0,52
Deaja,F,100,52,0,52
Deisi,F,100,52,0,52
Desma,F,100,52,0,52
Devonn,M,88,6,46,52
Dexton,M,100,0,52,52
Diallo,M,100,0,52,52
Dickson,M,100,0,52,52
Dmitriy,M,100,0,52,52
Doc,M,100,0,52,52
Einar,M,100,0,52,52
Eldin,M,100,0,52,52
Ellieana,F,100,52,0,52
Emitt,M,100,0,52,52
Ericia,F,100,52,0,52
Erionna,F,100,52,0,52
Esma,F,100,52,0,52
Euan,M,100,0,52,52
Ezmeralda,F,100,52,0,52
Favor,F,90,47,5,52
Fredie,M,100,0,52,52
Gaile,F,100,52,0,52
Gerianne,F,100,52,0,52
Gillermo,M,100,0,52,52
Grason,M,100,0,52,52
Griffyn,M,88,6,46,52
Havanna,F,100,52,0,52
Hays,M,100,0,52,52
Ilhan,F,73,38,14,52
Jadira,F,100,52,0,52
Jaelynne,F,100,52,0,52
Jahnavi,F,100,52,0,52
Jakori,M,100,0,52,52
Janeli,F,100,52,0,52
Jasani,F,65,34,18,52
Jassiel,M,100,0,52,52
Jeena,F,100,52,0,52
Jema,F,100,52,0,52
Jessamine,F,100,52,0,52
Jewelia,F,100,52,0,52
Ji,F,63,33,19,52
Jil,F,100,52,0,52
Johnita,F,100,52,0,52
Jone,F,100,52,0,52
Josetta,F,100,52,0,52
Joshwa,M,100,0,52,52
Jovannie,M,90,5,47,52
Joylyn,F,100,52,0,52
Judea,F,75,39,13,52
Kaeo,M,100,0,52,52
Kaetlyn,F,100,52,0,52
Kainalu,M,100,0,52,52
Kamdin,M,100,0,52,52
Kanye,M,100,0,52,52
Karlynn,F,100,52,0,52
Katalin,F,100,52,0,52
Katrinia,F,100,52,0,52
Kaylamarie,F,100,52,0,52
Kaylina,F,100,52,0,52
Kayly,F,100,52,0,52
Kearston,F,100,52,0,52
Khiara,F,100,52,0,52
Kier,M,88,6,46,52
Kolston,M,100,0,52,52
Krzysztof,M,100,0,52,52
Kyland,M,100,0,52,52
Lakai,M,88,6,46,52
Laresa,F,100,52,0,52
Latika,F,100,52,0,52
Lezly,F,100,52,0,52
Liann,F,100,52,0,52
Loriana,F,100,52,0,52
Machell,F,100,52,0,52
Macsen,M,100,0,52,52
Madie,F,100,52,0,52
Makeyla,F,100,52,0,52
Maleeya,F,100,52,0,52
Mar,F,60,31,21,52
Maressa,F,100,52,0,52
Maricel,F,100,52,0,52
Marionna,F,100,52,0,52
Masiyah,F,69,36,16,52
Meribeth,F,100,52,0,52
Merinda,F,100,52,0,52
Mirtha,F,100,52,0,52
Mohit,M,100,0,52,52
Montrez,M,100,0,52,52
Muhsin,M,100,0,52,52
Mysha,F,100,52,0,52
Nariya,F,100,52,0,52
Nayelis,F,100,52,0,52
Naylea,F,100,52,0,52
Ndeye,F,100,52,0,52
Neala,F,100,52,0,52
Neyland,M,100,0,52,52
Niva,F,100,52,0,52
Oakland,M,83,9,43,52
Oaklyn,F,83,43,9,52
Ojas,M,100,0,52,52
Onesimo,M,100,0,52,52
Peyson,F,52,27,25,52
Prynce,M,100,0,52,52
Purvis,M,100,0,52,52
Raeghan,F,100,52,0,52
Ralphael,M,100,0,52,52
Ranesha,F,100,52,0,52
Ranita,F,100,52,0,52
Raynee,F,100,52,0,52
Reygan,F,100,52,0,52
Richardson,M,100,0,52,52
Rodric,M,100,0,52,52
Ronie,M,60,21,31,52
Ruddy,M,100,0,52,52
Rylon,M,100,0,52,52
Sabriya,F,100,52,0,52
Salli,F,100,52,0,52
Samayah,F,100,52,0,52
Sandhya,F,100,52,0,52
Sayed,M,100,0,52,52
Scherry,F,100,52,0,52
Seriah,F,100,52,0,52
Shada,F,100,52,0,52
Shaleah,F,100,52,0,52
Shannyn,F,100,52,0,52
Shaquetta,F,100,52,0,52
Sharma,F,100,52,0,52
Sheralyn,F,100,52,0,52
Shronda,F,100,52,0,52
Siedah,F,100,52,0,52
Skilar,F,90,47,5,52
Solveig,F,100,52,0,52
Sriya,F,100,52,0,52
Symantha,F,100,52,0,52
Takota,M,100,0,52,52
Tameria,F,100,52,0,52
Tawney,F,100,52,0,52
Thera,F,100,52,0,52
Tiki,F,100,52,0,52
Tin,M,100,0,52,52
Tomer,M,100,0,52,52
Tramayne,M,100,0,52,52
Treshon,M,100,0,52,52
Trevonte,M,100,0,52,52
Trust,M,67,17,35,52
Urbano,M,100,0,52,52
Valrie,F,100,52,0,52
Vang,M,88,6,46,52
Xion,M,100,0,52,52
Yahye,M,100,0,52,52
Yanessa,F,100,52,0,52
Yari,F,90,47,5,52
Yeriel,M,100,0,52,52
Yug,M,100,0,52,52
Zaelynn,F,100,52,0,52
Zamara,F,100,52,0,52
Zaydan,M,100,0,52,52
Zebediah,M,100,0,52,52
Zoran,M,100,0,52,52
Abagale,F,100,51,0,51
Abir,M,75,13,38,51
Adonna,F,100,51,0,51
Adore,F,100,51,0,51
Adrena,F,100,51,0,51
Aerabella,F,100,51,0,51
Ahmaad,M,100,0,51,51
Aira,F,100,51,0,51
Albertina,F,100,51,0,51
Aleatha,F,100,51,0,51
Aleksey,M,100,0,51,51
Alleah,F,100,51,0,51
Altagracia,F,100,51,0,51
Amadi,F,51,26,25,51
Amran,F,80,41,10,51
Anapaula,F,100,51,0,51
Anthonio,M,100,0,51,51
Artisha,F,100,51,0,51
Ashari,F,100,51,0,51
Ashiya,F,100,51,0,51
Athziry,F,100,51,0,51
Aubreanna,F,100,51,0,51
Audric,M,100,0,51,51
Avagrace,F,100,51,0,51
Ayshia,F,100,51,0,51
Ayven,M,88,6,45,51
Aza,F,88,45,6,51
Bayden,M,100,0,51,51
Beckey,F,100,51,0,51
Bethsaida,F,100,51,0,51
Blu,M,71,15,36,51
Brandye,F,100,51,0,51
Braxston,M,100,0,51,51
Byanka,F,100,51,0,51
Cadin,M,100,0,51,51
Calah,F,100,51,0,51
Calynn,F,100,51,0,51
Can,M,100,0,51,51
Cashius,M,100,0,51,51
Cassandre,F,100,51,0,51
Caycee,F,100,51,0,51
Caydance,F,100,51,0,51
Chiffon,F,100,51,0,51
Chinyere,F,100,51,0,51
Christipher,M,100,0,51,51
Christle,F,100,51,0,51
Colsen,M,100,0,51,51
Cookie,F,100,51,0,51
Crissie,F,100,51,0,51
Daejon,M,100,0,51,51
Demont,M,100,0,51,51
Denym,M,55,23,28,51
Devanie,F,100,51,0,51
Dhruva,M,100,0,51,51
Dimple,F,100,51,0,51
Doniel,M,100,0,51,51
Dray,M,100,0,51,51
Eddison,M,100,0,51,51
Elisabetta,F,100,51,0,51
Frady,F,100,51,0,51
Fredrik,M,100,0,51,51
Garrette,M,100,0,51,51
Gifford,M,100,0,51,51
Glendy,F,100,51,0,51
Glynnis,F,100,51,0,51
Godric,M,100,0,51,51
Grier,F,80,41,10,51
Guilherme,M,100,0,51,51
Guiseppe,M,100,0,51,51
Gyasi,M,100,0,51,51
Haakon,M,100,0,51,51
Haeden,M,80,10,41,51
Haeley,F,100,51,0,51
Ilyse,F,100,51,0,51
Isabellah,F,100,51,0,51
Itai,M,100,0,51,51
Jac,M,100,0,51,51
Jahziel,M,90,5,46,51
Jaise,M,88,6,45,51
Jakara,F,100,51,0,51
Jassiah,M,86,7,44,51
Javiel,M,100,0,51,51
Jeania,F,100,51,0,51
Jeevan,M,100,0,51,51
Jersie,F,100,51,0,51
Jeziel,M,100,0,51,51
Jocilyn,F,100,51,0,51
Josha,M,100,0,51,51
Jossalyn,F,100,51,0,51
Jovonna,F,100,51,0,51
Kaid,M,100,0,51,51
Kamree,F,100,51,0,51
Karder,M,86,7,44,51
Kayleena,F,100,51,0,51
Keiden,M,100,0,51,51
Kemar,M,100,0,51,51
Kennedee,F,100,51,0,51
Kerigan,F,100,51,0,51
Khyle,M,86,7,44,51
Kiele,F,100,51,0,51
Kimble,M,63,19,32,51
Kolette,F,100,51,0,51
Kona,M,61,20,31,51
Kushal,M,100,0,51,51
Kyrese,M,100,0,51,51
Labron,M,100,0,51,51
Laini,F,100,51,0,51
Lakira,F,100,51,0,51
Landa,F,100,51,0,51
Latora,F,100,51,0,51
Laveah,F,100,51,0,51
Lesean,M,100,0,51,51
Letricia,F,100,51,0,51
Lilley,F,100,51,0,51
Lisaann,F,100,51,0,51
Lisanne,F,100,51,0,51
Lonn,M,100,0,51,51
Lorielle,F,100,51,0,51
Ly,F,67,34,17,51
Lynde,F,100,51,0,51
Lyndsy,F,100,51,0,51
Madox,M,100,0,51,51
Mahari,F,61,31,20,51
Mahealani,F,100,51,0,51
Maizey,F,100,51,0,51
Maksymilian,M,100,0,51,51
Malayia,F,100,51,0,51
Maleny,F,100,51,0,51
Mallery,F,100,51,0,51
Manasvi,F,100,51,0,51
Marlise,F,100,51,0,51
Matisse,F,55,28,23,51
Mattix,M,100,0,51,51
Maurene,F,100,51,0,51
Mckade,M,100,0,51,51
Mckaela,F,100,51,0,51
Mckell,F,84,43,8,51
Mckinleigh,F,100,51,0,51
Mehar,F,90,46,5,51
Melrose,F,100,51,0,51
Midge,F,100,51,0,51
Moncia,F,100,51,0,51
Monserat,F,100,51,0,51
Myleah,F,100,51,0,51
Nakeshia,F,100,51,0,51
Naleah,F,100,51,0,51
Necia,F,100,51,0,51
Nikiya,F,100,51,0,51
Norton,M,100,0,51,51
Omaira,F,100,51,0,51
Paitynn,F,100,51,0,51
Parthenia,F,100,51,0,51
Paxon,M,100,0,51,51
Peg,F,100,51,0,51
Percilla,F,100,51,0,51
Purnell,M,100,0,51,51
Quantavious,M,100,0,51,51
Raegyn,F,100,51,0,51
Remedy,F,100,51,0,51
Rheannon,F,100,51,0,51
Ridhi,F,100,51,0,51
Riyad,M,100,0,51,51
Rufina,F,100,51,0,51
Ruthanna,F,100,51,0,51
Sahaj,M,100,0,51,51
Satchel,M,100,0,51,51
Saudia,F,100,51,0,51
Sayda,F,100,51,0,51
Senai,M,55,23,28,51
Seraphine,F,100,51,0,51
Shaheer,M,100,0,51,51
Shalia,F,100,51,0,51
Shaney,F,100,51,0,51
Sharai,F,100,51,0,51
Shawndell,M,80,10,41,51
Shellby,F,100,51,0,51
Sherard,M,100,0,51,51
Shiven,M,100,0,51,51
Shourya,M,100,0,51,51
Skiler,F,55,28,23,51
Sueellen,F,100,51,0,51
Suha,F,100,51,0,51
Suhas,M,100,0,51,51
Suleyma,F,100,51,0,51
Talissa,F,100,51,0,51
Tanyia,F,100,51,0,51
Tarren,M,76,12,39,51
Tarron,M,90,5,46,51
Tayanna,F,100,51,0,51
Terral,M,100,0,51,51
Teyonna,F,100,51,0,51
Toddrick,M,100,0,51,51
Tres,M,100,0,51,51
Tyrae,M,88,6,45,51
Tzirel,F,100,51,0,51
Valisa,F,100,51,0,51
Veera,F,100,51,0,51
Venancio,M,100,0,51,51
Wallis,F,82,42,9,51
Wilburt,M,100,0,51,51
Woodson,M,100,0,51,51
Wynston,M,100,0,51,51
Xitlalli,F,100,51,0,51
Yazeed,M,100,0,51,51
Yazid,M,100,0,51,51
Yusif,M,100,0,51,51
Yvan,M,100,0,51,51
Zabdiel,M,100,0,51,51
Zaiya,F,100,51,0,51
Zakhi,M,100,0,51,51
Zayveon,M,100,0,51,51
Zenovia,F,100,51,0,51
Aashvi,F,100,50,0,50
Adal,M,100,0,50,50
Ainara,F,100,50,0,50
Aisa,F,100,50,0,50
Aissata,F,100,50,0,50
Akua,F,100,50,0,50
Aldrich,M,100,0,50,50
Aleenah,F,100,50,0,50
Alicja,F,100,50,0,50
Allisen,F,100,50,0,50
Altair,F,52,26,24,50
Alyjah,M,74,13,37,50
Amalya,F,100,50,0,50
Amerika,F,100,50,0,50
Anely,F,100,50,0,50
Angelito,M,100,0,50,50
Angenette,F,100,50,0,50
Aprille,F,100,50,0,50
Araina,F,100,50,0,50
Ardyn,F,100,50,0,50
Areana,F,100,50,0,50
Ariahna,F,100,50,0,50
Arienne,F,100,50,0,50
Ashanty,F,100,50,0,50
Atarah,F,100,50,0,50
Audreyanna,F,100,50,0,50
Aviya,F,100,50,0,50
Ayline,F,100,50,0,50
Azusena,F,100,50,0,50
Baley,F,76,38,12,50
Barnaby,M,100,0,50,50
Bentzion,M,100,0,50,50
Blondell,F,100,50,0,50
Brae,F,60,30,20,50
Breeanne,F,100,50,0,50
Breland,M,86,7,43,50
Breslin,M,56,22,28,50
Brighid,F,100,50,0,50
Brigida,F,100,50,0,50
Brynnleigh,F,100,50,0,50
Carliss,F,64,32,18,50
Charna,F,100,50,0,50
Chika,F,100,50,0,50
Chrisann,F,100,50,0,50
Christella,F,100,50,0,50
Colen,M,100,0,50,50
Cosimo,M,100,0,50,50
Crissa,F,100,50,0,50
Damiah,F,100,50,0,50
Dashiel,M,100,0,50,50
Dawnelle,F,100,50,0,50
Dawnn,F,100,50,0,50
Debborah,F,100,50,0,50
Deep,M,100,0,50,50
Deepa,F,100,50,0,50
Derk,M,100,0,50,50
Dewana,F,100,50,0,50
Dewon,M,100,0,50,50
Dez,M,100,0,50,50
Diahann,F,100,50,0,50
Diamon,F,100,50,0,50
Dorean,F,86,43,7,50
Estuardo,M,100,0,50,50
Evangelyn,F,100,50,0,50
Felina,F,100,50,0,50
Fiza,F,100,50,0,50
Galia,F,100,50,0,50
Gerrell,M,100,0,50,50
Gimena,F,100,50,0,50
Hadden,M,100,0,50,50
Halei,F,100,50,0,50
Hammad,M,100,0,50,50
Harjot,M,64,18,32,50
Harvest,F,52,26,24,50
Husna,F,100,50,0,50
Ivone,F,100,50,0,50
Iyona,F,100,50,0,50
Jachin,M,100,0,50,50
Jacquan,M,100,0,50,50
Jaivion,M,100,0,50,50
Jamariah,F,100,50,0,50
Jenita,F,100,50,0,50
Jerami,M,88,6,44,50
Jerek,M,100,0,50,50
Jessup,M,100,0,50,50
Jisselle,F,100,50,0,50
Joei,F,100,50,0,50
Johnmark,M,100,0,50,50
Johnrobert,M,100,0,50,50
Joon,M,90,5,45,50
Justyne,F,100,50,0,50
Kadan,M,100,0,50,50
Kadience,F,100,50,0,50
Kalianna,F,100,50,0,50
Kamyia,F,100,50,0,50
Kaprice,F,100,50,0,50
Kariyah,F,100,50,0,50
Kartier,M,90,5,45,50
Karver,M,100,0,50,50
Kayliegh,F,100,50,0,50
Kendalynn,F,100,50,0,50
Kenon,M,100,0,50,50
Kern,M,100,0,50,50
Khaden,M,100,0,50,50
Ki,M,76,12,38,50
Kierstan,F,100,50,0,50
Kregg,M,100,0,50,50
Krissie,F,100,50,0,50
Krystiana,F,100,50,0,50
Kurstin,F,100,50,0,50
Kyonna,F,100,50,0,50
Lacrisha,F,100,50,0,50
Lakelynn,F,100,50,0,50
Lamaria,F,100,50,0,50
Lancelot,M,100,0,50,50
Lasalle,M,100,0,50,50
Lasondra,F,100,50,0,50
Lavena,F,100,50,0,50
Lerin,F,84,42,8,50
Leydi,F,100,50,0,50
Lonni,F,100,50,0,50
Ltanya,F,100,50,0,50
Maddyx,M,66,17,33,50
Maggy,F,100,50,0,50
Mahathi,F,100,50,0,50
Makell,M,70,15,35,50
Makynna,F,100,50,0,50
Makynzi,F,100,50,0,50
Marella,F,100,50,0,50
Martinique,F,100,50,0,50
Marycarmen,F,100,50,0,50
Maryella,F,100,50,0,50
Marysa,F,100,50,0,50
Mavrik,M,100,0,50,50
Mili,F,100,50,0,50
Mir,M,100,0,50,50
Mizael,M,100,0,50,50
Mouhamadou,M,100,0,50,50
Naftoli,M,100,0,50,50
Naheem,M,100,0,50,50
Nancye,F,100,50,0,50
Natoshia,F,100,50,0,50
Neftaly,M,84,8,42,50
Nekisha,F,100,50,0,50
Nicolasa,F,100,50,0,50
Norm,M,100,0,50,50
Nou,F,86,43,7,50
Nunzio,M,100,0,50,50
Oceanna,F,100,50,0,50
Paco,M,100,0,50,50
Patrisia,F,100,50,0,50
Perl,F,100,50,0,50
Phi,M,88,6,44,50
Pria,F,100,50,0,50
Promyse,F,100,50,0,50
Quintus,M,100,0,50,50
Quyen,F,100,50,0,50
Ralpheal,M,100,0,50,50
Rashed,M,100,0,50,50
Raylie,F,100,50,0,50
Renie,F,100,50,0,50
Rhyleigh,F,100,50,0,50
Riah,F,100,50,0,50
Robina,F,100,50,0,50
Romain,M,100,0,50,50
Ronelle,F,100,50,0,50
Roza,F,100,50,0,50
Rozella,F,100,50,0,50
Rylann,F,82,41,9,50
Sabas,M,100,0,50,50
Samanatha,F,100,50,0,50
Sani,F,84,42,8,50
Saralee,F,100,50,0,50
Sarayah,F,100,50,0,50
Seerat,F,100,50,0,50
Shaneice,F,100,50,0,50
Sherrilyn,F,100,50,0,50
Simrah,F,100,50,0,50
Suhayla,F,100,50,0,50
Tabias,M,100,0,50,50
Tacey,F,100,50,0,50
Taiden,M,100,0,50,50
Talulah,F,100,50,0,50
Teneisha,F,100,50,0,50
Teran,M,58,21,29,50
Toribio,M,100,0,50,50
Toure,M,100,0,50,50
Treyshawn,M,100,0,50,50
Tunisia,F,100,50,0,50
Vashawn,M,100,0,50,50
Venise,F,100,50,0,50
Verl,M,100,0,50,50
Vidya,F,100,50,0,50
Yohannes,M,100,0,50,50
Zakayla,F,100,50,0,50
Zarion,M,100,0,50,50
Zaven,M,100,0,50,50
Zoria,F,100,50,0,50
Zunairah,F,100,50,0,50
Zyaira,F,100,50,0,50
Zyria,F,100,50,0,50
Adelin,F,100,49,0,49
Adessa,F,100,49,0,49
Adhrit,M,100,0,49,49
Adiana,F,100,49,0,49
Aerilyn,F,100,49,0,49
Aiya,F,100,49,0,49
Albaro,M,100,0,49,49
Ambika,F,100,49,0,49
Amias,M,100,0,49,49
Anah,F,100,49,0,49
Anarosa,F,100,49,0,49
Anesia,F,100,49,0,49
Annel,F,100,49,0,49
Anouk,F,100,49,0,49
Antoino,M,100,0,49,49
Aracelli,F,100,49,0,49
Ariauna,F,100,49,0,49
Aryssa,F,100,49,0,49
Asaad,M,100,0,49,49
Ashtynn,F,100,49,0,49
Aubreyana,F,100,49,0,49
Avonna,F,100,49,0,49
Azan,M,100,0,49,49
Bahar,F,100,49,0,49
Basia,F,100,49,0,49
Blessin,F,100,49,0,49
Bradin,M,100,0,49,49
Burnice,M,69,15,34,49
Callyn,F,100,49,0,49
Carrisa,F,100,49,0,49
Casidy,F,100,49,0,49
Caylah,F,100,49,0,49
Ceola,F,100,49,0,49
Christophor,M,100,0,49,49
Cristino,M,100,0,49,49
Dabney,F,90,44,5,49
Dajia,F,100,49,0,49
Dearl,M,100,0,49,49
Deeanne,F,100,49,0,49
Deija,F,100,49,0,49
Deno,M,100,0,49,49
Detric,M,100,0,49,49
Dezerae,F,100,49,0,49
Dezi,M,59,20,29,49
Dorethea,F,100,49,0,49
Dorianne,F,100,49,0,49
Dwanna,F,100,49,0,49
Eiliyah,F,100,49,0,49
Eliany,F,100,49,0,49
Elienai,F,100,49,0,49
Elycia,F,100,49,0,49
Emrey,F,78,38,11,49
Enna,F,100,49,0,49
Erian,F,57,28,21,49
Genette,F,100,49,0,49
Ha,F,86,42,7,49
Hailei,F,100,49,0,49
Harish,M,100,0,49,49
Haseeb,M,100,0,49,49
Heiress,F,100,49,0,49
Hermilo,M,100,0,49,49
Hosie,M,100,0,49,49
Hutch,M,100,0,49,49
Ikeem,M,100,0,49,49
Ismaeel,M,100,0,49,49
Jadine,F,100,49,0,49
Jahkai,M,100,0,49,49
Jaion,M,100,0,49,49
Jaiquan,M,100,0,49,49
Jaira,F,100,49,0,49
Jaire,M,100,0,49,49
Jakaden,M,100,0,49,49
Jakhia,F,100,49,0,49
Jaley,F,100,49,0,49
Jamilia,F,100,49,0,49
Jamine,F,69,34,15,49
Jaquavius,M,100,0,49,49
Jarold,M,100,0,49,49
Jasma,F,100,49,0,49
Jaylean,F,100,49,0,49
Jazalyn,F,100,49,0,49
Jhase,M,100,0,49,49
Jordany,M,100,0,49,49
Jozelyn,F,100,49,0,49
Juliene,F,100,49,0,49
Justan,M,100,0,49,49
Kaj,M,100,0,49,49
Kalene,F,100,49,0,49
Karianna,F,100,49,0,49
Kasra,M,100,0,49,49
Katielynn,F,100,49,0,49
Katrinka,F,100,49,0,49
Kawanna,F,100,49,0,49
Kayler,M,53,23,26,49
Kealey,F,100,49,0,49
Keauna,F,100,49,0,49
Kennieth,M,100,0,49,49
Khyri,M,100,0,49,49
Kiahna,F,100,49,0,49
Kiante,M,51,24,25,49
Kimbley,F,100,49,0,49
Kristia,F,100,49,0,49
Kylyn,F,78,38,11,49
Kynsleigh,F,100,49,0,49
Laddie,M,100,0,49,49
Ladora,F,100,49,0,49
Laelah,F,100,49,0,49
Latresha,F,100,49,0,49
Laurita,F,100,49,0,49
Laveta,F,100,49,0,49
Laylanie,F,100,49,0,49
Leiloni,F,100,49,0,49
Lequita,F,100,49,0,49
Lilybeth,F,100,49,0,49
Lilyrose,F,100,49,0,49
Loan,F,100,49,0,49
Lylian,F,100,49,0,49
Lyndall,M,63,18,31,49
Madilyne,F,100,49,0,49
Majestic,F,65,32,17,49
Makisha,F,100,49,0,49
Manuella,F,100,49,0,49
Marche,F,100,49,0,49
Mariadelcarmen,F,100,49,0,49
Marlissa,F,100,49,0,49
Marybelle,F,100,49,0,49
Maurica,F,100,49,0,49
Mellany,F,100,49,0,49
Memorie,F,100,49,0,49
Merek,M,100,0,49,49
Merrily,F,100,49,0,49
Mery,F,100,49,0,49
Miaya,F,100,49,0,49
Mikaya,F,100,49,0,49
Milee,F,100,49,0,49
Milica,F,100,49,0,49
Mio,F,90,44,5,49
Mousa,M,100,0,49,49
Naidelyn,F,100,49,0,49
Nhu,F,100,49,0,49
Nira,F,100,49,0,49
Olajuwon,M,100,0,49,49
Orpha,F,100,49,0,49
Orren,M,100,0,49,49
Prachi,F,100,49,0,49
Quinnlyn,F,100,49,0,49
Rayetta,F,100,49,0,49
Reginold,M,100,0,49,49
Renwick,M,100,0,49,49
Rhyann,F,100,49,0,49
Rielyn,F,90,44,5,49
Riggins,M,100,0,49,49
Riyah,F,100,49,0,49
Rmani,F,61,30,19,49
Robertson,M,100,0,49,49
Roselee,F,100,49,0,49
Saina,F,100,49,0,49
Sajid,M,100,0,49,49
Saloni,F,100,49,0,49
Saman,M,73,13,36,49
Samarra,F,100,49,0,49
Savian,M,100,0,49,49
Shakim,M,100,0,49,49
Shama,F,100,49,0,49
Shawan,F,80,39,10,49
Sheliah,F,100,49,0,49
Shelina,F,100,49,0,49
Shequita,F,100,49,0,49
Sherrice,F,100,49,0,49
Shone,M,84,8,41,49
Siegfried,M,100,0,49,49
Starlynn,F,100,49,0,49
Sulayman,M,100,0,49,49
Summit,M,100,0,49,49
Symon,M,100,0,49,49
Tanyla,F,100,49,0,49
Tashanna,F,100,49,0,49
Tayvin,M,100,0,49,49
Tequan,M,100,0,49,49
Tere,F,100,49,0,49
Theia,F,100,49,0,49
Tifanie,F,100,49,0,49
Travers,M,100,0,49,49
Tresia,F,100,49,0,49
Vallorie,F,100,49,0,49
Vela,F,100,49,0,49
Veyda,F,100,49,0,49
Whyatt,M,100,0,49,49
Yanis,M,69,15,34,49
Yaqub,M,100,0,49,49
Zacari,M,51,24,25,49
Zahari,F,61,30,19,49
Zemira,F,100,49,0,49
Zenna,F,100,49,0,49
Aaleah,F,100,48,0,48
Aalijah,M,75,12,36,48
Aaniya,F,100,48,0,48
Abigayl,F,100,48,0,48
Adra,F,100,48,0,48
Adri,F,69,33,15,48
Aerith,F,100,48,0,48
Aidden,M,100,0,48,48
Aleiya,F,100,48,0,48
Alie,F,100,48,0,48
Alla,F,100,48,0,48
Allianna,F,100,48,0,48
Allysha,F,100,48,0,48
Amila,F,100,48,0,48
Amine,M,100,0,48,48
Amjad,M,100,0,48,48
Angeliz,F,100,48,0,48
Apple,F,100,48,0,48
Aqsa,F,100,48,0,48
Aquarius,F,60,29,19,48
Arlyne,F,100,48,0,48
Ashika,F,100,48,0,48
Ashlinn,F,100,48,0,48
Astra,F,100,48,0,48
Atia,F,100,48,0,48
Aubreyanna,F,100,48,0,48
Auron,M,100,0,48,48
Aynsley,F,100,48,0,48
Azim,M,100,0,48,48
Bettyjo,F,100,48,0,48
Bobi,F,100,48,0,48
Boubacar,M,100,0,48,48
Breccan,M,100,0,48,48
Bruchy,F,100,48,0,48
Brycin,M,100,0,48,48
Burnis,M,100,0,48,48
Carlus,M,100,0,48,48
Casimiro,M,100,0,48,48
Caylyn,F,100,48,0,48
Cesare,M,100,0,48,48
Cha,M,77,11,37,48
Chantae,F,100,48,0,48
Cheney,F,50,24,24,48
Chetan,M,100,0,48,48
Chevis,M,88,6,42,48
Colon,M,100,0,48,48
Coltrane,M,100,0,48,48
Corky,M,100,0,48,48
Cybil,F,100,48,0,48
Danta,M,90,5,43,48
Davyon,M,100,0,48,48
Daylene,F,100,48,0,48
Decklyn,M,69,15,33,48
Deette,F,100,48,0,48
Delories,F,100,48,0,48
Dianah,F,100,48,0,48
Dillian,M,100,0,48,48
Drayke,M,100,0,48,48
Dublin,M,73,13,35,48
Ediel,M,100,0,48,48
Eiley,F,100,48,0,48
Eivin,M,100,0,48,48
Elizabethann,F,100,48,0,48
Ellanor,F,100,48,0,48
Elsbeth,F,100,48,0,48
Esperansa,F,100,48,0,48
Everlie,F,100,48,0,48
Finis,M,100,0,48,48
Forever,F,100,48,0,48
Freeda,F,100,48,0,48
Georgena,F,100,48,0,48
Gila,F,100,48,0,48
Ginelle,F,100,48,0,48
Gorden,M,100,0,48,48
Gregary,M,100,0,48,48
Hao,M,100,0,48,48
Hiroshi,M,100,0,48,48
Homar,M,100,0,48,48
Iasia,F,100,48,0,48
Imoni,F,100,48,0,48
Iyannah,F,100,48,0,48
Jachai,M,100,0,48,48
Jacksyn,M,77,11,37,48
Jadee,F,100,48,0,48
Jahmar,M,100,0,48,48
Jahna,F,100,48,0,48
Jalysa,F,100,48,0,48
Jamielee,F,100,48,0,48
Jamill,M,100,0,48,48
Jammy,M,69,15,33,48
Jannely,F,100,48,0,48
Jaxtyn,M,100,0,48,48
Jazzelle,F,100,48,0,48
Jermell,M,100,0,48,48
Jessyka,F,100,48,0,48
Jeston,M,100,0,48,48
Jhovany,M,100,0,48,48
Jodean,F,100,48,0,48
Joeangel,M,100,0,48,48
Johnnathan,M,100,0,48,48
Jolynne,F,100,48,0,48
Josafat,M,100,0,48,48
Josaiah,M,100,0,48,48
Josyah,M,100,0,48,48
Judas,M,100,0,48,48
Julieana,F,100,48,0,48
Kahari,M,100,0,48,48
Kalinda,F,100,48,0,48
Kalle,F,90,43,5,48
Kamel,M,100,0,48,48
Kamorah,F,100,48,0,48
Kasee,F,100,48,0,48
Katalyna,F,100,48,0,48
Katilynn,F,100,48,0,48
Kayon,M,100,0,48,48
Kealan,M,100,0,48,48
Keaten,M,100,0,48,48
Kelden,M,100,0,48,48
Keniel,M,100,0,48,48
Kentaro,M,100,0,48,48
Kentrel,M,100,0,48,48
Khaleah,F,100,48,0,48
Kilynn,F,100,48,0,48
Kinzleigh,F,100,48,0,48
Koah,M,100,0,48,48
Ksenia,F,100,48,0,48
Kvon,M,100,0,48,48
Kyndel,F,100,48,0,48
Lace,F,100,48,0,48
Ladarious,M,100,0,48,48
Laderrick,M,100,0,48,48
Laniece,F,100,48,0,48
Lanique,F,100,48,0,48
Larri,F,54,26,22,48
Lasonja,F,100,48,0,48
Latrecia,F,100,48,0,48
Lavona,F,100,48,0,48
Leith,M,75,12,36,48
Leonore,F,100,48,0,48
Levan,M,100,0,48,48
Lochlyn,F,77,37,11,48
Lorisa,F,100,48,0,48
Lotoya,F,100,48,0,48
Lucan,M,100,0,48,48
Lyanne,F,100,48,0,48
Lynleigh,F,100,48,0,48
Lynnetta,F,100,48,0,48
Maddon,M,100,0,48,48
Maesyn,F,85,41,7,48
Mahkai,M,100,0,48,48
Makinna,F,100,48,0,48
Makye,M,100,0,48,48
Maral,F,100,48,0,48
Marcine,F,100,48,0,48
Marielys,F,100,48,0,48
Markez,M,100,0,48,48
Marrion,M,67,16,32,48
Maryama,F,100,48,0,48
Maylani,F,100,48,0,48
Md,M,100,0,48,48
Meenakshi,F,100,48,0,48
Meiling,F,100,48,0,48
Mekai,M,100,0,48,48
Miamor,F,100,48,0,48
Mikhaela,F,100,48,0,48
Minka,F,100,48,0,48
Minor,M,100,0,48,48
Morrell,M,100,0,48,48
Mozella,F,100,48,0,48
Mylin,F,73,35,13,48
Myonna,F,100,48,0,48
Nafis,M,100,0,48,48
Nayelie,F,100,48,0,48
Nazar,M,100,0,48,48
Nikolina,F,100,48,0,48
Nirali,F,100,48,0,48
Noriah,F,100,48,0,48
Oluwanifemi,F,52,25,23,48
Othniel,M,100,0,48,48
Paighton,F,100,48,0,48
Patria,F,100,48,0,48
Penne,F,100,48,0,48
Purvi,F,100,48,0,48
Quintella,F,100,48,0,48
Renia,F,100,48,0,48
Renner,M,100,0,48,48
Rigby,M,88,6,42,48
Ronav,M,100,0,48,48
Rondi,F,100,48,0,48
Ronika,F,100,48,0,48
Roper,M,100,0,48,48
Rosey,F,100,48,0,48
Roxan,F,100,48,0,48
Rudolpho,M,100,0,48,48
Ry,M,100,0,48,48
Ryana,F,100,48,0,48
Saadiq,M,100,0,48,48
Sahid,M,100,0,48,48
Sameeha,F,100,48,0,48
Sanika,F,100,48,0,48
Sevin,M,100,0,48,48
Shailey,F,100,48,0,48
Shamone,F,75,36,12,48
Shandrea,F,100,48,0,48
Sharanya,F,100,48,0,48
Sharifa,F,100,48,0,48
Shariya,F,100,48,0,48
Shaughn,M,100,0,48,48
Shaylan,F,77,37,11,48
Sherl,F,100,48,0,48
Sherline,F,100,48,0,48
Sim,M,100,0,48,48
Skylen,F,58,28,20,48
Sohail,M,100,0,48,48
Souleymane,M,100,0,48,48
Srishti,F,100,48,0,48
Starsha,F,100,48,0,48
Syliva,F,100,48,0,48
Tahja,F,81,39,9,48
Taiga,M,100,0,48,48
Talana,F,100,48,0,48
Taner,M,100,0,48,48
Tanishia,F,100,48,0,48
Taz,M,100,0,48,48
Teretha,F,100,48,0,48
Terriona,F,100,48,0,48
Theran,M,100,0,48,48
Thressa,F,100,48,0,48
Tiler,M,85,7,41,48
Tion,M,77,11,37,48
Tobyn,M,85,7,41,48
Tonesha,F,100,48,0,48
Trinitie,F,100,48,0,48
Tyanne,F,100,48,0,48
Tyberius,M,100,0,48,48
Tyliah,F,100,48,0,48
Ula,F,100,48,0,48
Venson,M,100,0,48,48
Vergil,M,100,0,48,48
Whitten,M,90,5,43,48
Wilberto,M,100,0,48,48
Windi,F,100,48,0,48
Yahia,M,100,0,48,48
Yanique,F,100,48,0,48
Yashira,F,100,48,0,48
Yeison,M,100,0,48,48
Yoan,M,100,0,48,48
Yosselin,F,100,48,0,48
Yovanny,M,100,0,48,48
Zacharey,M,100,0,48,48
Zamiah,F,100,48,0,48
Zurie,F,100,48,0,48
Abdurahman,M,100,0,47,47
Abijah,M,100,0,47,47
Abubakr,M,100,0,47,47
Addi,F,100,47,0,47
Adhya,F,100,47,0,47
Adonia,F,100,47,0,47
Adron,M,100,0,47,47
Aiman,M,74,12,35,47
Alesana,F,100,47,0,47
Alese,F,100,47,0,47
Alexandrya,F,100,47,0,47
Alexianna,F,100,47,0,47
Alexsia,F,100,47,0,47
Alitzel,F,100,47,0,47
Allia,F,100,47,0,47
Allora,F,100,47,0,47
Almeta,F,100,47,0,47
Alonah,F,100,47,0,47
Aloni,F,100,47,0,47
Alyissa,F,100,47,0,47
Amaira,F,100,47,0,47
Amana,F,100,47,0,47
Ambrea,F,100,47,0,47
Amerah,F,100,47,0,47
Amillion,F,55,26,21,47
Amzie,F,100,47,0,47
Angelli,F,100,47,0,47
Anis,M,100,0,47,47
Annastacia,F,100,47,0,47
Arlisa,F,100,47,0,47
Artavia,F,100,47,0,47
Asaph,M,100,0,47,47
Ashlyne,F,100,47,0,47
Ashunti,F,100,47,0,47
Atif,M,100,0,47,47
Avantika,F,100,47,0,47
Ayriana,F,100,47,0,47
Ayson,M,100,0,47,47
Ayushi,F,100,47,0,47
Azarias,M,100,0,47,47
Azayla,F,100,47,0,47
Azelia,F,100,47,0,47
Bartolo,M,100,0,47,47
Basma,F,100,47,0,47
Beauregard,M,100,0,47,47
Biridiana,F,100,47,0,47
Bonnita,F,100,47,0,47
Breslyn,F,100,47,0,47
Breydan,M,100,0,47,47
Brick,M,100,0,47,47
Broxton,M,100,0,47,47
Caliah,F,100,47,0,47
Carlous,M,100,0,47,47
Cato,M,100,0,47,47
Cayli,F,100,47,0,47
Ceana,F,100,47,0,47
Cece,F,100,47,0,47
Cecille,F,100,47,0,47
Champagne,F,100,47,0,47
Chandni,F,100,47,0,47
Chanita,F,100,47,0,47
Charese,F,100,47,0,47
Chelle,F,100,47,0,47
Chrystopher,M,100,0,47,47
Cruzito,M,100,0,47,47
Dalina,F,100,47,0,47
Danyella,F,100,47,0,47
Daralyn,F,100,47,0,47
Darrow,M,100,0,47,47
Dastan,M,100,0,47,47
Davena,F,100,47,0,47
Davontay,M,100,0,47,47
Deavon,M,89,5,42,47
Deeksha,F,100,47,0,47
Demitra,F,100,47,0,47
Denetra,F,100,47,0,47
Deng,M,100,0,47,47
Deonne,F,89,42,5,47
Derinda,F,100,47,0,47
Devinn,M,66,16,31,47
Dima,F,89,42,5,47
Djuana,F,100,47,0,47
Donnelle,F,60,28,19,47
Dorena,F,100,47,0,47
Drena,F,100,47,0,47
Edouard,M,100,0,47,47
Ehan,M,100,0,47,47
Elianny,F,100,47,0,47
Ellyson,F,100,47,0,47
Emillie,F,100,47,0,47
Emmalynne,F,100,47,0,47
Erlene,F,100,47,0,47
Erol,M,100,0,47,47
Ezana,M,100,0,47,47
Falcon,M,100,0,47,47
Fortune,F,64,30,17,47
Francoise,F,100,47,0,47
Fuad,M,100,0,47,47
Gabrianna,F,100,47,0,47
Geni,F,100,47,0,47
Ger,M,100,0,47,47
Gini,F,100,47,0,47
Gunter,M,100,0,47,47
Hannan,F,89,42,5,47
Illianna,F,100,47,0,47
Iraida,F,100,47,0,47
Isaah,M,100,0,47,47
Izan,M,100,0,47,47
Ja,M,57,20,27,47
Jabin,M,100,0,47,47
Jahn,M,100,0,47,47
Jamale,M,100,0,47,47
Jamesetta,F,100,47,0,47
Janalyn,F,100,47,0,47
Janiyla,F,100,47,0,47
Javonni,M,85,7,40,47
Jayceion,M,100,0,47,47
Jeanny,F,100,47,0,47
Jennifier,F,100,47,0,47
Jeovani,M,100,0,47,47
Jermar,M,100,0,47,47
Johanny,F,100,47,0,47
Joia,F,100,47,0,47
Jonda,F,100,47,0,47
Jousha,M,100,0,47,47
Kaithlyn,F,100,47,0,47
Kamirah,F,100,47,0,47
Karia,F,100,47,0,47
Karys,F,100,47,0,47
Kaveh,M,100,0,47,47
Kawan,M,100,0,47,47
Kayelee,F,100,47,0,47
Keean,M,100,0,47,47
Keisa,F,100,47,0,47
Kennesha,F,100,47,0,47
Kharisma,F,100,47,0,47
Khi,M,85,7,40,47
Khira,F,100,47,0,47
Kittie,F,100,47,0,47
Kitzia,F,100,47,0,47
Lakeia,F,100,47,0,47
Lanard,M,100,0,47,47
Larisha,F,100,47,0,47
Larkyn,F,100,47,0,47
Lashona,F,100,47,0,47
Latona,F,100,47,0,47
Laurelle,F,100,47,0,47
Laurieann,F,100,47,0,47
Lekeshia,F,100,47,0,47
Liel,F,81,38,9,47
Livvy,F,100,47,0,47
Lovetta,F,100,47,0,47
Luisalberto,M,100,0,47,47
Mackenize,F,100,47,0,47
Mahogani,F,100,47,0,47
Maisyn,F,87,41,6,47
Makenley,F,100,47,0,47
Makyia,F,100,47,0,47
Malillany,F,100,47,0,47
Marja,F,100,47,0,47
Marleah,F,100,47,0,47
Marolyn,F,100,47,0,47
Marquies,M,100,0,47,47
Marshelle,F,100,47,0,47
Mayo,M,100,0,47,47
Mckena,F,100,47,0,47
Mehgan,F,100,47,0,47
Meilin,F,100,47,0,47
Melodye,F,100,47,0,47
Mervyn,M,100,0,47,47
Mikella,F,100,47,0,47
Mindie,F,100,47,0,47
Mishell,F,100,47,0,47
Miyuki,F,100,47,0,47
Mubarak,M,100,0,47,47
Mujtaba,M,100,0,47,47
Nachelle,F,100,47,0,47
Naira,F,100,47,0,47
Nakyla,F,100,47,0,47
Naoma,F,100,47,0,47
Nashay,F,100,47,0,47
Nastassia,F,100,47,0,47
Nethra,F,100,47,0,47
Noemie,F,100,47,0,47
Olinda,F,100,47,0,47
Philicia,F,100,47,0,47
Pier,F,72,34,13,47
Porshe,F,100,47,0,47
Primrose,F,100,47,0,47
Quinlyn,F,100,47,0,47
Raedyn,F,62,29,18,47
Raequan,M,100,0,47,47
Reiko,F,100,47,0,47
Ricard,M,100,0,47,47
Rosellen,F,100,47,0,47
Ryle,M,66,16,31,47
Saiya,F,100,47,0,47
Samanthia,F,100,47,0,47
Sanjeev,M,100,0,47,47
Saxton,M,100,0,47,47
Seaira,F,100,47,0,47
Shaena,F,100,47,0,47
Shaleigh,F,100,47,0,47
Shanyah,F,100,47,0,47
Sharaya,F,100,47,0,47
Sharra,F,100,47,0,47
Shelda,F,100,47,0,47
Siaosi,M,100,0,47,47
Simra,F,100,47,0,47
Siyona,F,100,47,0,47
Skyelynn,F,100,47,0,47
Storie,F,100,47,0,47
Sumaiyah,F,100,47,0,47
Sutter,M,87,6,41,47
Tashayla,F,100,47,0,47
Tatiyanna,F,100,47,0,47
Tawan,M,100,0,47,47
Taylie,F,100,47,0,47
Tayonna,F,100,47,0,47
Tedi,F,100,47,0,47
Tehilla,F,100,47,0,47
Teja,F,85,40,7,47
Tekisha,F,100,47,0,47
Teneka,F,100,47,0,47
Teylor,F,100,47,0,47
Theseus,M,100,0,47,47
Thomasena,F,100,47,0,47
Tigerlily,F,100,47,0,47
Tkeyah,F,100,47,0,47
Tommye,F,100,47,0,47
Travian,M,100,0,47,47
Travin,M,100,0,47,47
Trenice,F,100,47,0,47
Tristina,F,100,47,0,47
Tymere,M,100,0,47,47
Wafa,F,100,47,0,47
Winthrop,M,100,0,47,47
Xzavian,M,100,0,47,47
Yuriana,F,100,47,0,47
Zahmir,M,100,0,47,47
Zelia,F,100,47,0,47
Zelie,F,100,47,0,47
Aahan,M,100,0,46,46
Abelina,F,100,46,0,46
Abu,M,100,0,46,46
Adit,M,100,0,46,46
Adrieanna,F,100,46,0,46
Alacia,F,100,46,0,46
Alanys,F,100,46,0,46
Aleksei,M,100,0,46,46
Alesandro,M,100,0,46,46
Alinda,F,100,46,0,46
Anevay,F,100,46,0,46
Annaliyah,F,100,46,0,46
Annalyssa,F,100,46,0,46
Antonique,F,100,46,0,46
Aryannah,F,100,46,0,46
Asley,F,100,46,0,46
Aslyn,F,100,46,0,46
Audelia,F,100,46,0,46
Audreana,F,100,46,0,46
Aviah,F,100,46,0,46
Avielle,F,100,46,0,46
Aylene,F,100,46,0,46
Bentlie,F,70,32,14,46
Bintou,F,100,46,0,46
Bora,M,85,7,39,46
Brevyn,M,100,0,46,46
Brodyn,M,100,0,46,46
Camdin,M,100,0,46,46
Caresse,F,100,46,0,46
Carlyon,F,100,46,0,46
Carylon,F,100,46,0,46
Cayle,M,63,17,29,46
Cephas,M,100,0,46,46
Chandon,M,100,0,46,46
Chantele,F,100,46,0,46
Chelby,F,100,46,0,46
Chyla,F,100,46,0,46
Cicero,M,100,0,46,46
Cindra,F,100,46,0,46
Cissy,F,100,46,0,46
Conny,F,78,36,10,46
Corah,F,100,46,0,46
Cylie,F,100,46,0,46
Dace,M,100,0,46,46
Dalal,F,100,46,0,46
Damarious,M,100,0,46,46
Darbie,F,100,46,0,46
Dawit,M,100,0,46,46
Dekari,M,100,0,46,46
Delonda,F,100,46,0,46
Demontre,M,100,0,46,46
Deniya,F,100,46,0,46
Devani,F,100,46,0,46
Diara,F,100,46,0,46
Dierra,F,100,46,0,46
Dillin,M,100,0,46,46
Dunya,F,100,46,0,46
Dushawn,M,100,0,46,46
Edda,F,100,46,0,46
Edelmira,F,100,46,0,46
Elecia,F,100,46,0,46
Ellarose,F,100,46,0,46
Elnathan,M,100,0,46,46
Emanuelle,M,59,19,27,46
Erandi,F,100,46,0,46
Erminia,F,100,46,0,46
Estephania,F,100,46,0,46
Evalena,F,100,46,0,46
Eyal,M,100,0,46,46
Fernandez,M,100,0,46,46
Fradel,F,100,46,0,46
Gamal,M,100,0,46,46
Gayleen,F,100,46,0,46
Hailynn,F,100,46,0,46
Hanaa,F,100,46,0,46
Haruka,F,100,46,0,46
Heinz,M,100,0,46,46
Hoda,F,100,46,0,46
Hortense,F,100,46,0,46
Humphrey,M,100,0,46,46
Husain,M,100,0,46,46
Isrrael,M,100,0,46,46
Itza,F,100,46,0,46
Izaiha,M,100,0,46,46
Jaaron,M,100,0,46,46
Jaelee,F,100,46,0,46
Jakye,M,100,0,46,46
Jamael,M,100,0,46,46
Janani,F,100,46,0,46
Janesha,F,100,46,0,46
Jarmar,M,100,0,46,46
Jatavia,F,100,46,0,46
Jeani,F,100,46,0,46
Jeorge,M,100,0,46,46
Jeovanny,M,100,0,46,46
Jerman,M,100,0,46,46
Jomo,M,100,0,46,46
Jorian,M,100,0,46,46
Josiel,M,100,0,46,46
Judyth,F,100,46,0,46
Kadir,M,100,0,46,46
Kaiulani,F,100,46,0,46
Karlina,F,100,46,0,46
Katasha,F,100,46,0,46
Kaybree,F,100,46,0,46
Kayte,F,100,46,0,46
Keani,F,85,39,7,46
Keili,F,100,46,0,46
Kelon,M,100,0,46,46
Kenden,M,100,0,46,46
Kennah,F,100,46,0,46
Keontay,M,100,0,46,46
Keyshon,M,100,0,46,46
Khori,F,89,41,5,46
Khris,M,100,0,46,46
Kiauna,F,100,46,0,46
Kincaid,M,100,0,46,46
Korrine,F,100,46,0,46
Lamichael,M,100,0,46,46
Landra,F,100,46,0,46
Landrey,F,87,40,6,46
Lashanta,F,100,46,0,46
Lashone,F,100,46,0,46
Leaann,F,100,46,0,46
Legion,M,100,0,46,46
Leza,F,100,46,0,46
Loma,F,100,46,0,46
Lorayne,F,100,46,0,46
Lujain,F,100,46,0,46
Lyrica,F,100,46,0,46
Mackey,M,100,0,46,46
Madalene,F,100,46,0,46
Maddi,F,100,46,0,46
Mahamed,M,100,0,46,46
Mahmood,M,100,0,46,46
Mailani,F,100,46,0,46
Makalyn,F,100,46,0,46
Marnita,F,100,46,0,46
Marrio,M,100,0,46,46
Martrell,M,100,0,46,46
Marye,F,100,46,0,46
Masin,M,100,0,46,46
Maxcine,F,100,46,0,46
Meighan,F,100,46,0,46
Melchizedek,M,100,0,46,46
Merina,F,100,46,0,46
Mills,M,87,6,40,46
Mozelle,F,100,46,0,46
Mykaila,F,100,46,0,46
Myria,F,100,46,0,46
Naser,M,100,0,46,46
Navil,F,89,41,5,46
Naysa,F,100,46,0,46
Netanya,F,100,46,0,46
Niang,F,100,46,0,46
Nijel,M,100,0,46,46
Niyana,F,100,46,0,46
Noha,F,67,31,15,46
Nyana,F,100,46,0,46
Odysseus,M,100,0,46,46
Oswin,M,59,19,27,46
Ozie,M,65,16,30,46
Pammy,F,100,46,0,46
Perfecto,M,100,0,46,46
Peytan,F,100,46,0,46
Peytyn,F,100,46,0,46
Polo,M,100,0,46,46
Posey,F,85,39,7,46
Preet,M,65,16,30,46
Quint,M,100,0,46,46
Quintessa,F,100,46,0,46
Raed,M,100,0,46,46
Rahel,F,100,46,0,46
Rainah,F,100,46,0,46
Rameen,F,61,28,18,46
Ramonita,F,100,46,0,46
Ranelle,F,100,46,0,46
Rasul,M,100,0,46,46
Rayshun,M,100,0,46,46
Reniya,F,100,46,0,46
Reniyah,F,100,46,0,46
Richad,M,100,0,46,46
Rondall,M,100,0,46,46
Royden,M,100,0,46,46
Sarae,F,100,46,0,46
Sarha,F,100,46,0,46
Schylar,F,59,27,19,46
See,F,100,46,0,46
Seena,F,72,33,13,46
Sequoya,F,100,46,0,46
Sereen,F,100,46,0,46
Shaelee,F,100,46,0,46
Shalise,F,100,46,0,46
Shayley,F,100,46,0,46
Shelah,F,100,46,0,46
Shery,F,100,46,0,46
Shiane,F,100,46,0,46
Shneur,M,100,0,46,46
Sigifredo,M,100,0,46,46
Simonne,F,100,46,0,46
Soraida,F,100,46,0,46
Stedman,M,100,0,46,46
Sumayah,F,100,46,0,46
Suni,F,100,46,0,46
Taeya,F,100,46,0,46
Tahani,F,100,46,0,46
Tanishka,F,100,46,0,46
Teshawn,M,87,6,40,46
Theodosia,F,100,46,0,46
Thy,F,100,46,0,46
Toussaint,M,100,0,46,46
Trevian,M,100,0,46,46
Trula,F,100,46,0,46
Ulric,M,100,0,46,46
Vaden,M,100,0,46,46
Vanshika,F,100,46,0,46
Winry,F,100,46,0,46
Wray,M,100,0,46,46
Wylee,M,89,5,41,46
Xzayvier,M,100,0,46,46
Yafet,M,100,0,46,46
Yang,M,100,0,46,46
Yoko,F,100,46,0,46
Yovana,F,100,46,0,46
Yudith,F,100,46,0,46
Yuvia,F,100,46,0,46
Zemirah,F,100,46,0,46
Zosia,F,100,46,0,46
Zubin,M,100,0,46,46
Aarti,F,100,45,0,45
Abbygayle,F,100,45,0,45
Abid,M,100,0,45,45
Adonica,F,100,45,0,45
Aela,F,100,45,0,45
Ahnaf,M,100,0,45,45
Aina,F,100,45,0,45
Airel,F,100,45,0,45
Akshat,M,100,0,45,45
Aldrick,M,100,0,45,45
Aleysha,F,100,45,0,45
Alivea,F,100,45,0,45
Amberlin,F,100,45,0,45
Ambur,F,100,45,0,45
Amri,F,100,45,0,45
Anaisha,F,100,45,0,45
Analuisa,F,100,45,0,45
Angelicia,F,100,45,0,45
Angelus,M,89,5,40,45
Aquiles,M,100,0,45,45
Areeba,F,100,45,0,45
Areil,F,100,45,0,45
Arwyn,F,100,45,0,45
Aveon,M,100,0,45,45
Avila,F,100,45,0,45
Ayaka,F,100,45,0,45
Ayrianna,F,100,45,0,45
Batool,F,100,45,0,45
Bejamin,M,100,0,45,45
Benjamyn,M,100,0,45,45
Berl,M,100,0,45,45
Bernette,F,100,45,0,45
Brighten,M,58,19,26,45
Bristal,F,100,45,0,45
Bryann,F,89,40,5,45
Bubba,M,100,0,45,45
Calyssa,F,100,45,0,45
Caralynn,F,100,45,0,45
Cassidie,F,100,45,0,45
Cattaleya,F,100,45,0,45
Chai,M,51,22,23,45
Chane,M,64,16,29,45
Channell,F,100,45,0,45
Charde,F,100,45,0,45
Chaseton,M,100,0,45,45
Chessa,F,100,45,0,45
Chimamanda,F,100,45,0,45
Clemon,M,100,0,45,45
Codee,M,53,21,24,45
Coye,M,100,0,45,45
Cristyn,F,100,45,0,45
Cyntia,F,100,45,0,45
Dal,M,100,0,45,45
Dannia,F,100,45,0,45
Darlynn,F,100,45,0,45
Darrious,M,100,0,45,45
Davette,F,100,45,0,45
Dawana,F,100,45,0,45
Deandrae,M,100,0,45,45
Delanna,F,100,45,0,45
Deneisha,F,100,45,0,45
Dequarius,M,100,0,45,45
Derren,M,100,0,45,45
Desta,F,100,45,0,45
Destyne,F,100,45,0,45
Detria,F,100,45,0,45
Dewight,M,100,0,45,45
Dezmen,M,100,0,45,45
Dimitry,M,100,0,45,45
Domani,M,100,0,45,45
Dorenda,F,100,45,0,45
Drenda,F,100,45,0,45
Eleen,F,100,45,0,45
Elishia,F,100,45,0,45
Eliyana,F,100,45,0,45
Ellamarie,F,100,45,0,45
Elliemae,F,100,45,0,45
Emeric,M,100,0,45,45
Eulogio,M,100,0,45,45
Faithann,F,100,45,0,45
Galilee,F,100,45,0,45
Girl,F,100,45,0,45
Gracelynne,F,100,45,0,45
Gurpreet,M,64,16,29,45
Gwendelyn,F,100,45,0,45
Hannelore,F,100,45,0,45
Hardin,M,100,0,45,45
Henchy,F,100,45,0,45
Ishanvi,F,100,45,0,45
Ivori,F,100,45,0,45
Ivyonna,F,100,45,0,45
Iyan,M,100,0,45,45
Jaceion,M,100,0,45,45
Jacquel,F,62,28,17,45
Jadea,F,100,45,0,45
Jaelene,F,100,45,0,45
Jahziah,M,87,6,39,45
Jamera,F,100,45,0,45
Jamyiah,F,100,45,0,45
Janeane,F,100,45,0,45
Janisa,F,100,45,0,45
Januel,M,100,0,45,45
Jeanann,F,100,45,0,45
Jennalyn,F,100,45,0,45
Jerzy,M,71,13,32,45
Jessen,M,100,0,45,45
Jibran,M,100,0,45,45
Jodine,F,100,45,0,45
Jonique,F,100,45,0,45
Jovanie,M,100,0,45,45
Jsean,M,100,0,45,45
Kaedin,M,100,0,45,45
Kaity,F,100,45,0,45
Kaleya,F,100,45,0,45
Kalisa,F,100,45,0,45
Kandise,F,100,45,0,45
Kareemah,F,100,45,0,45
Karrissa,F,100,45,0,45
Karsin,M,87,6,39,45
Katrell,M,100,0,45,45
Kaveon,M,100,0,45,45
Keilen,M,87,6,39,45
Kerilyn,F,100,45,0,45
Kevaughn,M,100,0,45,45
Khayri,M,100,0,45,45
Kianah,F,100,45,0,45
Kinza,F,100,45,0,45
Kirstan,F,100,45,0,45
Koleton,M,100,0,45,45
Krystalyn,F,100,45,0,45
Krystie,F,100,45,0,45
Kwamane,M,100,0,45,45
Kyaira,F,100,45,0,45
Kyerra,F,100,45,0,45
Lameka,F,100,45,0,45
Lamisha,F,100,45,0,45
Lancer,M,100,0,45,45
Lansing,M,100,0,45,45
Latron,M,100,0,45,45
Leida,F,100,45,0,45
Leighana,F,100,45,0,45
Lorali,F,100,45,0,45
Lurdes,F,100,45,0,45
Lynita,F,100,45,0,45
Mahek,F,100,45,0,45
Mardy,M,80,9,36,45
Marialuisa,F,100,45,0,45
Maryum,F,100,45,0,45
Maud,F,100,45,0,45
Mayan,F,64,29,16,45
Meila,F,100,45,0,45
Mekenna,F,100,45,0,45
Melanye,F,100,45,0,45
Mendi,F,100,45,0,45
Mera,F,100,45,0,45
Micole,F,100,45,0,45
Muhamad,M,100,0,45,45
Nakira,F,100,45,0,45
Nasha,F,100,45,0,45
Nashon,M,100,0,45,45
Nasier,M,100,0,45,45
Natalye,F,100,45,0,45
Nathyn,M,100,0,45,45
Nazia,F,100,45,0,45
Neeko,M,100,0,45,45
Niharika,F,100,45,0,45
Nygel,M,100,0,45,45
Omero,M,100,0,45,45
Pearla,F,100,45,0,45
Phylliss,F,100,45,0,45
Quetzali,F,100,45,0,45
Raihan,M,100,0,45,45
Raley,F,100,45,0,45
Raman,M,100,0,45,45
Randol,M,100,0,45,45
Rayona,F,100,45,0,45
Reham,F,100,45,0,45
Richrd,M,100,0,45,45
Rinoa,F,100,45,0,45
Romualdo,M,100,0,45,45
Ronel,M,100,0,45,45
Ronnisha,F,100,45,0,45
Rosary,F,100,45,0,45
Roselie,F,100,45,0,45
Roshaun,M,73,12,33,45
Rosibel,F,100,45,0,45
Saahil,M,100,0,45,45
Sadiya,F,100,45,0,45
Samhita,F,100,45,0,45
Samora,F,100,45,0,45
Selenia,F,100,45,0,45
Seraphim,F,62,28,17,45
Shadai,F,100,45,0,45
Shadrick,M,100,0,45,45
Shalita,F,100,45,0,45
Shanica,F,100,45,0,45
Shanieka,F,100,45,0,45
Shanisha,F,100,45,0,45
Shaquila,F,100,45,0,45
Shean,M,100,0,45,45
Sheccid,F,100,45,0,45
Shondell,F,51,23,22,45
Shooter,M,100,0,45,45
Sintia,F,100,45,0,45
Sita,F,100,45,0,45
Soriya,F,100,45,0,45
Stavroula,F,100,45,0,45
Taegen,F,53,24,21,45
Tahisha,F,100,45,0,45
Takai,M,76,11,34,45
Takumi,M,100,0,45,45
Tamsen,F,100,45,0,45
Tamsin,F,100,45,0,45
Tarance,M,100,0,45,45
Teira,F,100,45,0,45
Tijuan,M,100,0,45,45
Timon,M,100,0,45,45
Tomiko,F,100,45,0,45
Toran,M,100,0,45,45
Trany,F,100,45,0,45
Tremel,M,100,0,45,45
Tycho,M,100,0,45,45
Tydus,M,100,0,45,45
Tyray,M,100,0,45,45
Tyrrell,M,100,0,45,45
Ulyssa,F,100,45,0,45
Vandy,M,58,19,26,45
Vanisha,F,100,45,0,45
Wael,M,100,0,45,45
Whitnie,F,100,45,0,45
Willena,F,100,45,0,45
Yeimy,F,100,45,0,45
Yuka,F,100,45,0,45
Zahrah,F,100,45,0,45
Zyah,F,100,45,0,45
Aamira,F,100,44,0,44
Adilee,F,100,44,0,44
Adrin,M,100,0,44,44
Ahmiyah,F,100,44,0,44
Ahniya,F,100,44,0,44
Ai,F,100,44,0,44
Aki,F,55,24,20,44
Alisandra,F,100,44,0,44
Alivya,F,100,44,0,44
Allannah,F,100,44,0,44
Allayah,F,100,44,0,44
Almir,M,100,0,44,44
Alwin,M,100,0,44,44
Amilah,F,100,44,0,44
Anant,M,100,0,44,44
Andrick,M,100,0,44,44
Andruw,M,100,0,44,44
Annis,F,100,44,0,44
Anthon,M,100,0,44,44
Aphrodite,F,100,44,0,44
Ardelia,F,100,44,0,44
Arliss,M,57,19,25,44
Aster,F,89,39,5,44
Atlantis,F,100,44,0,44
Avenir,M,100,0,44,44
Avy,F,100,44,0,44
Ayona,F,100,44,0,44
Bashar,M,100,0,44,44
Benn,M,100,0,44,44
Blakeleigh,F,100,44,0,44
Braelee,F,100,44,0,44
Bransyn,M,100,0,44,44
Brees,M,84,7,37,44
Breindy,F,100,44,0,44
Breylon,M,100,0,44,44
Britne,F,100,44,0,44
Brittanya,F,100,44,0,44
Brookelynne,F,100,44,0,44
Bryen,M,100,0,44,44
Catrena,F,100,44,0,44
Chianti,F,100,44,0,44
Chidinma,F,100,44,0,44
Claudell,M,70,13,31,44
Clorinda,F,100,44,0,44
Collie,M,89,5,39,44
Cordel,M,100,0,44,44
Corra,F,100,44,0,44
Cove,M,86,6,38,44
Cyanna,F,100,44,0,44
Dailynn,F,100,44,0,44
Daley,F,89,39,5,44
Daryel,M,100,0,44,44
Daxten,M,100,0,44,44
Daylynn,F,100,44,0,44
Deaunte,M,100,0,44,44
Delmus,M,100,0,44,44
Delray,M,100,0,44,44
Demoni,M,80,9,35,44
Denitra,F,100,44,0,44
Dewain,M,100,0,44,44
Deyana,F,100,44,0,44
Dilara,F,100,44,0,44
Domnick,M,100,0,44,44
Doneisha,F,100,44,0,44
Drey,M,100,0,44,44
Dynasti,F,100,44,0,44
Eagan,M,100,0,44,44
Eashan,M,100,0,44,44
Edyth,F,100,44,0,44
Eily,F,100,44,0,44
Elaysia,F,100,44,0,44
Eleny,F,100,44,0,44
Elier,M,100,0,44,44
Elinore,F,100,44,0,44
Elisse,F,100,44,0,44
Elric,M,100,0,44,44
Emanuela,F,100,44,0,44
Emmalyne,F,100,44,0,44
Emmanual,M,100,0,44,44
Emmarae,F,100,44,0,44
Emmely,F,100,44,0,44
Emmilyn,F,100,44,0,44
Encarnacion,M,100,0,44,44
Ephriam,M,100,0,44,44
Estefan,M,100,0,44,44
Fahim,M,100,0,44,44
Farrel,M,100,0,44,44
Favio,M,100,0,44,44
Felishia,F,100,44,0,44
Filipe,M,100,0,44,44
Folasade,F,100,44,0,44
Galo,M,100,0,44,44
Garreth,M,100,0,44,44
Genita,F,100,44,0,44
Greydis,F,100,44,0,44
Gumaro,M,100,0,44,44
Gwyndolyn,F,100,44,0,44
Haig,M,100,0,44,44
Hannia,F,100,44,0,44
Harmonii,F,100,44,0,44
Harpreet,M,68,14,30,44
Haruki,M,100,0,44,44
Haytham,M,100,0,44,44
Hiliana,F,100,44,0,44
Hillarie,F,100,44,0,44
Hiroki,M,100,0,44,44
Hyatt,M,89,5,39,44
Italo,M,100,0,44,44
Jabier,M,100,0,44,44
Jabir,M,100,0,44,44
Jadakiss,M,70,13,31,44
Jahmai,M,100,0,44,44
Jahniyah,F,100,44,0,44
Jaionna,F,100,44,0,44
Jamiracle,F,100,44,0,44
Janeice,F,100,44,0,44
Jasha,F,100,44,0,44
Jashan,M,89,5,39,44
Jaskaran,M,100,0,44,44
Javone,M,100,0,44,44
Jazara,F,100,44,0,44
Jazell,F,100,44,0,44
Jerrion,M,100,0,44,44
Jerusalem,F,73,32,12,44
Joannah,F,100,44,0,44
Johnisha,F,100,44,0,44
Johnpatrick,M,100,0,44,44
Jonnae,F,100,44,0,44
Joren,M,100,0,44,44
Joud,F,82,36,8,44
Jovante,M,100,0,44,44
Jovaughn,M,100,0,44,44
Jrue,M,82,8,36,44
Kaaliyah,F,100,44,0,44
Kairee,F,50,22,22,44
Kallyn,F,100,44,0,44
Kaloni,F,100,44,0,44
Karsynn,F,100,44,0,44
Kashlyn,F,100,44,0,44
Kasin,M,100,0,44,44
Kassidie,F,100,44,0,44
Katieann,F,100,44,0,44
Katryn,F,100,44,0,44
Kaysee,F,100,44,0,44
Kaz,M,100,0,44,44
Kehinde,M,64,16,28,44
Keishaun,M,100,0,44,44
Kellsie,F,100,44,0,44
Keylon,M,100,0,44,44
Khairi,M,100,0,44,44
Khiya,F,100,44,0,44
Kiasia,F,100,44,0,44
Kien,M,100,0,44,44
Kimberlyann,F,100,44,0,44
Kimiya,F,100,44,0,44
Kinzi,F,100,44,0,44
Kiyoshi,M,89,5,39,44
Kymoni,M,80,9,35,44
Kyrian,M,100,0,44,44
Lanika,F,100,44,0,44
Laquasha,F,100,44,0,44
Larenz,M,100,0,44,44
Larraine,F,100,44,0,44
Lateesha,F,100,44,0,44
Lequan,M,100,0,44,44
Lien,F,100,44,0,44
Liisa,F,100,44,0,44
Lilit,F,100,44,0,44
Linell,M,66,15,29,44
Lissandra,F,100,44,0,44
Lubna,F,100,44,0,44
Lyliana,F,100,44,0,44
Lyndal,F,50,22,22,44
Lyndel,M,68,14,30,44
Lyrick,M,57,19,25,44
Maahi,F,100,44,0,44
Maclain,M,100,0,44,44
Malaiya,F,100,44,0,44
Mammie,F,100,44,0,44
Manuelita,F,100,44,0,44
Marisel,F,100,44,0,44
Mattilynn,F,100,44,0,44
Maxemiliano,M,100,0,44,44
Melika,F,100,44,0,44
Melville,M,100,0,44,44
Menashe,M,100,0,44,44
Mikeyla,F,100,44,0,44
Monita,F,100,44,0,44
Nafisa,F,100,44,0,44
Naoki,M,89,5,39,44
Natarsha,F,100,44,0,44
Nathaneil,M,100,0,44,44
Nea,F,100,44,0,44
Nely,F,100,44,0,44
Nicoli,M,100,0,44,44
Nissi,F,100,44,0,44
Nyeisha,F,100,44,0,44
Onita,F,100,44,0,44
Ousman,M,100,0,44,44
Prithvi,M,100,0,44,44
Quintavius,M,100,0,44,44
Revan,M,100,0,44,44
Ricarda,F,100,44,0,44
Rika,F,100,44,0,44
Rosi,F,100,44,0,44
Rosmery,F,100,44,0,44
Rowynn,F,100,44,0,44
Ruchi,F,100,44,0,44
Ryliegh,F,100,44,0,44
Sahas,M,100,0,44,44
Saidee,F,100,44,0,44
Samaiya,F,100,44,0,44
Samanvi,F,100,44,0,44
Samra,F,100,44,0,44
Sanna,F,100,44,0,44
Saprina,F,100,44,0,44
Serenitee,F,100,44,0,44
Shalea,F,100,44,0,44
Shandell,F,100,44,0,44
Shantrice,F,100,44,0,44
Shenandoah,F,84,37,7,44
Shenelle,F,100,44,0,44
Sheran,F,100,44,0,44
Sheretta,F,100,44,0,44
Shevonne,F,100,44,0,44
Song,F,84,37,7,44
Special,F,100,44,0,44
Sugey,F,100,44,0,44
Suleima,F,100,44,0,44
Sung,M,73,12,32,44
Szymon,M,100,0,44,44
Tabari,M,100,0,44,44
Taheem,M,100,0,44,44
Tareq,M,100,0,44,44
Tarvis,M,100,0,44,44
Tashiana,F,100,44,0,44
Tavien,M,100,0,44,44
Tempie,F,100,44,0,44
Teng,M,100,0,44,44
Terrilynn,F,100,44,0,44
Tessah,F,100,44,0,44
Thi,F,100,44,0,44
Tiegan,F,84,37,7,44
Tige,M,100,0,44,44
Tram,F,100,44,0,44
Trask,M,100,0,44,44
Tyrianna,F,100,44,0,44
Ulrich,M,100,0,44,44
Valerio,M,100,0,44,44
Verner,M,100,0,44,44
Veroncia,F,100,44,0,44
Virgen,F,100,44,0,44
Virgle,M,100,0,44,44
Waleska,F,100,44,0,44
Xadrian,M,100,0,44,44
Yailyn,F,100,44,0,44
Yaritzi,F,100,44,0,44
Yazlyn,F,100,44,0,44
Ying,F,70,31,13,44
Yolando,F,100,44,0,44
Ysenia,F,100,44,0,44
Yuritza,F,100,44,0,44
Zacariah,M,100,0,44,44
Zedrick,M,100,0,44,44
Zidan,M,100,0,44,44
Zuriah,F,86,38,6,44
Aaria,F,100,43,0,43
Abdifatah,M,100,0,43,43
Abie,M,77,10,33,43
Abri,F,100,43,0,43
Adaliz,F,100,43,0,43
Adriona,F,100,43,0,43
Afua,F,100,43,0,43
Agostino,M,100,0,43,43
Ahniyah,F,100,43,0,43
Airyanna,F,100,43,0,43
Ajai,F,51,22,21,43
Ajdin,M,100,0,43,43
Alaila,F,100,43,0,43
Alakai,M,100,0,43,43
Alayzia,F,100,43,0,43
Aleesia,F,100,43,0,43
Alexsandro,M,100,0,43,43
Alik,M,88,5,38,43
Allure,F,100,43,0,43
Allycia,F,100,43,0,43
Alvera,F,100,43,0,43
Ameila,F,100,43,0,43
Amenda,F,100,43,0,43
Ane,F,100,43,0,43
Anmarie,F,100,43,0,43
Anshika,F,100,43,0,43
Areeb,M,100,0,43,43
Arek,M,100,0,43,43
Arlynn,F,100,43,0,43
Arsalan,M,100,0,43,43
Artavius,M,100,0,43,43
Avelynn,F,100,43,0,43
Aymen,M,100,0,43,43
Aysa,F,100,43,0,43
Azalee,F,100,43,0,43
Berk,M,100,0,43,43
Bina,F,100,43,0,43
Binh,M,100,0,43,43
Blimie,F,100,43,0,43
Brallan,M,100,0,43,43
Brannan,M,100,0,43,43
Breleigh,F,100,43,0,43
Brendy,F,100,43,0,43
Bretta,F,100,43,0,43
Cadee,F,100,43,0,43
Caeleb,M,100,0,43,43
Candon,M,100,0,43,43
Carden,M,100,0,43,43
Carena,F,100,43,0,43
Carletha,F,100,43,0,43
Cendy,F,100,43,0,43
Chaddrick,M,100,0,43,43
Charisa,F,100,43,0,43
Charmel,F,100,43,0,43
Charron,F,100,43,0,43
Cheikh,M,100,0,43,43
Chidubem,M,100,0,43,43
Clarabelle,F,100,43,0,43
Claudius,M,100,0,43,43
Colbert,M,100,0,43,43
Courtnay,F,100,43,0,43
Daelan,M,100,0,43,43
Daleah,F,100,43,0,43
Damariz,F,100,43,0,43
Dantrell,M,100,0,43,43
Davieon,M,100,0,43,43
Davona,F,100,43,0,43
Dayjah,F,100,43,0,43
Dedria,F,100,43,0,43
Dejaun,M,100,0,43,43
Demone,M,100,0,43,43
Derwood,M,100,0,43,43
Dewaine,M,100,0,43,43
Dmya,F,100,43,0,43
Dody,F,100,43,0,43
Doroteo,M,100,0,43,43
Duaine,M,100,0,43,43
Eldora,F,100,43,0,43
Eldrick,M,100,0,43,43
Elenore,F,100,43,0,43
Eleonore,F,100,43,0,43
Elleanna,F,100,43,0,43
Escher,M,100,0,43,43
Eulises,M,100,0,43,43
Evanie,F,100,43,0,43
Evi,F,100,43,0,43
Faryn,F,100,43,0,43
Gabbriella,F,100,43,0,43
Galina,F,100,43,0,43
Gates,M,88,5,38,43
Giabella,F,100,43,0,43
Gilmer,M,100,0,43,43
Giorgia,F,100,43,0,43
Glori,F,100,43,0,43
Haliegh,F,100,43,0,43
Haylin,F,100,43,0,43
Hether,F,100,43,0,43
Hutton,M,100,0,43,43
Ivo,M,100,0,43,43
Jackquline,F,100,43,0,43
Jadrien,M,100,0,43,43
Jaeleigh,F,100,43,0,43
Jahira,F,100,43,0,43
Jaiana,F,100,43,0,43
Jameisha,F,100,43,0,43
Jamesa,F,100,43,0,43
Jatziry,F,100,43,0,43
Jazmon,F,81,35,8,43
Jehan,F,53,23,20,43
Jeison,M,100,0,43,43
Jenney,F,100,43,0,43
Jermany,F,72,31,12,43
Jermayne,M,100,0,43,43
Jerzee,F,100,43,0,43
Jhalil,M,100,0,43,43
Joh,M,100,0,43,43
Jolissa,F,100,43,0,43
Jomari,M,86,6,37,43
Joncarlos,M,100,0,43,43
Jourdin,F,72,31,12,43
Julliana,F,100,43,0,43
Julyan,M,100,0,43,43
Kae,F,100,43,0,43
Kaled,M,100,0,43,43
Kalesha,F,100,43,0,43
Kaliegh,F,100,43,0,43
Kaniesha,F,100,43,0,43
Kariah,F,100,43,0,43
Karthikeya,M,100,0,43,43
Katelan,F,100,43,0,43
Kayvion,M,100,0,43,43
Keidy,F,100,43,0,43
Kelee,F,100,43,0,43
Kelisha,F,100,43,0,43
Kellene,F,100,43,0,43
Kenechukwu,M,100,0,43,43
Kinberly,F,100,43,0,43
Lahna,F,100,43,0,43
Lalah,F,100,43,0,43
Latitia,F,100,43,0,43
Leeyah,F,100,43,0,43
Leira,F,100,43,0,43
Lenay,F,100,43,0,43
Lexton,M,100,0,43,43
Linde,F,100,43,0,43
Lindie,F,100,43,0,43
Lorenso,M,100,0,43,43
Lorilyn,F,100,43,0,43
Lumen,F,84,36,7,43
Lynsi,F,100,43,0,43
Maanya,F,100,43,0,43
Maely,F,100,43,0,43
Makesha,F,100,43,0,43
Maleik,M,100,0,43,43
Margretta,F,100,43,0,43
Marigold,F,100,43,0,43
Marilynne,F,100,43,0,43
Mashayla,F,100,43,0,43
Matai,M,100,0,43,43
Meliss,F,100,43,0,43
Meosha,F,100,43,0,43
Merlinda,F,100,43,0,43
Merline,F,100,43,0,43
Miciah,M,58,18,25,43
Milburn,M,100,0,43,43
Monti,M,84,7,36,43
Moroni,M,100,0,43,43
Mulan,F,100,43,0,43
Myangel,F,100,43,0,43
Mylissa,F,100,43,0,43
Nadean,F,100,43,0,43
Nadim,M,100,0,43,43
Nai,F,74,32,11,43
Naiyah,F,100,43,0,43
Najia,F,100,43,0,43
Natnael,M,100,0,43,43
Nohemy,F,100,43,0,43
North,M,100,0,43,43
Nysa,F,100,43,0,43
Onnie,F,63,27,16,43
Paisyn,F,100,43,0,43
Paxten,M,74,11,32,43
Quiara,F,100,43,0,43
Rahmir,M,100,0,43,43
Rakayla,F,100,43,0,43
Raziya,F,100,43,0,43
Remo,M,100,0,43,43
Renan,M,100,0,43,43
Rheya,F,100,43,0,43
Rhyker,M,100,0,43,43
Rozalynn,F,100,43,0,43
Rumaysa,F,100,43,0,43
Rumi,F,53,23,20,43
Sequan,M,100,0,43,43
Shar,F,100,43,0,43
Shashank,M,100,0,43,43
Sheppard,M,100,0,43,43
Simi,F,100,43,0,43
Sirius,M,100,0,43,43
Stevin,M,100,0,43,43
Strider,M,100,0,43,43
Talbert,M,100,0,43,43
Tameem,M,100,0,43,43
Tashon,M,100,0,43,43
Teneshia,F,100,43,0,43
Tenleigh,F,100,43,0,43
Texas,M,86,6,37,43
Theola,F,100,43,0,43
Tika,F,100,43,0,43
Trashawn,M,84,7,36,43
Treg,M,100,0,43,43
Trellis,F,56,24,19,43
Treylon,M,100,0,43,43
Tzipporah,F,100,43,0,43
Vinicio,M,100,0,43,43
Waddell,M,100,0,43,43
Wyatte,M,100,0,43,43
Wylene,F,100,43,0,43
Xaden,M,100,0,43,43
Yong,M,88,5,38,43
Zamirah,F,100,43,0,43
Zanyiah,F,100,43,0,43
Zaydon,M,100,0,43,43
Ziana,F,100,43,0,43
Ziyan,M,51,21,22,43
Aasha,F,100,42,0,42
Abdon,M,100,0,42,42
Abygale,F,100,42,0,42
Addeline,F,100,42,0,42
Adylene,F,100,42,0,42
Afia,F,100,42,0,42
Ailen,F,100,42,0,42
Akiko,F,100,42,0,42
Alis,F,100,42,0,42
Alvah,M,100,0,42,42
Alyra,F,100,42,0,42
Amish,M,100,0,42,42
Amulya,F,100,42,0,42
Anaisa,F,100,42,0,42
Anaka,F,100,42,0,42
Analisse,F,100,42,0,42
Andrzej,M,100,0,42,42
Aniket,M,100,0,42,42
Annalena,F,100,42,0,42
Archana,F,100,42,0,42
Arelly,F,100,42,0,42
Ariam,F,100,42,0,42
Ashya,F,100,42,0,42
Asja,F,100,42,0,42
Aubrea,F,100,42,0,42
Aurelie,F,100,42,0,42
Austynn,F,100,42,0,42
Avana,F,100,42,0,42
Averly,F,100,42,0,42
Aylani,F,100,42,0,42
Azaliah,F,100,42,0,42
Belkis,F,100,42,0,42
Brenleigh,F,100,42,0,42
Brentt,M,100,0,42,42
Brittne,F,100,42,0,42
Budd,M,100,0,42,42
Cadarius,M,100,0,42,42
Calixto,M,100,0,42,42
Chanae,F,100,42,0,42
Chanze,M,100,0,42,42
Cherylyn,F,100,42,0,42
Christohper,M,100,0,42,42
Chue,M,100,0,42,42
Clarrissa,F,100,42,0,42
Dala,F,100,42,0,42
Damarrion,M,100,0,42,42
Danyka,F,100,42,0,42
Darral,M,100,0,42,42
Darrielle,F,100,42,0,42
Dawnielle,F,100,42,0,42
Daxtyn,M,100,0,42,42
Deisha,F,100,42,0,42
Delecia,F,100,42,0,42
Deshonda,F,100,42,0,42
Deston,M,100,0,42,42
Devaun,M,100,0,42,42
Diezel,M,100,0,42,42
Digna,F,100,42,0,42
Domanique,F,69,29,13,42
Donnisha,F,100,42,0,42
Ediberto,M,100,0,42,42
Edrian,M,100,0,42,42
Elenor,F,100,42,0,42
Eleora,F,100,42,0,42
Eliceo,M,100,0,42,42
Elleana,F,100,42,0,42
Emaly,F,100,42,0,42
Emelly,F,100,42,0,42
Erandy,F,100,42,0,42
Etan,M,100,0,42,42
Ethelyn,F,100,42,0,42
Euna,F,100,42,0,42
Eyleen,F,100,42,0,42
Fadumo,F,100,42,0,42
Farryn,F,100,42,0,42
Filemon,M,100,0,42,42
Fotini,F,100,42,0,42
Geana,F,100,42,0,42
Genesys,F,100,42,0,42
Gizel,F,100,42,0,42
Hang,F,100,42,0,42
Harnoor,F,76,32,10,42
Hartlee,F,100,42,0,42
Hughie,M,100,0,42,42
Itamar,M,86,6,36,42
Iya,F,100,42,0,42
Jacolyn,F,100,42,0,42
Jadien,M,100,0,42,42
Jahad,M,100,0,42,42
Jahki,M,100,0,42,42
Jaidynn,F,88,37,5,42
Jaimy,F,100,42,0,42
Jakaylah,F,100,42,0,42
Jakel,M,100,0,42,42
Jamarrion,M,100,0,42,42
Jaquana,F,100,42,0,42
Jasman,F,88,37,5,42
Jatziri,F,100,42,0,42
Jazline,F,100,42,0,42
Jazmarie,F,100,42,0,42
Jency,F,100,42,0,42
Jenicka,F,100,42,0,42
Jeniya,F,100,42,0,42
Jermarcus,M,100,0,42,42
Jonisha,F,100,42,0,42
Jorgeluis,M,100,0,42,42
Juhi,F,100,42,0,42
Kacia,F,100,42,0,42
Kaida,F,100,42,0,42
Kanai,M,64,15,27,42
Kanen,M,100,0,42,42
Kaysan,M,100,0,42,42
Keilee,F,100,42,0,42
Keirstyn,F,100,42,0,42
Kel,M,100,0,42,42
Kenitra,F,100,42,0,42
Kennidy,F,100,42,0,42
Kenshin,M,100,0,42,42
Keyden,M,100,0,42,42
Keynan,M,100,0,42,42
Khamya,F,100,42,0,42
Khylen,M,100,0,42,42
Kiet,M,100,0,42,42
Kourtlyn,F,100,42,0,42
Krue,M,100,0,42,42
Kyshawn,M,100,0,42,42
Lakiyah,F,100,42,0,42
Larenda,F,100,42,0,42
Lasonia,F,100,42,0,42
Latania,F,100,42,0,42
Lenn,M,86,6,36,42
Leonia,F,100,42,0,42
Lesleigh,F,100,42,0,42
Leviathan,M,100,0,42,42
Liban,M,100,0,42,42
Linzey,F,100,42,0,42
Loreta,F,100,42,0,42
Luzelena,F,100,42,0,42
Maaliyah,F,100,42,0,42
Maddalynn,F,100,42,0,42
Magalie,F,100,42,0,42
Makenlee,F,100,42,0,42
Malie,F,100,42,0,42
Manaal,F,100,42,0,42
Marayah,F,100,42,0,42
Mare,M,100,0,42,42
Martisha,F,100,42,0,42
Marvens,M,100,0,42,42
Masai,M,100,0,42,42
Meghin,F,100,42,0,42
Melda,F,100,42,0,42
Merrilyn,F,100,42,0,42
Mikaylee,F,100,42,0,42
Mikhaila,F,100,42,0,42
Milliana,F,100,42,0,42
Mirka,F,100,42,0,42
Mohan,M,100,0,42,42
Moncerrat,F,100,42,0,42
Monia,F,100,42,0,42
Moniqua,F,100,42,0,42
Murat,M,100,0,42,42
Nakyah,F,100,42,0,42
Nawaf,M,100,0,42,42
Neale,M,100,0,42,42
Noami,F,100,42,0,42
Nylan,M,100,0,42,42
Olevia,F,100,42,0,42
Orenthal,M,100,0,42,42
Oreoluwa,F,52,22,20,42
Patrece,F,100,42,0,42
Preeti,F,100,42,0,42
Raguel,F,100,42,0,42
Raider,M,100,0,42,42
Rashawnda,F,100,42,0,42
Rashunda,F,100,42,0,42
Reet,F,100,42,0,42
Reiner,M,100,0,42,42
Resha,F,100,42,0,42
Rommie,M,100,0,42,42
Rosco,M,100,0,42,42
Sanaii,F,100,42,0,42
Sarim,M,100,0,42,42
Sarthak,M,100,0,42,42
Savino,M,100,0,42,42
Sayer,M,100,0,42,42
Senora,F,100,42,0,42
Shaianne,F,100,42,0,42
Shalina,F,100,42,0,42
Sharmin,F,100,42,0,42
Sharnae,F,100,42,0,42
Shaunak,M,100,0,42,42
Shawnya,F,100,42,0,42
Sheana,F,100,42,0,42
Shelva,F,100,42,0,42
Shiquita,F,100,42,0,42
Shubham,M,100,0,42,42
Sonnet,F,100,42,0,42
Sophy,F,100,42,0,42
Sotirios,M,100,0,42,42
Srihan,M,100,0,42,42
Sterlin,M,100,0,42,42
Sulma,F,100,42,0,42
Synia,F,100,42,0,42
Taleigha,F,100,42,0,42
Tameisha,F,100,42,0,42
Tanveer,M,88,5,37,42
Tauni,F,100,42,0,42
Taygen,M,55,19,23,42
Tayvian,M,100,0,42,42
Tensley,F,100,42,0,42
Teodor,M,100,0,42,42
Tevan,M,100,0,42,42
Tian,M,57,18,24,42
Tierre,M,74,11,31,42
Tishawn,M,71,12,30,42
Tiwana,F,100,42,0,42
Toba,F,100,42,0,42
Trip,M,100,0,42,42
Tu,M,69,13,29,42
Tyshun,M,100,0,42,42
Vaeda,F,100,42,0,42
Valena,F,100,42,0,42
Vangie,F,100,42,0,42
Verle,M,100,0,42,42
Versie,F,100,42,0,42
Vitaliy,M,100,0,42,42
Wacey,M,100,0,42,42
Wess,M,100,0,42,42
Wilfrido,M,100,0,42,42
Windsor,F,60,25,17,42
Xane,M,100,0,42,42
Xayvion,M,100,0,42,42
Yaileen,F,100,42,0,42
Yani,F,74,31,11,42
Yasha,F,100,42,0,42
Yashvi,F,100,42,0,42
Yazaira,F,100,42,0,42
Yeni,F,100,42,0,42
Yostin,M,100,0,42,42
Yulian,M,100,0,42,42
Zailyn,F,62,26,16,42
Zamyah,F,100,42,0,42
Zanyia,F,100,42,0,42
Zaryiah,F,100,42,0,42
Zerrick,M,100,0,42,42
Zoelle,F,100,42,0,42
Zylan,M,100,0,42,42
Zyquan,M,100,0,42,42
Aaliyha,F,100,41,0,41
Aamina,F,100,41,0,41
Aayushi,F,100,41,0,41
Adolf,M,100,0,41,41
Adriannah,F,100,41,0,41
Aireanna,F,100,41,0,41
Aiven,M,100,0,41,41
Akio,M,100,0,41,41
Alexzandrea,F,100,41,0,41
Alynn,F,100,41,0,41
Alyzah,F,100,41,0,41
Amad,M,100,0,41,41
Amorie,F,100,41,0,41
Amra,F,100,41,0,41
Anavictoria,F,100,41,0,41
Anberlin,F,100,41,0,41
Anesa,F,100,41,0,41
Angelmarie,F,100,41,0,41
Anishka,F,100,41,0,41
Antionio,M,100,0,41,41
Aprill,F,100,41,0,41
Arcadia,F,100,41,0,41
Arista,F,100,41,0,41
Arjay,M,100,0,41,41
Ashaunti,F,100,41,0,41
Atheena,F,100,41,0,41
Aubryanna,F,100,41,0,41
Axyl,M,100,0,41,41
Azad,M,100,0,41,41
Bailyn,F,100,41,0,41
Barbaraann,F,100,41,0,41
Belem,F,100,41,0,41
Benetta,F,100,41,0,41
Betti,F,100,41,0,41
Bralen,M,100,0,41,41
Briaunna,F,100,41,0,41
Brissia,F,100,41,0,41
Caitlynne,F,100,41,0,41
Calem,M,100,0,41,41
Canisha,F,100,41,0,41
Carle,M,68,13,28,41
Cassity,F,100,41,0,41
Chantalle,F,100,41,0,41
Chee,F,66,27,14,41
Christyna,F,100,41,0,41
Ciena,F,100,41,0,41
Corian,M,100,0,41,41
Creek,M,100,0,41,41
Dacari,M,100,0,41,41
Dagen,M,100,0,41,41
Daimen,M,100,0,41,41
Danilynn,F,100,41,0,41
Deajah,F,100,41,0,41
Deaundra,F,78,32,9,41
Dejohn,M,100,0,41,41
Dermot,M,100,0,41,41
Donata,F,100,41,0,41
Donoven,M,100,0,41,41
Doree,F,100,41,0,41
Drayven,M,100,0,41,41
Drelyn,M,100,0,41,41
Dsean,M,100,0,41,41
Earon,M,100,0,41,41
Eathen,M,100,0,41,41
Emiah,F,100,41,0,41
Emmajean,F,100,41,0,41
Emmalene,F,100,41,0,41
Errica,F,100,41,0,41
Esthela,F,100,41,0,41
Eyden,M,100,0,41,41
Gaila,F,100,41,0,41
Gaylyn,F,100,41,0,41
Geo,M,100,0,41,41
Glade,M,100,0,41,41
Griselle,F,100,41,0,41
Halleigh,F,100,41,0,41
Halyn,F,100,41,0,41
Hamed,M,100,0,41,41
Hamish,M,100,0,41,41
Hayla,F,100,41,0,41
Higinio,M,100,0,41,41
Idell,F,100,41,0,41
Ifeoma,F,100,41,0,41
Ilea,F,100,41,0,41
Indiya,F,100,41,0,41
Jaeceon,M,100,0,41,41
Jahquan,M,100,0,41,41
Jameis,M,100,0,41,41
Jamoni,M,61,16,25,41
Jatavion,M,100,0,41,41
Javius,M,100,0,41,41
Jermie,M,100,0,41,41
Jesalyn,F,100,41,0,41
Jilliann,F,100,41,0,41
Jlyn,M,51,20,21,41
Jolan,M,59,17,24,41
Josejuan,M,100,0,41,41
Joshuwa,M,100,0,41,41
Juandedios,M,100,0,41,41
Juliocesar,M,100,0,41,41
Kaaren,F,100,41,0,41
Kaedan,M,100,0,41,41
Kameelah,F,100,41,0,41
Kanin,M,100,0,41,41
Kassady,F,100,41,0,41
Kassim,M,100,0,41,41
Kaydi,F,100,41,0,41
Kaydince,F,100,41,0,41
Kayelyn,F,100,41,0,41
Kaylianna,F,100,41,0,41
Kayloni,F,100,41,0,41
Kayron,M,83,7,34,41
Kayton,F,51,21,20,41
Keishon,M,100,0,41,41
Kelie,F,100,41,0,41
Kendry,M,88,5,36,41
Keyna,F,100,41,0,41
Keyonia,F,100,41,0,41
Keyonta,M,71,12,29,41
Khaliya,F,100,41,0,41
Khloi,F,100,41,0,41
Kierah,F,100,41,0,41
Kimorah,F,100,41,0,41
Kinslie,F,100,41,0,41
Krishan,M,100,0,41,41
Kross,M,100,0,41,41
Kroy,M,100,0,41,41
Krupa,F,100,41,0,41
Kwane,M,100,0,41,41
Labria,F,100,41,0,41
Laisa,F,100,41,0,41
Lavontae,M,100,0,41,41
Leandria,F,100,41,0,41
Leita,F,100,41,0,41
Leonid,M,100,0,41,41
Letizia,F,100,41,0,41
Lexani,F,100,41,0,41
Lexxi,F,100,41,0,41
Linzee,F,100,41,0,41
Liston,M,100,0,41,41
Livi,F,100,41,0,41
Lorrain,F,100,41,0,41
Lorre,F,100,41,0,41
Lucerito,F,100,41,0,41
Lucianne,F,100,41,0,41
Luisana,F,100,41,0,41
Luisenrique,M,100,0,41,41
Lyan,M,80,8,33,41
Lydiah,F,100,41,0,41
Magnum,M,100,0,41,41
Mahaley,F,100,41,0,41
Mahira,F,100,41,0,41
Makalia,F,100,41,0,41
Makaylie,F,100,41,0,41
Malon,F,54,22,19,41
Manas,M,100,0,41,41
Mandel,M,100,0,41,41
Marcedes,F,100,41,0,41
Marcin,M,100,0,41,41
Margrett,F,100,41,0,41
Marifer,F,100,41,0,41
Markeya,F,100,41,0,41
Marsean,M,100,0,41,41
Martiza,F,100,41,0,41
Marven,M,100,0,41,41
Mashell,F,100,41,0,41
Maurisa,F,100,41,0,41
Maximilien,M,100,0,41,41
Mckaylah,F,100,41,0,41
Mckenlee,F,100,41,0,41
Melecio,M,100,0,41,41
Merril,M,59,17,24,41
Mesiah,M,100,0,41,41
Michalene,F,100,41,0,41
Millenia,F,100,41,0,41
Moreen,F,100,41,0,41
Moustapha,M,100,0,41,41
Muad,M,100,0,41,41
Mujahid,M,100,0,41,41
Mystic,F,100,41,0,41
Navon,M,100,0,41,41
Nayelly,F,100,41,0,41
Nechelle,F,100,41,0,41
Nicolaas,M,100,0,41,41
Nikitha,F,100,41,0,41
Nitza,F,100,41,0,41
Norval,M,100,0,41,41
Oleg,M,100,0,41,41
Olena,F,100,41,0,41
Othman,M,100,0,41,41
Pallavi,F,100,41,0,41
Philana,F,100,41,0,41
Phill,M,100,0,41,41
Providence,F,100,41,0,41
Quadarius,M,100,0,41,41
Raeley,F,100,41,0,41
Raimundo,M,100,0,41,41
Raney,F,83,34,7,41
Reita,F,100,41,0,41
Rejeana,F,100,41,0,41
Rohen,M,100,0,41,41
Rosabelle,F,100,41,0,41
Rune,M,88,5,36,41
Ryelee,F,71,29,12,41
Saki,F,100,41,0,41
Sarahjane,F,100,41,0,41
Sarajane,F,100,41,0,41
Seiji,M,100,0,41,41
Shanai,F,100,41,0,41
Shanin,F,100,41,0,41
Sharalyn,F,100,41,0,41
Shaylea,F,100,41,0,41
Shelena,F,100,41,0,41
Shelisa,F,100,41,0,41
Shenia,F,100,41,0,41
Shloimy,M,100,0,41,41
Shoua,F,66,27,14,41
Shylynn,F,100,41,0,41
Sieanna,F,100,41,0,41
Siona,F,100,41,0,41
Snigdha,F,100,41,0,41
Sophiah,F,100,41,0,41
Spurgeon,M,100,0,41,41
Stepheny,F,100,41,0,41
Stevee,F,100,41,0,41
Sudie,F,100,41,0,41
Sujay,M,100,0,41,41
Summar,F,100,41,0,41
Syndi,F,100,41,0,41
Taim,M,100,0,41,41
Tamyah,F,100,41,0,41
Tanga,F,100,41,0,41
Tarique,M,100,0,41,41
Tarry,M,80,8,33,41
Tatumn,F,100,41,0,41
Teala,F,100,41,0,41
Tennie,F,100,41,0,41
Terelle,M,100,0,41,41
Teyla,F,100,41,0,41
Thia,F,100,41,0,41
Thong,M,100,0,41,41
Tiandra,F,100,41,0,41
Tomara,F,100,41,0,41
Trayveon,M,100,0,41,41
Trenia,F,100,41,0,41
Tulsi,F,100,41,0,41
Tvisha,F,100,41,0,41
Tyger,M,100,0,41,41
Tyion,M,100,0,41,41
Tyjon,M,100,0,41,41
Unnamed,M,61,16,25,41
Vaishali,F,100,41,0,41
Vonn,M,100,0,41,41
Wenceslao,M,100,0,41,41
Weslyn,F,80,33,8,41
Yarielis,F,100,41,0,41
Ylonda,F,100,41,0,41
Yosgart,M,100,0,41,41
Yuriko,F,100,41,0,41
Zaydee,F,100,41,0,41
Zeshan,M,100,0,41,41
Zetta,F,100,41,0,41
Zyier,M,100,0,41,41
Aaryanna,F,100,40,0,40
Aeneas,M,100,0,40,40
Aftyn,F,100,40,0,40
Agata,F,100,40,0,40
Aidel,F,100,40,0,40
Aijah,F,100,40,0,40
Ailis,F,100,40,0,40
Alima,F,100,40,0,40
Alissandra,F,100,40,0,40
Aloma,F,100,40,0,40
Alonnah,F,100,40,0,40
Alyss,F,100,40,0,40
Ameyah,F,100,40,0,40
Anasophia,F,100,40,0,40
Angeleen,F,100,40,0,40
Anjalee,F,100,40,0,40
Annahi,F,100,40,0,40
Anneli,F,100,40,0,40
Arpan,M,100,0,40,40
Arrielle,F,100,40,0,40
Arthuro,M,100,0,40,40
Aryam,F,100,40,0,40
Ashlye,F,100,40,0,40
Ashok,M,100,0,40,40
Askia,M,100,0,40,40
Audrinna,F,100,40,0,40
Aveyah,F,100,40,0,40
Avigdor,M,100,0,40,40
Ayani,F,100,40,0,40
Ayrabella,F,100,40,0,40
Azhar,M,62,15,25,40
Bairon,M,100,0,40,40
Baleria,F,100,40,0,40
Barnard,M,100,0,40,40
Bary,M,100,0,40,40
Breea,F,100,40,0,40
Brenson,M,100,0,40,40
Britanie,F,100,40,0,40
Brooklen,F,100,40,0,40
Brown,M,100,0,40,40
Brysin,M,100,0,40,40
Camesha,F,100,40,0,40
Carolene,F,100,40,0,40
Carrah,F,100,40,0,40
Caylan,F,52,21,19,40
Cearra,F,100,40,0,40
Celicia,F,100,40,0,40
Chalmers,M,100,0,40,40
Charmine,F,100,40,0,40
Christabelle,F,100,40,0,40
Christepher,M,100,0,40,40
Clearence,M,100,0,40,40
Cleatus,M,100,0,40,40
Cordaro,M,100,0,40,40
Crisanto,M,100,0,40,40
Cyann,F,100,40,0,40
Czarina,F,100,40,0,40
Daltyn,M,100,0,40,40
Damary,F,100,40,0,40
Danely,F,100,40,0,40
Danish,M,100,0,40,40
Dazia,F,100,40,0,40
Deetya,F,100,40,0,40
Delaynie,F,100,40,0,40
Denea,F,100,40,0,40
Derico,M,100,0,40,40
Deshannon,F,70,28,12,40
Deziah,F,88,35,5,40
Diannia,F,100,40,0,40
Donyelle,F,100,40,0,40
Dorathy,F,100,40,0,40
Dow,M,100,0,40,40
Doyce,M,100,0,40,40
Dshaun,M,100,0,40,40
Duc,M,100,0,40,40
Duval,M,100,0,40,40
Ellagrace,F,100,40,0,40
Embree,F,100,40,0,40
Estaban,M,100,0,40,40
Ewell,M,100,0,40,40
Fateh,M,100,0,40,40
Favour,F,100,40,0,40
Fielding,M,100,0,40,40
Floy,F,80,32,8,40
Franko,M,100,0,40,40
Galileo,M,100,0,40,40
Gaylynn,F,100,40,0,40
Gerrad,M,100,0,40,40
Godwin,M,100,0,40,40
Gustabo,M,100,0,40,40
Harald,M,100,0,40,40
Husam,M,100,0,40,40
Iliyah,F,100,40,0,40
Island,F,100,40,0,40
Ivar,M,100,0,40,40
Izack,M,100,0,40,40
Izeah,M,100,0,40,40
Jabree,M,88,5,35,40
Jaelan,M,85,6,34,40
Jakhai,M,100,0,40,40
Jaleeyah,F,100,40,0,40
Jalise,F,100,40,0,40
Jasimine,F,100,40,0,40
Javante,M,100,0,40,40
Javeah,F,100,40,0,40
Jayko,M,100,0,40,40
Jaylenne,F,100,40,0,40
Jceon,M,100,0,40,40
Jeanclaude,M,100,0,40,40
Jennett,F,100,40,0,40
Jennilyn,F,100,40,0,40
Jermya,F,100,40,0,40
Jeylin,F,100,40,0,40
Joniyah,F,100,40,0,40
Joretta,F,100,40,0,40
Josecarlos,M,100,0,40,40
Journii,F,100,40,0,40
Jovian,M,100,0,40,40
Juanetta,F,100,40,0,40
Kaileah,F,100,40,0,40
Kaly,F,100,40,0,40
Kamarii,F,52,21,19,40
Kamika,F,100,40,0,40
Kartik,M,100,0,40,40
Katha,F,100,40,0,40
Kayda,F,100,40,0,40
Kazi,M,70,12,28,40
Keevon,M,100,0,40,40
Kelbie,F,100,40,0,40
Kelii,M,100,0,40,40
Kember,F,100,40,0,40
Kendan,M,100,0,40,40
Kerron,M,100,0,40,40
Kewan,M,100,0,40,40
Keyondre,M,100,0,40,40
Kimbely,F,100,40,0,40
Kimm,F,80,32,8,40
Kobee,M,100,0,40,40
Korry,M,82,7,33,40
Kostas,M,100,0,40,40
Kristain,F,72,29,11,40
Kristof,M,100,0,40,40
Kyiah,F,100,40,0,40
Kymir,M,100,0,40,40
Kynedi,F,100,40,0,40
Kyngston,M,100,0,40,40
Kynzlie,F,100,40,0,40
Lamika,F,100,40,0,40
Laqueta,F,100,40,0,40
Layana,F,100,40,0,40
Laycie,F,100,40,0,40
Lendon,M,100,0,40,40
Lillien,F,100,40,0,40
Lillyonna,F,100,40,0,40
Livie,F,100,40,0,40
Lovette,F,100,40,0,40
Lowanda,F,100,40,0,40
Lynea,F,100,40,0,40
Magdiel,M,88,5,35,40
Malayshia,F,100,40,0,40
Mame,F,100,40,0,40
Mariangel,F,100,40,0,40
Marico,M,100,0,40,40
Marquesha,F,100,40,0,40
Masson,M,100,0,40,40
Matthan,M,100,0,40,40
Mccartney,F,85,34,6,40
Melah,F,100,40,0,40
Melik,M,100,0,40,40
Melvia,F,100,40,0,40
Meridian,F,100,40,0,40
Michah,M,100,0,40,40
Michalle,F,100,40,0,40
Milos,M,100,0,40,40
Mishel,F,100,40,0,40
Missi,F,100,40,0,40
Mont,M,100,0,40,40
Montavius,M,100,0,40,40
Myer,M,100,0,40,40
Naveyah,F,100,40,0,40
Neelam,F,100,40,0,40
Neenah,F,100,40,0,40
Netanel,M,100,0,40,40
Nhan,M,100,0,40,40
Oisin,M,100,0,40,40
Ondre,M,100,0,40,40
Patra,F,100,40,0,40
Pau,M,100,0,40,40
Pearly,F,100,40,0,40
Peightyn,F,100,40,0,40
Peytin,F,100,40,0,40
Pharrell,M,100,0,40,40
Phinehas,M,100,0,40,40
Qadir,M,100,0,40,40
Quantrell,M,100,0,40,40
Quintan,M,100,0,40,40
Rai,M,72,11,29,40
Raif,M,100,0,40,40
Raneisha,F,100,40,0,40
Rashi,F,75,30,10,40
Rexton,M,100,0,40,40
Rhianon,F,100,40,0,40
Rhylen,M,68,13,27,40
Rolonda,F,100,40,0,40
Romen,M,100,0,40,40
Ronique,F,100,40,0,40
Ruhaan,M,100,0,40,40
Sabree,F,88,35,5,40
Sabri,M,75,10,30,40
Sadey,F,100,40,0,40
Samarion,M,100,0,40,40
Serrina,F,100,40,0,40
Shadoe,M,62,15,25,40
Shady,F,58,23,17,40
Shahan,M,100,0,40,40
Shailene,F,100,40,0,40
Sheikh,M,100,0,40,40
Sherae,F,100,40,0,40
Sheresa,F,100,40,0,40
Shiri,F,100,40,0,40
Shirlean,F,100,40,0,40
Shrihan,M,100,0,40,40
Shriyan,M,100,0,40,40
Skarlet,F,100,40,0,40
Slayde,M,100,0,40,40
Slayton,M,100,0,40,40
Sophea,F,100,40,0,40
Soumya,F,100,40,0,40
Sundae,F,100,40,0,40
Sura,F,100,40,0,40
Sydny,F,100,40,0,40
Syra,F,100,40,0,40
Tadarius,M,100,0,40,40
Taden,M,100,0,40,40
Taeler,F,100,40,0,40
Tahmid,M,100,0,40,40
Taiwo,M,58,17,23,40
Tashira,F,100,40,0,40
Teagyn,F,80,32,8,40
Teirra,F,100,40,0,40
Terrina,F,100,40,0,40
Thadius,M,100,0,40,40
Theodoros,M,100,0,40,40
Thierno,M,100,0,40,40
Tiyonna,F,100,40,0,40
Tobby,M,100,0,40,40
Trayon,M,100,0,40,40
Trejon,M,100,0,40,40
Trendon,M,100,0,40,40
Trevar,M,100,0,40,40
Tyquez,M,100,0,40,40
Vaneza,F,100,40,0,40
Vernia,F,100,40,0,40
Waylin,M,100,0,40,40
Wilhelmenia,F,100,40,0,40
Yandiel,M,100,0,40,40
Yishai,M,100,0,40,40
Younes,M,100,0,40,40
Zackry,M,100,0,40,40
Zamantha,F,100,40,0,40
Zeriah,F,88,35,5,40
Abreanna,F,100,39,0,39
Adalaide,F,100,39,0,39
Addilee,F,100,39,0,39
Adeeb,M,100,0,39,39
Adianna,F,100,39,0,39
Adrianah,F,100,39,0,39
Aidenn,M,100,0,39,39
Ajax,M,100,0,39,39
Akina,F,100,39,0,39
Alaena,F,100,39,0,39
Alaylah,F,100,39,0,39
Aleisa,F,100,39,0,39
Altha,F,100,39,0,39
Amarra,F,100,39,0,39
Amely,F,100,39,0,39
Ameris,F,100,39,0,39
Amyjo,F,100,39,0,39
Anamika,F,100,39,0,39
Anara,F,100,39,0,39
Ancel,M,100,0,39,39
Angelino,M,100,0,39,39
Annick,F,100,39,0,39
Antonya,F,100,39,0,39
Aqueelah,F,100,39,0,39
Artavious,M,100,0,39,39
Ashleyann,F,100,39,0,39
Assunta,F,100,39,0,39
Aubrii,F,100,39,0,39
Aunika,F,100,39,0,39
Aurie,F,100,39,0,39
Avaline,F,100,39,0,39
Avaneesh,M,100,0,39,39
Avarose,F,100,39,0,39
Ayce,M,100,0,39,39
Ayham,M,100,0,39,39
Azuri,F,100,39,0,39
Barack,M,100,0,39,39
Barkley,M,100,0,39,39
Baudelio,M,100,0,39,39
Becka,F,100,39,0,39
Belma,F,100,39,0,39
Berkleigh,F,100,39,0,39
Bienvenido,M,100,0,39,39
Birgit,F,100,39,0,39
Blakelynn,F,100,39,0,39
Bonna,F,100,39,0,39
Braley,F,100,39,0,39
Brance,M,100,0,39,39
Brannen,M,100,0,39,39
Brinna,F,100,39,0,39
Brylei,F,100,39,0,39
Burgess,M,100,0,39,39
Burnette,F,74,29,10,39
Cainen,M,100,0,39,39
Camillo,M,100,0,39,39
Carrianne,F,100,39,0,39
Cassiopeia,F,100,39,0,39
Cathern,F,100,39,0,39
Charvi,F,100,39,0,39
Chayne,M,100,0,39,39
Chenise,F,100,39,0,39
Chera,F,100,39,0,39
Christophr,M,100,0,39,39
Cindia,F,100,39,0,39
Coren,M,67,13,26,39
Corianne,F,100,39,0,39
Courage,M,82,7,32,39
Creig,M,100,0,39,39
Da,M,77,9,30,39
Dalonte,M,100,0,39,39
Dalten,M,100,0,39,39
Damonie,M,64,14,25,39
Dangela,F,100,39,0,39
Darol,M,100,0,39,39
Deashia,F,100,39,0,39
Deberah,F,100,39,0,39
Dekker,M,100,0,39,39
Demaria,F,100,39,0,39
Demitria,F,100,39,0,39
Demiya,F,100,39,0,39
Demorris,M,100,0,39,39
Denaya,F,100,39,0,39
Deyton,M,100,0,39,39
Deztiny,F,100,39,0,39
Diarra,F,100,39,0,39
Donatella,F,100,39,0,39
Donice,F,100,39,0,39
Dorice,F,100,39,0,39
Doyal,M,100,0,39,39
Dyshawn,M,100,0,39,39
Edvardo,M,100,0,39,39
Elasia,F,100,39,0,39
Elize,F,100,39,0,39
Elley,F,100,39,0,39
Emarion,M,100,0,39,39
Ernan,M,100,0,39,39
Erric,M,100,0,39,39
Estill,M,100,0,39,39
Ethon,M,100,0,39,39
Eugina,F,100,39,0,39
Evolette,F,100,39,0,39
Exzavier,M,100,0,39,39
Eziah,M,100,0,39,39
Fatimata,F,100,39,0,39
Fatmata,F,100,39,0,39
Febe,F,100,39,0,39
Findley,M,82,7,32,39
Galena,F,100,39,0,39
Genee,F,100,39,0,39
Genetta,F,100,39,0,39
Goddess,F,100,39,0,39
Greidy,F,100,39,0,39
Greydon,M,100,0,39,39
Gwenette,F,100,39,0,39
Hailea,F,100,39,0,39
Hajra,F,100,39,0,39
Hanad,M,100,0,39,39
Hanifa,F,100,39,0,39
Hareem,F,100,39,0,39
Henrick,M,100,0,39,39
Hesham,M,100,0,39,39
Ikram,F,100,39,0,39
Ileah,F,100,39,0,39
Ita,F,100,39,0,39
Ivin,M,100,0,39,39
Jacqulynn,F,100,39,0,39
Jaiveon,M,100,0,39,39
Jalana,F,100,39,0,39
Jalesia,F,100,39,0,39
Jamiere,M,100,0,39,39
Janesa,F,100,39,0,39
Jasim,M,100,0,39,39
Javaun,M,100,0,39,39
Jayvier,M,100,0,39,39
Jeffie,M,54,18,21,39
Jomarie,F,100,39,0,39
Jondavid,M,100,0,39,39
Jorgen,M,100,0,39,39
Josean,M,100,0,39,39
Jossiah,M,100,0,39,39
Jshawn,M,100,0,39,39
Jyl,F,100,39,0,39
Kaavya,F,100,39,0,39
Kaio,M,100,0,39,39
Kaipo,M,100,0,39,39
Kaizer,M,100,0,39,39
Kalicia,F,100,39,0,39
Karrin,F,100,39,0,39
Kasidee,F,100,39,0,39
Kathleene,F,100,39,0,39
Katreena,F,100,39,0,39
Kawanda,F,100,39,0,39
Kayah,F,100,39,0,39
Kayleeann,F,100,39,0,39
Keegen,M,100,0,39,39
Kemauri,M,87,5,34,39
Keni,F,69,27,12,39
Kepler,M,100,0,39,39
Kerrianne,F,100,39,0,39
Keyly,F,100,39,0,39
Khiley,F,100,39,0,39
Khylan,M,100,0,39,39
Kimyatta,F,100,39,0,39
Kursten,F,100,39,0,39
Kyliah,F,100,39,0,39
Kysha,F,100,39,0,39
Lacole,F,100,39,0,39
Lacrecia,F,100,39,0,39
Lamona,F,100,39,0,39
Landynn,M,56,17,22,39
Larell,M,100,0,39,39
Laryn,F,100,39,0,39
Layten,M,87,5,34,39
Leeam,M,100,0,39,39
Leeandra,F,100,39,0,39
Lenord,M,100,0,39,39
Levester,M,100,0,39,39
Leyda,F,100,39,0,39
Lorra,F,100,39,0,39
Lukah,M,100,0,39,39
Lydiann,F,100,39,0,39
Maebry,F,100,39,0,39
Makenah,F,100,39,0,39
Malvina,F,100,39,0,39
Mariangela,F,100,39,0,39
Marium,F,100,39,0,39
Marykathryn,F,100,39,0,39
Matison,F,100,39,0,39
Maveric,M,100,0,39,39
Maylyn,F,100,39,0,39
Medora,F,100,39,0,39
Michai,M,100,0,39,39
Mikeala,F,100,39,0,39
Milli,F,100,39,0,39
Min,M,69,12,27,39
Mirai,F,100,39,0,39
Mirielle,F,100,39,0,39
Mishka,F,100,39,0,39
Monee,F,100,39,0,39
Montrice,F,74,29,10,39
Myca,F,100,39,0,39
Nastasia,F,100,39,0,39
Natalina,F,100,39,0,39
Natalyah,F,100,39,0,39
Nathasha,F,100,39,0,39
Natsumi,F,100,39,0,39
Nefertari,F,100,39,0,39
Nela,F,100,39,0,39
Neven,M,100,0,39,39
Nichalas,M,100,0,39,39
Nieko,M,100,0,39,39
Nixie,F,100,39,0,39
Nyeem,M,100,0,39,39
Odetta,F,100,39,0,39
Orestes,M,100,0,39,39
Osmara,F,100,39,0,39
Osualdo,M,100,0,39,39
Ozella,F,100,39,0,39
Paras,M,100,0,39,39
Paw,F,100,39,0,39
Pawel,M,100,0,39,39
Rahkeem,M,100,0,39,39
Raistlin,M,100,0,39,39
Remie,F,100,39,0,39
Rogerio,M,100,0,39,39
Ruchama,F,100,39,0,39
Safari,F,87,34,5,39
Samah,F,100,39,0,39
Santhiago,M,100,0,39,39
Saralynn,F,100,39,0,39
Savior,M,100,0,39,39
Shakema,F,100,39,0,39
Shamyia,F,100,39,0,39
Shanekia,F,100,39,0,39
Shanyla,F,100,39,0,39
Shareese,F,100,39,0,39
Sharmane,F,100,39,0,39
Shauntay,F,100,39,0,39
Shellene,F,100,39,0,39
Shelsy,F,100,39,0,39
Sherine,F,100,39,0,39
Shloma,M,100,0,39,39
Shundra,F,100,39,0,39
Shy,F,100,39,0,39
Siah,F,64,25,14,39
Skarlette,F,100,39,0,39
Smriti,F,100,39,0,39
Sofiah,F,100,39,0,39
Sophiya,F,100,39,0,39
Sravya,F,100,39,0,39
Sudais,M,100,0,39,39
Sumeya,F,100,39,0,39
Suraiya,F,100,39,0,39
Taeshawn,M,100,0,39,39
Taym,M,100,0,39,39
Terasa,F,100,39,0,39
Theon,M,77,9,30,39
Thereasa,F,100,39,0,39
Tiasha,F,100,39,0,39
Tomasina,F,100,39,0,39
Torris,M,100,0,39,39
Toshiba,F,100,39,0,39
Traver,M,100,0,39,39
Tresea,F,100,39,0,39
Trilby,F,100,39,0,39
Tyria,F,100,39,0,39
Umer,M,100,0,39,39
Vegas,M,59,16,23,39
Verma,F,100,39,0,39
Wanetta,F,100,39,0,39
Willamina,F,100,39,0,39
Yeira,F,100,39,0,39
Yissel,F,100,39,0,39
Yonas,M,100,0,39,39
Yunuen,F,100,39,0,39
Yuta,M,100,0,39,39
Zaleah,F,100,39,0,39
Zidane,M,100,0,39,39
Zitlaly,F,100,39,0,39
Zonia,F,100,39,0,39
Zunaira,F,100,39,0,39
Aadhav,M,100,0,38,38
Aariv,M,100,0,38,38
Abishai,M,79,8,30,38
Adelene,F,100,38,0,38
Aiken,M,100,0,38,38
Aimy,F,100,38,0,38
Airi,F,100,38,0,38
Aiyonna,F,100,38,0,38
Akeen,M,100,0,38,38
Alaiah,F,100,38,0,38
Alera,F,100,38,0,38
Allexis,F,100,38,0,38
Aloura,F,100,38,0,38
Alyzza,F,100,38,0,38
Amilliana,F,100,38,0,38
Anaria,F,100,38,0,38
Andray,M,100,0,38,38
Anfernee,M,100,0,38,38
Anntoinette,F,100,38,0,38
Antonetta,F,100,38,0,38
Anwita,F,100,38,0,38
Aquil,M,100,0,38,38
Arabia,F,100,38,0,38
Arhan,M,100,0,38,38
Arieal,F,100,38,0,38
Arleta,F,100,38,0,38
Armanie,F,87,33,5,38
Arria,F,100,38,0,38
Arshad,M,100,0,38,38
Asucena,F,100,38,0,38
Ata,M,100,0,38,38
Aubery,M,53,18,20,38
Auriella,F,100,38,0,38
Averiana,F,100,38,0,38
Aydyn,M,100,0,38,38
Aylssa,F,100,38,0,38
Bain,M,100,0,38,38
Beauty,F,100,38,0,38
Blayton,M,100,0,38,38
Bosco,M,100,0,38,38
Bowden,M,100,0,38,38
Braheem,M,100,0,38,38
Brayon,M,100,0,38,38
Brennyn,F,53,20,18,38
Brigitta,F,100,38,0,38
Brinnley,F,100,38,0,38
Brinson,M,100,0,38,38
Brionne,F,100,38,0,38
British,F,87,33,5,38
Bryceton,M,100,0,38,38
Byanca,F,100,38,0,38
Cadon,M,100,0,38,38
Caiya,F,100,38,0,38
Captain,M,100,0,38,38
Carlea,F,100,38,0,38
Caspar,M,100,0,38,38
Cassiel,M,87,5,33,38
Catelin,F,100,38,0,38
Caven,M,100,0,38,38
Caylynn,F,100,38,0,38
Ceaser,M,100,0,38,38
Chae,F,66,25,13,38
Chanise,F,100,38,0,38
Chela,F,100,38,0,38
Classie,F,100,38,0,38
Clayten,M,100,0,38,38
Cleophas,M,100,0,38,38
Clorissa,F,100,38,0,38
Colonel,M,100,0,38,38
Corneilus,M,100,0,38,38
Cydnie,F,100,38,0,38
Dailon,M,100,0,38,38
Danai,F,100,38,0,38
Dareon,M,100,0,38,38
Darreon,M,100,0,38,38
Darrly,M,100,0,38,38
Daryus,M,100,0,38,38
Daviel,M,100,0,38,38
Deakon,M,100,0,38,38
Debie,F,100,38,0,38
Deboraha,F,100,38,0,38
Deeana,F,100,38,0,38
Deiondre,M,100,0,38,38
Deklen,M,100,0,38,38
Delaila,F,100,38,0,38
Delos,M,100,0,38,38
Denene,F,100,38,0,38
Dhalia,F,100,38,0,38
Dhyan,M,100,0,38,38
Domanik,M,100,0,38,38
Domenik,M,100,0,38,38
Dontarius,M,100,0,38,38
Dontre,M,100,0,38,38
Draiden,M,100,0,38,38
Dreyton,M,100,0,38,38
Edder,M,100,0,38,38
Edwar,M,100,0,38,38
Efe,M,100,0,38,38
Elayah,F,100,38,0,38
Elinda,F,100,38,0,38
Emeka,M,100,0,38,38
Enaya,F,100,38,0,38
Erikah,F,100,38,0,38
Esiah,M,100,0,38,38
Evelena,F,100,38,0,38
Ewing,M,100,0,38,38
Fahd,M,100,0,38,38
Fianna,F,100,38,0,38
Finnick,M,100,0,38,38
Franceska,F,100,38,0,38
Gabriana,F,100,38,0,38
Galaxy,F,100,38,0,38
Garyn,M,66,13,25,38
Glennda,F,100,38,0,38
Graceanne,F,100,38,0,38
Gwynneth,F,100,38,0,38
Haiven,F,87,33,5,38
Harshini,F,100,38,0,38
Havannah,F,100,38,0,38
Henlee,F,100,38,0,38
Hollye,F,100,38,0,38
Honest,F,55,21,17,38
Idrees,M,100,0,38,38
Ilario,M,100,0,38,38
Inocencio,M,100,0,38,38
Izayiah,M,100,0,38,38
Jacek,M,100,0,38,38
Jadis,M,84,6,32,38
Jamail,M,100,0,38,38
Jameil,M,100,0,38,38
Janeva,F,100,38,0,38
Jaquay,M,74,10,28,38
Jasamine,F,100,38,0,38
Jayland,M,100,0,38,38
Jayley,F,100,38,0,38
Jaysha,F,100,38,0,38
Jazalynn,F,100,38,0,38
Jazzalyn,F,100,38,0,38
Jenia,F,100,38,0,38
Jeremiyah,M,100,0,38,38
Jeweliana,F,100,38,0,38
Jhony,M,100,0,38,38
Jilliana,F,100,38,0,38
Johnelle,F,100,38,0,38
Johnnetta,F,100,38,0,38
Juanluis,M,100,0,38,38
Julina,F,100,38,0,38
Kacyn,M,66,13,25,38
Kaede,F,84,32,6,38
Kaemon,M,100,0,38,38
Kaizley,F,100,38,0,38
Kaleesi,F,100,38,0,38
Kalif,M,100,0,38,38
Kalis,F,87,33,5,38
Kamaile,F,100,38,0,38
Kareli,F,100,38,0,38
Karigan,F,100,38,0,38
Karlei,F,100,38,0,38
Kaston,M,100,0,38,38
Katniss,F,100,38,0,38
Kaylla,F,100,38,0,38
Kaziah,F,100,38,0,38
Keerthana,F,100,38,0,38
Kendrik,M,100,0,38,38
Kenidee,F,100,38,0,38
Keymani,F,61,23,15,38
Khale,M,100,0,38,38
Khya,F,100,38,0,38
Kierrah,F,100,38,0,38
Kirsta,F,100,38,0,38
Kiyara,F,100,38,0,38
Kollins,F,84,32,6,38
Krissi,F,100,38,0,38
Lakevia,F,100,38,0,38
Lakyra,F,100,38,0,38
Lamel,M,100,0,38,38
Laraya,F,100,38,0,38
Laresha,F,100,38,0,38
Laurisa,F,100,38,0,38
Leanthony,M,100,0,38,38
Leasha,F,100,38,0,38
Ledell,M,100,0,38,38
Leilanni,F,100,38,0,38
Lene,F,100,38,0,38
Liandra,F,100,38,0,38
Lileigh,F,100,38,0,38
Livy,F,100,38,0,38
Llewyn,M,100,0,38,38
Loralai,F,100,38,0,38
Loralye,F,100,38,0,38
Lorelie,F,100,38,0,38
Lorn,M,100,0,38,38
Louetta,F,100,38,0,38
Lucciano,M,100,0,38,38
Luwana,F,100,38,0,38
Lyfe,M,71,11,27,38
Macallister,M,100,0,38,38
Maddelynn,F,100,38,0,38
Maghan,F,100,38,0,38
Mahamadou,M,100,0,38,38
Makalya,F,100,38,0,38
Makynzee,F,100,38,0,38
Malaak,F,100,38,0,38
Mallika,F,100,38,0,38
Malyah,F,100,38,0,38
Marieli,F,100,38,0,38
Mariposa,F,100,38,0,38
Mariyam,F,100,38,0,38
Markey,M,100,0,38,38
Marlaine,F,100,38,0,38
Marnee,F,100,38,0,38
Maryetta,F,100,38,0,38
Matalyn,F,100,38,0,38
Mehak,F,100,38,0,38
Mekhai,M,100,0,38,38
Merrik,M,100,0,38,38
Mieke,F,100,38,0,38
Milad,M,100,0,38,38
Millan,M,87,5,33,38
Millennia,F,100,38,0,38
Monquie,F,100,38,0,38
Morey,M,100,0,38,38
Morrisa,F,100,38,0,38
Nabeeha,F,100,38,0,38
Nadezhda,F,100,38,0,38
Naevia,F,100,38,0,38
Naija,F,100,38,0,38
Nalin,M,74,10,28,38
Naraly,F,100,38,0,38
Navayah,F,100,38,0,38
Nayra,F,100,38,0,38
Nevaya,F,100,38,0,38
Neyla,F,100,38,0,38
Nga,F,100,38,0,38
Nikya,F,100,38,0,38
Niyati,F,100,38,0,38
Nuala,F,100,38,0,38
Owens,M,100,0,38,38
Pervis,M,100,0,38,38
Pheng,M,100,0,38,38
Quillan,M,100,0,38,38
Racine,F,100,38,0,38
Ramsay,M,100,0,38,38
Randale,M,100,0,38,38
Ranvir,M,100,0,38,38
Rashaunda,F,100,38,0,38
Rayelle,F,100,38,0,38
Raymondo,M,100,0,38,38
Raziyah,F,100,38,0,38
Reilley,M,53,18,20,38
Rhianne,F,100,38,0,38
Rhyanna,F,100,38,0,38
Riely,M,53,18,20,38
Roanna,F,100,38,0,38
Rohn,M,100,0,38,38
Romelle,F,50,19,19,38
Rondarius,M,100,0,38,38
Roran,M,100,0,38,38
Rosselyn,F,100,38,0,38
Rox,F,100,38,0,38
Ruhan,M,100,0,38,38
Sabastion,M,100,0,38,38
Sarvesh,M,100,0,38,38
Schneider,M,100,0,38,38
Seanpaul,M,100,0,38,38
Shaden,M,82,7,31,38
Shakeena,F,100,38,0,38
Shakyla,F,100,38,0,38
Shamyah,F,100,38,0,38
Shaneen,F,100,38,0,38
Shanina,F,100,38,0,38
Shaquilla,F,100,38,0,38
Shawnice,F,100,38,0,38
Sherena,F,100,38,0,38
Shirah,F,100,38,0,38
Shyne,M,82,7,31,38
Sinjin,M,100,0,38,38
Sofija,F,100,38,0,38
Sohaib,M,100,0,38,38
Stephaney,F,100,38,0,38
Syndey,F,100,38,0,38
Tadeusz,M,100,0,38,38
Taneika,F,100,38,0,38
Tannah,F,100,38,0,38
Tasheka,F,100,38,0,38
Tashena,F,100,38,0,38
Tedric,M,100,0,38,38
Telena,F,100,38,0,38
Tiaira,F,100,38,0,38
Tila,F,100,38,0,38
Tivon,M,100,0,38,38
Tracyann,F,100,38,0,38
Trampas,M,100,0,38,38
Trevia,F,100,38,0,38
Treysen,M,100,0,38,38
Trinda,F,100,38,0,38
Tsion,F,100,38,0,38
Tykeem,M,100,0,38,38
Tyller,M,74,10,28,38
Tyreon,M,100,0,38,38
Ulanda,F,100,38,0,38
Varonica,F,100,38,0,38
Venezia,F,100,38,0,38
Veronda,F,100,38,0,38
Vick,M,100,0,38,38
Vir,M,100,0,38,38
Yaminah,F,100,38,0,38
Yaw,M,100,0,38,38
Ymani,F,100,38,0,38
Yomar,M,100,0,38,38
Yumna,F,100,38,0,38
Zadkiel,M,100,0,38,38
Zanyla,F,100,38,0,38
Zayaan,M,100,0,38,38
Zlata,F,100,38,0,38
Zondra,F,100,38,0,38
Zykira,F,100,38,0,38
Abagayle,F,100,37,0,37
Abbiegail,F,100,37,0,37
Aby,F,100,37,0,37
Adana,F,100,37,0,37
Aerielle,F,100,37,0,37
Aero,M,70,11,26,37
Ahava,F,100,37,0,37
Akeyla,F,100,37,0,37
Alashia,F,100,37,0,37
Alwyn,M,100,0,37,37
Alyric,F,100,37,0,37
Ambriel,F,100,37,0,37
Amela,F,100,37,0,37
Andrienne,F,100,37,0,37
Anias,M,100,0,37,37
Aniceto,M,100,0,37,37
Anjani,F,100,37,0,37
Antoinne,M,100,0,37,37
Anyeli,F,100,37,0,37
Arah,F,100,37,0,37
Aras,M,100,0,37,37
Aretta,F,100,37,0,37
Arielis,F,100,37,0,37
Armel,M,100,0,37,37
Arohi,F,100,37,0,37
Arriel,F,100,37,0,37
Ashayla,F,100,37,0,37
Asiana,F,100,37,0,37
Asianna,F,100,37,0,37
Aslynn,F,100,37,0,37
Atleigh,F,100,37,0,37
Audrielle,F,100,37,0,37
Autymn,F,100,37,0,37
Avner,M,100,0,37,37
Bayard,M,100,0,37,37
Belita,F,100,37,0,37
Bellamarie,F,100,37,0,37
Bena,F,100,37,0,37
Benett,M,100,0,37,37
Betheny,F,100,37,0,37
Bijou,F,100,37,0,37
Braelen,M,100,0,37,37
Braison,M,100,0,37,37
Brax,M,100,0,37,37
Breia,F,100,37,0,37
Breiana,F,100,37,0,37
Brianni,F,100,37,0,37
Burney,M,100,0,37,37
Caela,F,100,37,0,37
Camauri,M,57,16,21,37
Camree,F,100,37,0,37
Carilyn,F,100,37,0,37
Carren,F,100,37,0,37
Castor,M,100,0,37,37
Catera,F,100,37,0,37
Catori,F,100,37,0,37
Cerys,F,100,37,0,37
Champion,M,100,0,37,37
Chao,M,84,6,31,37
Charee,F,100,37,0,37
Charnae,F,100,37,0,37
Chastidy,F,100,37,0,37
Chayden,M,84,6,31,37
Chesky,M,100,0,37,37
Chinedu,M,100,0,37,37
Chivon,F,100,37,0,37
Chrishaun,M,100,0,37,37
Cline,M,100,0,37,37
Collyns,F,100,37,0,37
Cordie,F,78,29,8,37
Creedence,M,68,12,25,37
Daivion,M,100,0,37,37
Dajaun,M,100,0,37,37
Dalisa,F,100,37,0,37
Damier,M,100,0,37,37
Danaja,F,100,37,0,37
Danelly,F,100,37,0,37
Dawid,M,100,0,37,37
Deepika,F,100,37,0,37
Delania,F,100,37,0,37
Denean,F,100,37,0,37
Deronda,F,100,37,0,37
Deshanna,F,100,37,0,37
Desirey,F,100,37,0,37
Deundre,M,100,0,37,37
Devian,M,86,5,32,37
Dolphus,M,100,0,37,37
Donnia,F,100,37,0,37
Dontavis,M,100,0,37,37
Dontray,M,100,0,37,37
Dorise,F,100,37,0,37
Dracen,M,100,0,37,37
Dreanna,F,100,37,0,37
Dreya,F,100,37,0,37
Duayne,M,100,0,37,37
Edelmiro,M,100,0,37,37
Eira,F,100,37,0,37
Eliannah,F,100,37,0,37
Eliodoro,M,100,0,37,37
Emillia,F,100,37,0,37
Endya,F,100,37,0,37
Eniola,F,100,37,0,37
Faizon,M,100,0,37,37
Fathima,F,100,37,0,37
Fleming,M,100,0,37,37
Fraida,F,100,37,0,37
Franca,F,100,37,0,37
Fynlee,F,100,37,0,37
Garnette,F,100,37,0,37
Gavriella,F,100,37,0,37
Gracelin,F,100,37,0,37
Gram,M,100,0,37,37
Greig,M,100,0,37,37
Haaris,M,100,0,37,37
Haillie,F,100,37,0,37
Haleema,F,100,37,0,37
Harlene,F,100,37,0,37
Harshil,M,100,0,37,37
Hashir,M,100,0,37,37
Helayna,F,100,37,0,37
Helios,M,100,0,37,37
Hibah,F,100,37,0,37
Inari,F,100,37,0,37
Inioluwa,F,57,21,16,37
Isaia,M,100,0,37,37
Itzabella,F,100,37,0,37
Iza,F,100,37,0,37
Izaan,M,100,0,37,37
Jacilyn,F,100,37,0,37
Jadden,M,100,0,37,37
Jaimeson,M,100,0,37,37
Jakin,M,100,0,37,37
Jamesmichael,M,100,0,37,37
Jamicheal,M,100,0,37,37
Jammal,M,100,0,37,37
Janeece,F,100,37,0,37
Janelys,F,100,37,0,37
Jaquelyne,F,100,37,0,37
Jarelle,M,100,0,37,37
Jasai,M,100,0,37,37
Jatin,M,100,0,37,37
Jatniel,M,100,0,37,37
Javonn,M,100,0,37,37
Jawana,F,100,37,0,37
Jazzmen,F,100,37,0,37
Jden,M,100,0,37,37
Jearld,M,100,0,37,37
Jelina,F,100,37,0,37
Jenavie,F,100,37,0,37
Jenetta,F,100,37,0,37
Jennae,F,100,37,0,37
Jeret,M,100,0,37,37
Jermine,M,100,0,37,37
Jerrico,M,100,0,37,37
Jhoanna,F,100,37,0,37
Jilda,F,100,37,0,37
Jojo,M,62,14,23,37
Julion,M,100,0,37,37
Jusiah,M,100,0,37,37
Kailana,F,100,37,0,37
Karolynn,F,100,37,0,37
Kashaun,M,100,0,37,37
Kauan,M,100,0,37,37
Kaydn,M,86,5,32,37
Kella,F,100,37,0,37
Kemal,M,100,0,37,37
Khaiden,M,100,0,37,37
Khrystal,F,100,37,0,37
Khyrie,M,84,6,31,37
Kiela,F,100,37,0,37
Kieryn,F,100,37,0,37
Kingstin,M,100,0,37,37
Kitrina,F,100,37,0,37
Knoah,M,100,0,37,37
Kolden,M,100,0,37,37
Koltan,M,100,0,37,37
Krisanne,F,100,37,0,37
Kristelle,F,100,37,0,37
Laiya,F,100,37,0,37
Laiyla,F,100,37,0,37
Lamark,M,100,0,37,37
Lamir,M,100,0,37,37
Larence,M,100,0,37,37
Leniyah,F,100,37,0,37
Leodis,M,100,0,37,37
Leonarda,F,100,37,0,37
Letasha,F,100,37,0,37
Letia,F,100,37,0,37
Letoya,F,100,37,0,37
Lielle,F,100,37,0,37
Lilyonna,F,100,37,0,37
Lilyth,F,100,37,0,37
Ling,F,100,37,0,37
Linkoln,M,100,0,37,37
Livingston,M,100,0,37,37
Lizanne,F,100,37,0,37
Loletha,F,100,37,0,37
Lonzell,M,100,0,37,37
Lorette,F,100,37,0,37
Lorraina,F,100,37,0,37
Lynann,F,100,37,0,37
Macenzie,F,100,37,0,37
Maciej,M,100,0,37,37
Madeleyn,F,100,37,0,37
Maelin,F,100,37,0,37
Majed,M,100,0,37,37
Makaelyn,F,100,37,0,37
Makani,M,100,0,37,37
Malini,F,100,37,0,37
Malley,F,100,37,0,37
Mandeep,M,70,11,26,37
Mansoor,M,100,0,37,37
Mansour,M,100,0,37,37
Maralyn,F,100,37,0,37
Marciana,F,100,37,0,37
Marielis,F,100,37,0,37
Markeshia,F,100,37,0,37
Marquelle,M,81,7,30,37
Marra,F,100,37,0,37
Maryland,F,78,29,8,37
Master,M,100,0,37,37
Maygen,F,100,37,0,37
Menelik,M,100,0,37,37
Micaella,F,100,37,0,37
Mikhayla,F,100,37,0,37
Miking,M,100,0,37,37
Mikiya,F,100,37,0,37
Miklo,M,100,0,37,37
Mitcheal,M,100,0,37,37
Montre,M,100,0,37,37
Mychaela,F,100,37,0,37
Mylia,F,100,37,0,37
Myrka,F,100,37,0,37
Nasra,F,100,37,0,37
Nasreen,F,100,37,0,37
Nastasha,F,100,37,0,37
Natassia,F,100,37,0,37
Neeraj,M,100,0,37,37
Nelle,F,100,37,0,37
Nicci,F,100,37,0,37
Niraj,M,100,0,37,37
Nishi,F,100,37,0,37
Niurka,F,100,37,0,37
Omkar,M,100,0,37,37
Oriel,M,68,12,25,37
Oseas,M,100,0,37,37
Parry,M,100,0,37,37
Patrizia,F,100,37,0,37
Phung,F,84,31,6,37
Prairie,F,100,37,0,37
Prisca,F,100,37,0,37
Quintel,M,100,0,37,37
Raia,F,100,37,0,37
Raigen,F,100,37,0,37
Rakiya,F,100,37,0,37
Ramonda,F,100,37,0,37
Rasheena,F,100,37,0,37
Raymont,M,100,0,37,37
Rayvin,F,100,37,0,37
Raza,M,100,0,37,37
Rehana,F,100,37,0,37
Reiss,M,81,7,30,37
Renad,F,100,37,0,37
Rhilynn,F,100,37,0,37
Rik,M,100,0,37,37
Rishan,M,100,0,37,37
Roarke,M,100,0,37,37
Roizy,F,100,37,0,37
Ruchy,F,100,37,0,37
Rumaisa,F,100,37,0,37
Saloma,F,100,37,0,37
Samule,M,100,0,37,37
Samyia,F,100,37,0,37
Sanayah,F,100,37,0,37
Satonya,F,100,37,0,37
Searra,F,100,37,0,37
Shaelin,F,100,37,0,37
Shah,M,100,0,37,37
Shakena,F,100,37,0,37
Shalane,F,100,37,0,37
Shalisha,F,100,37,0,37
Shameca,F,100,37,0,37
Shanah,F,100,37,0,37
Shandria,F,100,37,0,37
Shaquala,F,100,37,0,37
Sharica,F,100,37,0,37
Shary,F,100,37,0,37
Shaylon,F,57,21,16,37
Shelonda,F,100,37,0,37
Sheral,F,100,37,0,37
Shraddha,F,100,37,0,37
Sitara,F,100,37,0,37
Soma,F,57,21,16,37
Sophina,F,100,37,0,37
Soul,M,76,9,28,37
Sreya,F,100,37,0,37
Sumiko,F,100,37,0,37
Taivon,M,100,0,37,37
Taletha,F,100,37,0,37
Taleya,F,100,37,0,37
Talita,F,100,37,0,37
Tanush,M,100,0,37,37
Teandra,F,100,37,0,37
Teela,F,100,37,0,37
Tekia,F,100,37,0,37
Terek,M,100,0,37,37
Tonantzin,F,100,37,0,37
Toye,F,100,37,0,37
Trigger,M,100,0,37,37
Tyeson,M,100,0,37,37
Uyen,F,100,37,0,37
Valori,F,100,37,0,37
Vanessia,F,100,37,0,37
Vedanth,M,100,0,37,37
Veola,F,100,37,0,37
Vianne,F,100,37,0,37
Vishwa,M,100,0,37,37
Vonetta,F,100,37,0,37
Wandra,F,100,37,0,37
Willson,M,100,0,37,37
Wyett,M,100,0,37,37
Wylder,M,100,0,37,37
Yazen,M,100,0,37,37
Yeraldin,F,100,37,0,37
Yitta,F,100,37,0,37
Yoav,M,100,0,37,37
Yuli,F,100,37,0,37
Zackarie,M,100,0,37,37
Zackory,M,100,0,37,37
Zakariyya,M,100,0,37,37
Zakirah,F,100,37,0,37
Zariana,F,100,37,0,37
Zayvier,M,100,0,37,37
Zekiah,M,70,11,26,37
Zohar,F,59,22,15,37
Abdulkarim,M,100,0,36,36
Adaley,F,100,36,0,36
Adamariz,F,100,36,0,36
Adeola,F,100,36,0,36
Adna,F,100,36,0,36
Adren,M,100,0,36,36
Adrie,F,100,36,0,36
Aijalon,M,53,17,19,36
Aireona,F,100,36,0,36
Akiera,F,100,36,0,36
Alahni,F,100,36,0,36
Alazay,F,100,36,0,36
Aliceson,F,100,36,0,36
Aliciana,F,100,36,0,36
Anayla,F,100,36,0,36
Andreea,F,100,36,0,36
Angeliki,F,100,36,0,36
Angellina,F,100,36,0,36
Angy,F,100,36,0,36
Anique,F,100,36,0,36
Anquan,M,100,0,36,36
Anslie,F,100,36,0,36
Antania,F,100,36,0,36
Antonisha,F,100,36,0,36
Areya,F,100,36,0,36
Arhianna,F,100,36,0,36
Arieonna,F,100,36,0,36
Ariyon,F,64,23,13,36
Arrion,M,78,8,28,36
Aryella,F,100,36,0,36
Ashling,F,100,36,0,36
Ashlynd,F,100,36,0,36
Aubriel,F,100,36,0,36
Avyukt,M,100,0,36,36
Ayinde,M,100,0,36,36
Ayyan,M,100,0,36,36
Bambie,F,100,36,0,36
Belton,M,100,0,36,36
Blayde,M,100,0,36,36
Breton,M,100,0,36,36
Breylan,M,100,0,36,36
Breylin,M,86,5,31,36
Britlyn,F,100,36,0,36
Brynden,M,100,0,36,36
Cabrina,F,100,36,0,36
Cadan,M,100,0,36,36
Caidan,M,100,0,36,36
Caisen,M,100,0,36,36
Caitrin,F,100,36,0,36
Calianna,F,100,36,0,36
Calloway,M,81,7,29,36
Cambell,F,64,23,13,36
Cardin,M,81,7,29,36
Carles,M,100,0,36,36
Cashel,M,100,0,36,36
Casia,F,100,36,0,36
Castle,M,100,0,36,36
Caysie,F,100,36,0,36
Caytlin,F,100,36,0,36
Cecilee,F,100,36,0,36
Chania,F,100,36,0,36
Chantee,F,100,36,0,36
Chanz,M,100,0,36,36
Chasey,F,100,36,0,36
Chaunte,F,100,36,0,36
Chequita,F,100,36,0,36
Chia,F,69,25,11,36
Christyan,M,100,0,36,36
Chryl,F,100,36,0,36
Clayborn,M,100,0,36,36
Corlis,F,100,36,0,36
Cranston,M,100,0,36,36
Crystian,M,100,0,36,36
Cyla,F,100,36,0,36
Dalayna,F,100,36,0,36
Damain,M,100,0,36,36
Damika,F,100,36,0,36
Danyele,F,100,36,0,36
Darragh,M,100,0,36,36
Davanee,F,100,36,0,36
Dawnita,F,100,36,0,36
Dayleen,F,100,36,0,36
Dejan,M,100,0,36,36
Deliyah,F,100,36,0,36
Dema,F,100,36,0,36
Demetrias,M,64,13,23,36
Dequincy,M,100,0,36,36
Destynie,F,100,36,0,36
Draylon,M,100,0,36,36
Dvonte,M,100,0,36,36
Elazar,M,100,0,36,36
Eleonor,F,100,36,0,36
Elisandro,M,100,0,36,36
Elisea,F,100,36,0,36
Ellin,F,100,36,0,36
Ellisha,F,100,36,0,36
Eluzer,M,100,0,36,36
Evely,F,100,36,0,36
Evoleth,F,100,36,0,36
Findlay,M,86,5,31,36
Fortunato,M,100,0,36,36
Gao,F,100,36,0,36
Garnell,M,100,0,36,36
Georgi,F,72,26,10,36
Gergory,M,100,0,36,36
Giavanni,F,75,27,9,36
Giovan,M,100,0,36,36
Glendale,M,81,7,29,36
Glover,M,100,0,36,36
Griffon,M,100,0,36,36
Grissel,F,100,36,0,36
Gurjot,M,83,6,30,36
Gwenna,F,100,36,0,36
Haifa,F,100,36,0,36
Hansika,F,100,36,0,36
Harlym,F,86,31,5,36
Haygen,M,100,0,36,36
Helio,M,100,0,36,36
Hennessey,F,100,36,0,36
Hilliary,F,100,36,0,36
Hussien,M,100,0,36,36
Ikran,F,100,36,0,36
Imunique,F,100,36,0,36
Iniya,F,100,36,0,36
Irineo,M,100,0,36,36
Izetta,F,100,36,0,36
Jackilyn,F,100,36,0,36
Jackline,F,100,36,0,36
Jaeliana,F,100,36,0,36
Jamilette,F,100,36,0,36
Janecia,F,100,36,0,36
Jarquez,M,100,0,36,36
Jarrin,M,100,0,36,36
Jasmynn,F,100,36,0,36
Jaxiel,M,100,0,36,36
Jaydeen,M,64,13,23,36
Jaz,M,86,5,31,36
Jearl,M,86,5,31,36
Jenisha,F,100,36,0,36
Jerimyah,M,100,0,36,36
Jestina,F,100,36,0,36
Jevonte,M,100,0,36,36
Jimmi,F,81,29,7,36
Jocee,F,100,36,0,36
Jodelle,F,100,36,0,36
Johnice,F,100,36,0,36
Johntae,M,81,7,29,36
Jonavan,M,100,0,36,36
Jonee,F,100,36,0,36
Joplin,F,100,36,0,36
Jourden,M,81,7,29,36
Jurni,F,100,36,0,36
Justeen,F,100,36,0,36
Kalika,F,100,36,0,36
Kameisha,F,100,36,0,36
Kameshia,F,100,36,0,36
Kamyiah,F,100,36,0,36
Kathelyn,F,100,36,0,36
Kayela,F,100,36,0,36
Keahi,M,100,0,36,36
Keisi,F,100,36,0,36
Keiton,M,100,0,36,36
Kennen,M,100,0,36,36
Kesler,M,100,0,36,36
Kevonna,F,100,36,0,36
Kewon,M,100,0,36,36
Khan,M,100,0,36,36
Khyren,M,100,0,36,36
Kienan,M,100,0,36,36
Kiyla,F,100,36,0,36
Kleigh,F,100,36,0,36
Krisann,F,100,36,0,36
Kristianne,F,100,36,0,36
Laiden,M,100,0,36,36
Larrissa,F,100,36,0,36
Lasheena,F,100,36,0,36
Latrease,F,100,36,0,36
Lauraine,F,100,36,0,36
Lenoard,M,100,0,36,36
Lochlann,M,100,0,36,36
Lynnann,F,100,36,0,36
Lynnox,F,86,31,5,36
Machaela,F,100,36,0,36
Machai,M,100,0,36,36
Machele,F,100,36,0,36
Maham,F,100,36,0,36
Mairi,F,100,36,0,36
Makenzye,F,100,36,0,36
Makinsey,F,100,36,0,36
Malajah,F,100,36,0,36
Malee,F,100,36,0,36
Marcelene,F,100,36,0,36
Marcelline,F,100,36,0,36
Mariha,F,100,36,0,36
Marixa,F,100,36,0,36
Marlyne,F,100,36,0,36
Marrianne,F,100,36,0,36
Maryse,F,100,36,0,36
Matin,M,100,0,36,36
Matina,F,100,36,0,36
Mechel,M,69,11,25,36
Mee,F,100,36,0,36
Meelah,F,100,36,0,36
Melora,F,100,36,0,36
Meshelle,F,100,36,0,36
Mikale,M,86,5,31,36
Mikhi,M,100,0,36,36
Mileigh,F,100,36,0,36
Mindel,F,100,36,0,36
Mirra,F,100,36,0,36
Mitchael,M,100,0,36,36
Moranda,F,100,36,0,36
Mykenna,F,100,36,0,36
Mylon,M,100,0,36,36
Naasir,M,100,0,36,36
Nahlia,F,100,36,0,36
Nairobi,F,100,36,0,36
Namya,F,100,36,0,36
Narayan,M,100,0,36,36
Nashley,F,100,36,0,36
Nasiah,F,64,23,13,36
Nassim,M,100,0,36,36
Natalea,F,100,36,0,36
Natesha,F,100,36,0,36
Neco,M,86,5,31,36
Neesha,F,100,36,0,36
Nero,M,100,0,36,36
Nickolis,M,100,0,36,36
Niketa,F,100,36,0,36
Niveah,F,100,36,0,36
Nnenna,F,100,36,0,36
Nohelia,F,100,36,0,36
Novak,M,100,0,36,36
Octaviano,M,100,0,36,36
Ogechi,F,100,36,0,36
Olegario,M,100,0,36,36
Ostin,M,100,0,36,36
Porschia,F,100,36,0,36
Qamar,F,56,20,16,36
Quinesha,F,100,36,0,36
Quinetta,F,100,36,0,36
Quinlynn,F,100,36,0,36
Raelle,F,100,36,0,36
Ragina,F,100,36,0,36
Raphaela,F,100,36,0,36
Rashawna,F,100,36,0,36
Rekha,F,100,36,0,36
Remmi,F,100,36,0,36
Remonia,F,100,36,0,36
Renika,F,100,36,0,36
Renn,M,100,0,36,36
Rivaldo,M,100,0,36,36
Rondel,M,100,0,36,36
Rosalena,F,100,36,0,36
Roshon,M,78,8,28,36
Rozell,M,100,0,36,36
Ryelle,F,100,36,0,36
Salbador,M,100,0,36,36
Salimah,F,100,36,0,36
Scottlyn,F,100,36,0,36
Shaketa,F,100,36,0,36
Sharrell,F,100,36,0,36
Shatonya,F,100,36,0,36
Shayda,F,100,36,0,36
Sheng,F,100,36,0,36
Shey,F,56,20,16,36
Shian,F,100,36,0,36
Shivansh,M,100,0,36,36
Shravan,M,100,0,36,36
Shya,F,100,36,0,36
Sinan,M,100,0,36,36
Skilynn,F,100,36,0,36
Smantha,F,100,36,0,36
Sofya,F,100,36,0,36
Soriah,F,100,36,0,36
Sorin,M,100,0,36,36
Stanislav,M,100,0,36,36
Stefanos,M,100,0,36,36
Stephens,M,100,0,36,36
Symir,M,100,0,36,36
Takyla,F,100,36,0,36
Tamea,F,100,36,0,36
Tanessa,F,100,36,0,36
Taralynn,F,100,36,0,36
Tarika,F,100,36,0,36
Tarnisha,F,100,36,0,36
Tarus,M,100,0,36,36
Tashay,F,100,36,0,36
Tavius,M,100,0,36,36
Tayleigh,F,100,36,0,36
Tee,M,100,0,36,36
Teresea,F,100,36,0,36
Teyah,F,100,36,0,36
Thailand,M,86,5,31,36
Treyce,M,100,0,36,36
Tyjae,F,50,18,18,36
Tyrian,M,83,6,30,36
Vanassa,F,100,36,0,36
Verlie,F,83,30,6,36
Vondell,M,86,5,31,36
Waneta,F,100,36,0,36
Wynetta,F,100,36,0,36
Yanuel,M,100,0,36,36
Yarden,M,58,15,21,36
Yeilin,F,100,36,0,36
Yianni,M,100,0,36,36
Younis,M,100,0,36,36
Zackari,M,100,0,36,36
Zairah,F,100,36,0,36
Zalia,F,100,36,0,36
Zayed,M,100,0,36,36
Zayvian,M,100,0,36,36
Zeenat,F,100,36,0,36
Zorian,M,100,0,36,36
Aariah,F,100,35,0,35
Aashritha,F,100,35,0,35
Abdalla,M,100,0,35,35
Aboubacar,M,100,0,35,35
Abrian,M,100,0,35,35
Abrie,F,100,35,0,35
Addis,M,83,6,29,35
Ade,M,100,0,35,35
Adeleine,F,100,35,0,35
Agam,M,51,17,18,35
Agnieszka,F,100,35,0,35
Ailed,F,100,35,0,35
Aireal,F,100,35,0,35
Aizik,M,100,0,35,35
Ajit,M,100,0,35,35
Alanmichael,M,100,0,35,35
Alayza,F,100,35,0,35
Alazae,F,100,35,0,35
Aleyza,F,100,35,0,35
Aliena,F,100,35,0,35
Allex,M,69,11,24,35
Alleyah,F,100,35,0,35
Almon,M,100,0,35,35
Alyviah,F,100,35,0,35
Amanada,F,100,35,0,35
Ame,F,100,35,0,35
Amylia,F,100,35,0,35
Anaise,F,100,35,0,35
Anissia,F,100,35,0,35
Antasia,F,100,35,0,35
Antrell,M,100,0,35,35
Anysia,F,100,35,0,35
Aolanis,F,100,35,0,35
Arran,M,100,0,35,35
Asli,F,100,35,0,35
Ayasha,F,100,35,0,35
Aynslee,F,100,35,0,35
Azara,F,100,35,0,35
Ballard,M,100,0,35,35
Banessa,F,100,35,0,35
Behr,M,100,0,35,35
Belladonna,F,100,35,0,35
Bensen,M,100,0,35,35
Bow,M,100,0,35,35
Brand,M,100,0,35,35
Brayant,M,100,0,35,35
Brianah,F,100,35,0,35
Briell,F,100,35,0,35
Bright,M,100,0,35,35
Bron,M,100,0,35,35
Brylea,F,100,35,0,35
Bryse,M,100,0,35,35
Burdette,M,100,0,35,35
Caitlen,F,100,35,0,35
Carron,F,69,24,11,35
Caylon,M,100,0,35,35
Ceejay,M,100,0,35,35
Charelle,F,100,35,0,35
Charmian,F,100,35,0,35
Chenell,F,100,35,0,35
Chenita,F,100,35,0,35
Chiana,F,100,35,0,35
Cinque,M,100,0,35,35
Clenton,M,100,0,35,35
Conlin,M,100,0,35,35
Coriana,F,100,35,0,35
Corrigan,M,100,0,35,35
Cyanne,F,100,35,0,35
Cythia,F,100,35,0,35
Dae,M,63,13,22,35
Daeton,M,100,0,35,35
Daeveon,M,100,0,35,35
Dalanie,F,100,35,0,35
Dalisha,F,100,35,0,35
Danajah,F,100,35,0,35
Dannelle,F,100,35,0,35
Darnetta,F,100,35,0,35
Darvis,M,100,0,35,35
Dawnetta,F,100,35,0,35
Dela,F,100,35,0,35
Delan,M,100,0,35,35
Delontae,M,100,0,35,35
Demarea,M,100,0,35,35
Desira,F,100,35,0,35
Deundra,M,80,7,28,35
Diamantina,F,100,35,0,35
Dierks,M,100,0,35,35
Dilon,M,100,0,35,35
Donaciano,M,100,0,35,35
Dong,M,100,0,35,35
Dorotha,F,100,35,0,35
Dorrell,M,100,0,35,35
Earla,F,100,35,0,35
Ebin,M,100,0,35,35
Edra,F,100,35,0,35
Eero,M,100,0,35,35
Electa,F,100,35,0,35
Elkin,M,100,0,35,35
Ellianah,F,100,35,0,35
Ellias,M,100,0,35,35
Emaya,F,100,35,0,35
Emmette,M,100,0,35,35
Ephram,M,100,0,35,35
Erial,F,100,35,0,35
Eyana,F,100,35,0,35
Fina,F,100,35,0,35
Flo,F,100,35,0,35
Gara,F,100,35,0,35
Garald,M,100,0,35,35
Garrie,M,100,0,35,35
Gayatri,F,100,35,0,35
Glennie,F,86,30,5,35
Gwendlyn,F,100,35,0,35
Haille,F,100,35,0,35
Hakan,M,100,0,35,35
Halona,F,100,35,0,35
Hasson,M,100,0,35,35
Henery,M,100,0,35,35
Herschell,M,100,0,35,35
Hewitt,M,100,0,35,35
Holiday,F,100,35,0,35
Huntington,M,100,0,35,35
Huzaifa,M,100,0,35,35
Ichael,M,100,0,35,35
Isiaha,M,100,0,35,35
Isolde,F,100,35,0,35
Isyss,F,100,35,0,35
Itzia,F,100,35,0,35
Ivorie,F,100,35,0,35
Jacquita,F,100,35,0,35
Jahmeir,M,100,0,35,35
Jahmier,M,100,0,35,35
Jakyia,F,100,35,0,35
Jalie,F,100,35,0,35
Jalilah,F,100,35,0,35
Jalynne,F,100,35,0,35
Janiylah,F,100,35,0,35
Jasiya,F,100,35,0,35
Jaston,M,100,0,35,35
Jayzon,M,100,0,35,35
Jefry,M,100,0,35,35
Jemari,M,100,0,35,35
Jerett,M,100,0,35,35
Jerlyn,F,100,35,0,35
Jeyla,F,100,35,0,35
Jhordan,M,66,12,23,35
Jisela,F,100,35,0,35
Jobie,M,86,5,30,35
Jocabed,F,100,35,0,35
Jocsan,M,100,0,35,35
Joelynn,F,100,35,0,35
Jolayne,F,100,35,0,35
Jolette,F,100,35,0,35
Jordain,F,71,25,10,35
Jorey,M,100,0,35,35
Jorgia,F,100,35,0,35
Josilynn,F,100,35,0,35
Josph,M,100,0,35,35
Josten,M,100,0,35,35
Judee,F,100,35,0,35
Julaine,F,100,35,0,35
Juluis,M,100,0,35,35
Kambryn,F,100,35,0,35
Kamen,M,100,0,35,35
Kamylah,F,100,35,0,35
Katalia,F,100,35,0,35
Kathalina,F,100,35,0,35
Kathye,F,100,35,0,35
Kayan,M,100,0,35,35
Kazuki,M,100,0,35,35
Kendallyn,F,100,35,0,35
Kenosha,F,100,35,0,35
Kenzli,F,100,35,0,35
Keyarra,F,100,35,0,35
Khamryn,F,60,21,14,35
Kharis,F,100,35,0,35
Khrista,F,100,35,0,35
Kinda,F,100,35,0,35
Kiril,M,100,0,35,35
Koralyn,F,100,35,0,35
Kortlyn,F,100,35,0,35
Kostantinos,M,100,0,35,35
Koston,M,100,0,35,35
Krimson,F,86,30,5,35
Kyann,F,100,35,0,35
Kynadi,F,100,35,0,35
Lachanda,F,100,35,0,35
Lajean,F,100,35,0,35
Lakasha,F,100,35,0,35
Lakishia,F,100,35,0,35
Lakynn,F,100,35,0,35
Lalo,M,100,0,35,35
Larie,F,100,35,0,35
Lavanda,F,100,35,0,35
Layce,F,100,35,0,35
Lenisha,F,100,35,0,35
Lethia,F,100,35,0,35
Leyland,M,100,0,35,35
Leylanie,F,100,35,0,35
Liborio,M,100,0,35,35
Lindee,F,100,35,0,35
Linford,M,100,0,35,35
Lira,F,100,35,0,35
Lofton,M,100,0,35,35
Loic,M,100,0,35,35
Lonita,F,100,35,0,35
Lynett,F,100,35,0,35
Machi,M,100,0,35,35
Madelein,F,100,35,0,35
Madyn,F,100,35,0,35
Mahlik,M,100,0,35,35
Manraj,M,100,0,35,35
Marcelyn,F,100,35,0,35
Marelin,F,100,35,0,35
Markeis,M,100,0,35,35
Marwin,M,100,0,35,35
Mattalyn,F,100,35,0,35
Maurisio,M,100,0,35,35
Maxxwell,M,100,0,35,35
Meganne,F,100,35,0,35
Meggin,F,100,35,0,35
Melat,F,100,35,0,35
Meredyth,F,100,35,0,35
Michaell,M,100,0,35,35
Mikaelah,F,100,35,0,35
Milaya,F,100,35,0,35
Mileidy,F,100,35,0,35
Milisa,F,100,35,0,35
Milynn,F,100,35,0,35
Minette,F,100,35,0,35
Minha,F,100,35,0,35
Mishayla,F,100,35,0,35
Mishika,F,100,35,0,35
Miyu,F,100,35,0,35
Monzerrath,F,100,35,0,35
Myking,M,100,0,35,35
Naama,F,100,35,0,35
Naithan,M,100,0,35,35
Naryah,F,100,35,0,35
Nathanyel,M,100,0,35,35
Natilie,F,100,35,0,35
Natlie,F,100,35,0,35
Naziya,F,100,35,0,35
Nekeisha,F,100,35,0,35
Nemiah,M,69,11,24,35
Neviah,F,100,35,0,35
Nishanth,M,100,0,35,35
Nithin,M,100,0,35,35
Novaleigh,F,100,35,0,35
Nykole,F,100,35,0,35
Nylee,F,100,35,0,35
Oak,M,100,0,35,35
Oaklynn,F,100,35,0,35
Oluwatobiloba,M,80,7,28,35
Olvin,M,100,0,35,35
Oriah,F,100,35,0,35
Orry,M,100,0,35,35
Prateek,M,100,0,35,35
Praveen,M,100,0,35,35
Prisma,F,100,35,0,35
Prudencio,M,100,0,35,35
Quetzaly,F,100,35,0,35
Rainna,F,100,35,0,35
Raiyan,M,100,0,35,35
Ranata,F,100,35,0,35
Rashana,F,100,35,0,35
Rashidah,F,100,35,0,35
Ravenna,F,100,35,0,35
Rella,F,100,35,0,35
Rhetta,F,100,35,0,35
Rhyse,M,66,12,23,35
Rilla,F,100,35,0,35
Rizwan,M,100,0,35,35
Robben,M,100,0,35,35
Rocko,M,100,0,35,35
Rogena,F,100,35,0,35
Rusti,F,100,35,0,35
Ryenn,F,100,35,0,35
Saara,F,100,35,0,35
Saber,M,83,6,29,35
Samaiyah,F,100,35,0,35
Samaj,M,86,5,30,35
Samariah,F,100,35,0,35
Samhitha,F,100,35,0,35
Sanyah,F,100,35,0,35
Saraiah,F,100,35,0,35
Scotlynn,F,100,35,0,35
Senta,F,100,35,0,35
Shakiyla,F,100,35,0,35
Shanzay,F,100,35,0,35
Sharlie,F,100,35,0,35
Shatina,F,100,35,0,35
Shayli,F,100,35,0,35
Shemeika,F,100,35,0,35
Shemekia,F,100,35,0,35
Sheryn,F,100,35,0,35
Shiori,F,100,35,0,35
Shravya,F,100,35,0,35
Shukri,F,100,35,0,35
Shyana,F,100,35,0,35
Siddhi,F,100,35,0,35
Skippy,M,100,0,35,35
Sorcha,F,100,35,0,35
Soyla,F,100,35,0,35
Stepahnie,F,100,35,0,35
Supreme,M,100,0,35,35
Supriya,F,100,35,0,35
Syrenity,F,100,35,0,35
Talise,F,100,35,0,35
Tameshia,F,100,35,0,35
Tamikia,F,100,35,0,35
Tangy,F,100,35,0,35
Tanija,F,100,35,0,35
Taralee,F,100,35,0,35
Tashae,F,100,35,0,35
Tessia,F,100,35,0,35
Tikia,F,100,35,0,35
Tilman,M,100,0,35,35
Tirza,F,100,35,0,35
Tonnette,F,100,35,0,35
Tramon,M,100,0,35,35
Trea,M,69,11,24,35
Trindon,M,100,0,35,35
Trinia,F,100,35,0,35
Trumaine,M,100,0,35,35
Tyaire,M,86,5,30,35
Tyne,F,100,35,0,35
Tyona,F,100,35,0,35
Tyresse,M,100,0,35,35
Tyrick,M,100,0,35,35
Valdez,M,100,0,35,35
Vinessa,F,100,35,0,35
Vontrell,M,100,0,35,35
Wyeth,M,100,0,35,35
Yaneisy,F,100,35,0,35
Yaneliz,F,100,35,0,35
Yaqueline,F,100,35,0,35
Yariana,F,100,35,0,35
Yasamin,F,100,35,0,35
Yassir,M,100,0,35,35
Yonis,M,100,0,35,35
Yuriel,M,100,0,35,35
Yuvaan,M,100,0,35,35
Zameer,M,100,0,35,35
Zarian,M,100,0,35,35
Zaylan,M,100,0,35,35
Zivah,F,100,35,0,35
Zlatan,M,100,0,35,35
Zynia,F,100,35,0,35
Aailyah,F,100,34,0,34
Aasim,M,100,0,34,34
Aastha,F,100,34,0,34
Abaigeal,F,100,34,0,34
Abrey,F,100,34,0,34
Aceson,M,100,0,34,34
Adabella,F,100,34,0,34
Adhvik,M,100,0,34,34
Ahan,M,100,0,34,34
Ahkeem,M,100,0,34,34
Ahsha,F,100,34,0,34
Akyla,F,100,34,0,34
Alisabeth,F,100,34,0,34
Allina,F,100,34,0,34
Alpheus,M,100,0,34,34
Alvan,M,100,0,34,34
Alyzabeth,F,100,34,0,34
Amiaya,F,100,34,0,34
Amilyah,F,100,34,0,34
Anacristina,F,100,34,0,34
Anastyn,F,100,34,0,34
Aniaya,F,100,34,0,34
Anik,M,100,0,34,34
Annais,F,100,34,0,34
Annalysa,F,100,34,0,34
Anyelin,F,100,34,0,34
Arilynn,F,100,34,0,34
Armany,M,100,0,34,34
Arnisha,F,100,34,0,34
Arren,M,85,5,29,34
Arvella,F,100,34,0,34
Atiana,F,100,34,0,34
Aubriee,F,100,34,0,34
Augie,M,100,0,34,34
Aundrey,M,100,0,34,34
Aunesty,F,100,34,0,34
Avalina,F,100,34,0,34
Ayansh,M,100,0,34,34
Azariya,F,100,34,0,34
Bailei,F,100,34,0,34
Baine,M,100,0,34,34
Baird,M,100,0,34,34
Basim,M,100,0,34,34
Bethania,F,100,34,0,34
Braniyah,F,100,34,0,34
Brenyn,M,56,15,19,34
Brinly,F,100,34,0,34
Britini,F,100,34,0,34
Brittiney,F,100,34,0,34
Burak,M,100,0,34,34
Caellum,M,100,0,34,34
Cailan,M,53,16,18,34
Calypso,F,100,34,0,34
Caniya,F,100,34,0,34
Carlean,F,100,34,0,34
Carloyn,F,100,34,0,34
Carmilla,F,100,34,0,34
Cayde,M,100,0,34,34
Celica,F,100,34,0,34
Charie,F,100,34,0,34
Charlye,F,100,34,0,34
Charrise,F,100,34,0,34
Chasten,M,100,0,34,34
Cherylynn,F,100,34,0,34
Chizaram,F,82,28,6,34
Chrisanne,F,100,34,0,34
Chriselda,F,100,34,0,34
Christabella,F,100,34,0,34
Claryssa,F,100,34,0,34
Coady,M,100,0,34,34
Corinda,F,100,34,0,34
Correna,F,100,34,0,34
Couper,M,100,0,34,34
Criag,M,100,0,34,34
Curvin,M,100,0,34,34
Cydne,F,100,34,0,34
Cyntha,F,100,34,0,34
Daeshon,M,100,0,34,34
Daneille,F,100,34,0,34
Darrol,M,100,0,34,34
Darvell,M,100,0,34,34
Davied,M,100,0,34,34
Daxx,M,100,0,34,34
Delonta,M,100,0,34,34
Deloria,F,100,34,0,34
Delshawn,M,100,0,34,34
Denarius,M,100,0,34,34
Deontray,M,100,0,34,34
Dezeray,F,100,34,0,34
Dezmin,M,100,0,34,34
Diavion,F,79,27,7,34
Dishon,M,100,0,34,34
Dominiq,M,100,0,34,34
Donis,F,79,27,7,34
Dorla,F,100,34,0,34
Dravyn,M,100,0,34,34
Duff,M,100,0,34,34
Duffy,M,82,6,28,34
Edi,M,76,8,26,34
Edmon,M,100,0,34,34
Eisa,F,53,18,16,34
Eleanna,F,100,34,0,34
Elham,F,100,34,0,34
Eliaz,M,100,0,34,34
Ellieanna,F,100,34,0,34
Ellwood,M,100,0,34,34
Elsi,F,100,34,0,34
Erique,M,100,0,34,34
Eriyanna,F,100,34,0,34
Everet,M,100,0,34,34
Evynn,F,100,34,0,34
Faduma,F,100,34,0,34
Faige,F,100,34,0,34
Fia,F,100,34,0,34
Freja,F,100,34,0,34
Gayl,F,100,34,0,34
Germani,F,100,34,0,34
Gianny,F,59,20,14,34
Gitel,F,100,34,0,34
Graciana,F,100,34,0,34
Guilianna,F,100,34,0,34
Hanni,F,100,34,0,34
Harlei,F,100,34,0,34
Harrold,M,100,0,34,34
Haru,M,74,9,25,34
Haruto,M,100,0,34,34
Hava,F,100,34,0,34
Hazelle,F,100,34,0,34
Hena,F,100,34,0,34
Henleigh,F,100,34,0,34
Herby,M,100,0,34,34
Hesston,M,100,0,34,34
Hussam,M,100,0,34,34
Hyun,M,79,7,27,34
Ilissa,F,100,34,0,34
Illa,F,100,34,0,34
Illya,M,100,0,34,34
Jaaliyah,F,100,34,0,34
Jamayah,F,100,34,0,34
Jandel,M,100,0,34,34
Jashun,M,100,0,34,34
Jaylei,F,100,34,0,34
Jaymon,M,100,0,34,34
Jaymz,M,100,0,34,34
Jazarah,F,100,34,0,34
Jazion,M,100,0,34,34
Jazper,M,100,0,34,34
Jeffren,M,100,0,34,34
Jenalyn,F,100,34,0,34
Jenefer,F,100,34,0,34
Jennel,F,100,34,0,34
Jeny,F,100,34,0,34
Jeramyah,M,100,0,34,34
Jeriann,F,100,34,0,34
Jerremy,M,100,0,34,34
Jesly,F,100,34,0,34
Jezabelle,F,100,34,0,34
Jezelle,F,100,34,0,34
Joeanna,F,100,34,0,34
Johncarlo,M,100,0,34,34
Juanangel,M,100,0,34,34
Judyann,F,100,34,0,34
Jupiter,M,82,6,28,34
Kachina,F,100,34,0,34
Kahlea,F,100,34,0,34
Kailash,M,100,0,34,34
Kairon,M,100,0,34,34
Kalai,M,85,5,29,34
Kaleab,M,100,0,34,34
Kalik,M,100,0,34,34
Kameela,F,100,34,0,34
Kamile,F,100,34,0,34
Kanijah,F,100,34,0,34
Karem,F,82,28,6,34
Karmina,F,100,34,0,34
Katai,M,100,0,34,34
Kaysin,M,100,0,34,34
Kazuma,M,100,0,34,34
Kearia,F,100,34,0,34
Kellsey,F,100,34,0,34
Kemiya,F,100,34,0,34
Kempton,M,100,0,34,34
Kenner,M,100,0,34,34
Keny,M,100,0,34,34
Keveon,M,100,0,34,34
Keylie,F,100,34,0,34
Keylor,M,100,0,34,34
Khalea,F,100,34,0,34
Khalib,M,100,0,34,34
Khiana,F,100,34,0,34
Khristy,F,100,34,0,34
Khyleigh,F,100,34,0,34
Khylin,M,62,13,21,34
Khyra,F,100,34,0,34
Kima,F,100,34,0,34
Kimesha,F,100,34,0,34
Kishawn,M,100,0,34,34
Kishon,M,100,0,34,34
Kjell,M,100,0,34,34
Kjerstin,F,100,34,0,34
Kla,F,100,34,0,34
Knoxx,M,100,0,34,34
Koleen,F,100,34,0,34
Kollyn,M,82,6,28,34
Koraline,F,100,34,0,34
Kwadwo,M,100,0,34,34
Kwamaine,M,100,0,34,34
Lajoyce,F,100,34,0,34
Lakresha,F,100,34,0,34
Lakya,F,100,34,0,34
Lamontae,M,100,0,34,34
Lamyah,F,100,34,0,34
Lanayah,F,100,34,0,34
Lanyia,F,100,34,0,34
Laquanta,F,100,34,0,34
Laranda,F,100,34,0,34
Latrena,F,100,34,0,34
Lavan,M,100,0,34,34
Lavonta,M,100,0,34,34
Layanna,F,100,34,0,34
Layni,F,100,34,0,34
Lehua,F,100,34,0,34
Leib,M,100,0,34,34
Lejon,M,100,0,34,34
Lenice,F,100,34,0,34
Leyana,F,100,34,0,34
Libni,F,100,34,0,34
Lijah,M,100,0,34,34
Lincy,F,100,34,0,34
Linder,F,100,34,0,34
Lissandro,M,100,0,34,34
Londan,F,100,34,0,34
Luellen,F,100,34,0,34
Mael,M,100,0,34,34
Mahlet,F,100,34,0,34
Malania,F,100,34,0,34
Malayla,F,100,34,0,34
Maleeha,F,100,34,0,34
Manasa,F,100,34,0,34
Mannie,M,100,0,34,34
Margit,F,100,34,0,34
Mariateresa,F,100,34,0,34
Marisleysis,F,100,34,0,34
Markeeta,F,100,34,0,34
Marlaysia,F,100,34,0,34
Marquee,M,100,0,34,34
Marvette,F,100,34,0,34
Maryfer,F,100,34,0,34
Marysue,F,100,34,0,34
Mat,M,100,0,34,34
Meesha,F,100,34,0,34
Meriel,F,100,34,0,34
Meztli,F,100,34,0,34
Miguelina,F,100,34,0,34
Moiz,M,100,0,34,34
Monea,F,100,34,0,34
Muskan,F,100,34,0,34
Myers,M,85,5,29,34
Mykiah,F,100,34,0,34
Myrissa,F,100,34,0,34
Naeema,F,100,34,0,34
Nafeesah,F,100,34,0,34
Naiara,F,100,34,0,34
Najeeb,M,100,0,34,34
Nasiyah,F,100,34,0,34
Natalija,F,100,34,0,34
Natika,F,100,34,0,34
Navaya,F,100,34,0,34
Nayleen,F,100,34,0,34
Newt,M,100,0,34,34
Nickol,F,100,34,0,34
Nickson,M,100,0,34,34
Nili,F,100,34,0,34
Octavis,M,100,0,34,34
Oluwaseun,M,85,5,29,34
Orest,M,100,0,34,34
Orvil,M,100,0,34,34
Owais,M,100,0,34,34
Paiden,F,62,21,13,34
Paschal,M,100,0,34,34
Pati,F,100,34,0,34
Payam,M,100,0,34,34
Paycen,F,56,19,15,34
Pratham,M,100,0,34,34
Princeston,M,100,0,34,34
Priti,F,100,34,0,34
Quinci,F,85,29,5,34
Ramadan,M,100,0,34,34
Randen,M,100,0,34,34
Raphaella,F,100,34,0,34
Rayshad,M,100,0,34,34
Reginaldo,M,100,0,34,34
Reshard,M,100,0,34,34
Rheta,F,100,34,0,34
Robbert,M,100,0,34,34
Rolinda,F,100,34,0,34
Ronson,M,100,0,34,34
Ruqayyah,F,100,34,0,34
Rushi,M,100,0,34,34
Saidy,F,100,34,0,34
Sakeenah,F,100,34,0,34
Sakia,F,100,34,0,34
Sakshi,F,100,34,0,34
Samanth,F,100,34,0,34
Samay,M,85,5,29,34
Samyiah,F,100,34,0,34
Sarahbeth,F,100,34,0,34
Saumya,F,100,34,0,34
Sayan,M,100,0,34,34
Sehaj,F,50,17,17,34
Seraiah,F,100,34,0,34
Seryna,F,100,34,0,34
Shaday,F,100,34,0,34
Shandrika,F,100,34,0,34
Sharanda,F,100,34,0,34
Shayanne,F,100,34,0,34
Shefali,F,100,34,0,34
Shekia,F,100,34,0,34
Sherilynn,F,100,34,0,34
Shiana,F,100,34,0,34
Shuaib,M,100,0,34,34
Shubh,M,100,0,34,34
Sloka,F,100,34,0,34
Soni,F,100,34,0,34
Swati,F,100,34,0,34
Syaire,M,100,0,34,34
Syris,M,100,0,34,34
Taher,M,100,0,34,34
Tahmir,M,100,0,34,34
Takeshia,F,100,34,0,34
Tamina,F,100,34,0,34
Tannor,M,100,0,34,34
Taressa,F,100,34,0,34
Tarri,F,100,34,0,34
Tashonda,F,100,34,0,34
Tawn,F,82,28,6,34
Tekoa,F,50,17,17,34
Temima,F,100,34,0,34
Tessla,F,100,34,0,34
Teyon,M,100,0,34,34
Therisa,F,100,34,0,34
Tinia,F,100,34,0,34
Tinna,F,100,34,0,34
Tiphany,F,100,34,0,34
Tiron,M,100,0,34,34
Traves,M,100,0,34,34
Treana,F,100,34,0,34
Tyese,F,100,34,0,34
Tyress,M,100,0,34,34
Tyrez,M,100,0,34,34
Tyriana,F,100,34,0,34
Tyshay,F,100,34,0,34
Urvi,F,100,34,0,34
Valory,F,100,34,0,34
Vaness,F,100,34,0,34
Vernelle,F,100,34,0,34
Vineet,M,100,0,34,34
Viraaj,M,100,0,34,34
Weronika,F,100,34,0,34
Wilkins,M,100,0,34,34
Wissam,M,100,0,34,34
Wyland,M,100,0,34,34
Xoey,F,100,34,0,34
Yamin,M,100,0,34,34
Yates,M,100,0,34,34
Yordy,M,100,0,34,34
Yovanna,F,100,34,0,34
Zafir,M,100,0,34,34
Zalaya,F,100,34,0,34
Zamia,F,100,34,0,34
Zanae,F,100,34,0,34
Zanetta,F,100,34,0,34
Zebastian,M,100,0,34,34
Zekiel,M,100,0,34,34
Zerek,M,100,0,34,34
Zeva,F,100,34,0,34
Zitlali,F,100,34,0,34
Zyniah,F,100,34,0,34
Aaira,F,100,33,0,33
Abdur,M,100,0,33,33
Adaiah,F,85,28,5,33
Adain,M,100,0,33,33
Adalis,F,100,33,0,33
Addisynn,F,100,33,0,33
Aengus,M,100,0,33,33
Ahmod,M,100,0,33,33
Aiyla,F,100,33,0,33
Akeira,F,100,33,0,33
Akisha,F,100,33,0,33
Akosua,F,100,33,0,33
Alexios,M,100,0,33,33
Alferd,M,100,0,33,33
Alfreida,F,100,33,0,33
Allanna,F,100,33,0,33
Allyah,F,100,33,0,33
Alphonza,M,100,0,33,33
Amatullah,F,100,33,0,33
Amayia,F,100,33,0,33
Amelio,M,100,0,33,33
Ameliya,F,100,33,0,33
Amoura,F,100,33,0,33
Amreen,F,100,33,0,33
Amyla,F,100,33,0,33
Anahis,F,100,33,0,33
Anaira,F,100,33,0,33
Analya,F,100,33,0,33
Andreu,M,100,0,33,33
Aneli,F,100,33,0,33
Angelgabriel,M,100,0,33,33
Annalynne,F,100,33,0,33
Annaya,F,100,33,0,33
Anniah,F,100,33,0,33
Anselm,M,100,0,33,33
Ansen,M,100,0,33,33
Antwaine,M,100,0,33,33
Anvika,F,100,33,0,33
Aoi,F,82,27,6,33
Arena,F,100,33,0,33
Arieona,F,100,33,0,33
Arora,F,100,33,0,33
Aryka,F,100,33,0,33
Ashleymarie,F,100,33,0,33
Ashwath,M,100,0,33,33
Avalynne,F,100,33,0,33
Avriana,F,100,33,0,33
Awab,M,100,0,33,33
Aylissa,F,100,33,0,33
Baden,M,100,0,33,33
Batoul,F,100,33,0,33
Bentli,F,79,26,7,33
Beren,M,82,6,27,33
Bessy,F,100,33,0,33
Beya,F,100,33,0,33
Bluma,F,100,33,0,33
Bonney,F,100,33,0,33
Brandom,M,100,0,33,33
Breelle,F,100,33,0,33
Brenn,F,70,23,10,33
Briony,F,100,33,0,33
Brisia,F,100,33,0,33
Briya,F,100,33,0,33
Bryler,M,100,0,33,33
Bryten,M,79,7,26,33
Butler,M,100,0,33,33
Caileb,M,100,0,33,33
Cailie,F,100,33,0,33
Cambryn,F,79,26,7,33
Camilah,F,100,33,0,33
Caniyah,F,100,33,0,33
Cassian,M,100,0,33,33
Cathe,F,100,33,0,33
Cayne,M,100,0,33,33
Charlott,F,100,33,0,33
Charnele,F,100,33,0,33
Chauna,F,100,33,0,33
Cherlynn,F,100,33,0,33
Cherylene,F,100,33,0,33
Chett,M,100,0,33,33
Chez,M,64,12,21,33
Chirstina,F,100,33,0,33
Chrisandra,F,100,33,0,33
Christell,F,100,33,0,33
Christropher,M,100,0,33,33
Christyana,F,100,33,0,33
Chrystie,F,100,33,0,33
Claressa,F,100,33,0,33
Clary,F,79,26,7,33
Court,M,100,0,33,33
Cyprian,M,100,0,33,33
Dael,M,100,0,33,33
Daiden,M,100,0,33,33
Daleen,F,100,33,0,33
Damaso,M,100,0,33,33
Damean,M,100,0,33,33
Damiano,M,100,0,33,33
Danner,M,100,0,33,33
Dantonio,M,100,0,33,33
Darelle,M,100,0,33,33
Datra,F,100,33,0,33
Daziyah,F,100,33,0,33
Deadrian,M,100,0,33,33
Deijah,F,100,33,0,33
Dekayla,F,100,33,0,33
Demita,F,100,33,0,33
Derriona,F,100,33,0,33
Deserea,F,100,33,0,33
Deyanna,F,100,33,0,33
Disa,F,100,33,0,33
Django,M,100,0,33,33
Djibril,M,100,0,33,33
Donika,F,100,33,0,33
Donzel,M,100,0,33,33
Doren,M,85,5,28,33
Eirik,M,100,0,33,33
Eleina,F,100,33,0,33
Emilea,F,100,33,0,33
Emlyn,F,100,33,0,33
Eon,M,100,0,33,33
Erabella,F,100,33,0,33
Erlin,M,82,6,27,33
Ethelene,F,100,33,0,33
Eveleen,F,100,33,0,33
Evia,F,100,33,0,33
Evlyn,F,100,33,0,33
Fariha,F,100,33,0,33
Gabbrielle,F,100,33,0,33
Gabrelle,F,100,33,0,33
Geron,M,100,0,33,33
Glee,F,100,33,0,33
Gleen,M,100,0,33,33
Haniyah,F,100,33,0,33
Harleyquinn,F,100,33,0,33
Harout,M,100,0,33,33
Hawken,M,100,0,33,33
Helmut,M,100,0,33,33
Hodan,F,100,33,0,33
Hunt,M,100,0,33,33
Idali,F,100,33,0,33
Ifrah,F,100,33,0,33
Ileanna,F,100,33,0,33
Illyanna,F,100,33,0,33
Imane,F,100,33,0,33
Imanuel,M,100,0,33,33
Inaki,M,100,0,33,33
Irby,M,100,0,33,33
Iszabella,F,100,33,0,33
Itzell,F,100,33,0,33
Iyesha,F,100,33,0,33
Izaiyah,M,100,0,33,33
Izzac,M,100,0,33,33
Jaaziah,M,100,0,33,33
Jacquilyn,F,100,33,0,33
Jaedynn,F,73,24,9,33
Jaeleen,F,100,33,0,33
Jahlia,F,100,33,0,33
Jalayla,F,100,33,0,33
Jancy,F,100,33,0,33
Janeisha,F,100,33,0,33
Janellie,F,100,33,0,33
Janmichael,M,100,0,33,33
Jaques,M,100,0,33,33
Jarissa,F,100,33,0,33
Javyn,M,100,0,33,33
Jaycelyn,F,100,33,0,33
Jeanenne,F,100,33,0,33
Jensine,F,100,33,0,33
Jerline,F,100,33,0,33
Jernee,F,100,33,0,33
Jerolyn,F,100,33,0,33
Jerzi,F,100,33,0,33
Jesaiah,M,100,0,33,33
Jhamir,M,100,0,33,33
Jillyan,F,100,33,0,33
Jinan,F,100,33,0,33
Joanette,F,100,33,0,33
Jocie,F,100,33,0,33
Joenathan,M,100,0,33,33
Johnsie,F,100,33,0,33
Kabella,F,100,33,0,33
Kaesen,M,100,0,33,33
Kahmari,M,70,10,23,33
Kalev,M,100,0,33,33
Kaliq,M,100,0,33,33
Kalyse,F,100,33,0,33
Kamera,F,100,33,0,33
Karisha,F,100,33,0,33
Karolyne,F,100,33,0,33
Katelen,F,100,33,0,33
Kathyleen,F,100,33,0,33
Kayia,F,100,33,0,33
Kaylob,M,100,0,33,33
Kaynen,M,100,0,33,33
Keatyn,F,67,22,11,33
Keian,M,100,0,33,33
Kelsei,F,100,33,0,33
Kemonte,M,100,0,33,33
Kenlyn,F,85,28,5,33
Kennidi,F,100,33,0,33
Keonia,F,100,33,0,33
Kevina,F,100,33,0,33
Keyler,M,100,0,33,33
Khalila,F,100,33,0,33
Khaya,F,100,33,0,33
Kimisha,F,100,33,0,33
Kitt,F,67,22,11,33
Krithik,M,100,0,33,33
Kyarah,F,100,33,0,33
Kynzee,F,100,33,0,33
Kyrillos,M,100,0,33,33
Ladaisha,F,100,33,0,33
Ladana,F,100,33,0,33
Ladasha,F,100,33,0,33
Ladeja,F,100,33,0,33
Lajoy,F,100,33,0,33
Lamin,M,100,0,33,33
Lamyia,F,100,33,0,33
Lasaundra,F,100,33,0,33
Laterrance,M,100,0,33,33
Laurianne,F,100,33,0,33
Leiyah,F,100,33,0,33
Lenaya,F,100,33,0,33
Leshonda,F,100,33,0,33
Levonne,F,85,28,5,33
Lexine,F,100,33,0,33
Lidya,F,100,33,0,33
Liesa,F,100,33,0,33
Loa,F,100,33,0,33
Luetta,F,100,33,0,33
Lylia,F,100,33,0,33
Lyndy,F,100,33,0,33
Macallan,M,100,0,33,33
Mahum,F,100,33,0,33
Maili,F,100,33,0,33
Makaia,F,100,33,0,33
Makeila,F,100,33,0,33
Makira,F,100,33,0,33
Maleigh,F,100,33,0,33
Manaia,F,100,33,0,33
Maniah,F,100,33,0,33
March,M,52,16,17,33
Marcio,M,100,0,33,33
Marili,F,100,33,0,33
Mariluz,F,100,33,0,33
Masaki,M,100,0,33,33
Maybree,F,100,33,0,33
Mcdonald,M,100,0,33,33
Mckinna,F,100,33,0,33
Meda,F,100,33,0,33
Minta,F,100,33,0,33
Mirakle,F,100,33,0,33
Miral,F,100,33,0,33
Mkenzie,F,100,33,0,33
Moksh,M,100,0,33,33
Monesha,F,100,33,0,33
Moustafa,M,100,0,33,33
Muskaan,F,100,33,0,33
Naava,F,100,33,0,33
Najib,M,100,0,33,33
Nardos,F,100,33,0,33
Nashaun,M,100,0,33,33
Nattalie,F,100,33,0,33
Nayda,F,100,33,0,33
Ndia,F,100,33,0,33
Nelsy,F,100,33,0,33
Nickalaus,M,100,0,33,33
Nidal,M,100,0,33,33
Nikesha,F,100,33,0,33
Nilay,M,100,0,33,33
Nirvaan,M,100,0,33,33
Nneoma,F,100,33,0,33
Obrian,M,100,0,33,33
Oluwatamilore,F,85,28,5,33
Parley,M,100,0,33,33
Pennelope,F,100,33,0,33
Perrie,F,100,33,0,33
Perris,F,58,19,14,33
Praneel,M,100,0,33,33
Qais,M,100,0,33,33
Quince,M,100,0,33,33
Quinisha,F,100,33,0,33
Ramonia,F,100,33,0,33
Raymona,F,100,33,0,33
Raynelle,F,100,33,0,33
Rayner,M,100,0,33,33
Raziah,F,100,33,0,33
Reagyn,F,100,33,0,33
Reannon,F,100,33,0,33
Rielynn,F,100,33,0,33
Roczen,M,100,0,33,33
Roldan,M,100,0,33,33
Roswell,M,100,0,33,33
Rourke,M,100,0,33,33
Ruthe,F,100,33,0,33
Sabrinna,F,100,33,0,33
Sarit,F,100,33,0,33
Saryn,F,100,33,0,33
Sayaka,F,100,33,0,33
Seif,M,100,0,33,33
Serenitie,F,100,33,0,33
Sevanna,F,100,33,0,33
Shaddai,F,55,18,15,33
Shahad,F,100,33,0,33
Shakela,F,100,33,0,33
Shamarion,M,100,0,33,33
Shandreka,F,100,33,0,33
Shanece,F,100,33,0,33
Shantina,F,100,33,0,33
Shauntell,F,100,33,0,33
Shauntia,F,100,33,0,33
Shayana,F,100,33,0,33
Shelden,M,100,0,33,33
Shelene,F,100,33,0,33
Shelsey,F,100,33,0,33
Shloka,F,100,33,0,33
Shota,M,100,0,33,33
Siarah,F,100,33,0,33
Sicilia,F,100,33,0,33
Sidnie,F,100,33,0,33
Siearra,F,100,33,0,33
Stuti,F,100,33,0,33
Suriyah,F,100,33,0,33
Symphany,F,100,33,0,33
Tahjae,F,52,17,16,33
Taila,F,100,33,0,33
Tamicka,F,100,33,0,33
Tamme,F,100,33,0,33
Tansy,F,100,33,0,33
Tanyah,F,100,33,0,33
Tashan,M,85,5,28,33
Tayron,M,100,0,33,33
Tejal,F,100,33,0,33
Tiffanny,F,100,33,0,33
Timya,F,100,33,0,33
Tiquan,M,100,0,33,33
Tomisha,F,100,33,0,33
Tomy,M,100,0,33,33
Tonica,F,100,33,0,33
Toriann,F,100,33,0,33
Torina,F,100,33,0,33
Torrell,M,100,0,33,33
Travious,M,100,0,33,33
Treyveon,M,100,0,33,33
Trinh,F,100,33,0,33
Truong,M,100,0,33,33
Trygve,M,100,0,33,33
Trystyn,M,73,9,24,33
Valyn,F,100,33,0,33
Vani,F,100,33,0,33
Velina,F,100,33,0,33
Victormanuel,M,100,0,33,33
Vivia,F,100,33,0,33
Vrinda,F,100,33,0,33
Xianna,F,100,33,0,33
Yaffa,F,100,33,0,33
Yardley,M,52,16,17,33
Ygnacio,M,100,0,33,33
Yidel,M,100,0,33,33
Zaccai,M,100,0,33,33
Zakkery,M,100,0,33,33
Zalayah,F,100,33,0,33
Zanden,M,100,0,33,33
Zareen,F,100,33,0,33
Zayana,F,100,33,0,33
Zayde,M,82,6,27,33
Ziyonna,F,100,33,0,33
Zyairah,F,100,33,0,33
Zykerria,F,100,33,0,33
Zyron,M,100,0,33,33
Aadam,M,100,0,32,32
Aanika,F,100,32,0,32
Abdulkareem,M,100,0,32,32
Acelin,M,78,7,25,32
Adeel,M,100,0,32,32
Adelena,F,100,32,0,32
Adja,F,100,32,0,32
Ahnna,F,100,32,0,32
Aidynn,M,84,5,27,32
Aija,F,100,32,0,32
Airyana,F,100,32,0,32
Aizlynn,F,100,32,0,32
Akane,F,100,32,0,32
Akeela,F,100,32,0,32
Alaira,F,100,32,0,32
Aldahir,M,100,0,32,32
Allessandra,F,100,32,0,32
Alric,M,100,0,32,32
Alter,M,100,0,32,32
Alyne,F,100,32,0,32
Alyxis,F,100,32,0,32
Ambyr,F,100,32,0,32
Amika,F,100,32,0,32
Amol,M,100,0,32,32
Amonie,F,100,32,0,32
Amrutha,F,100,32,0,32
Anabia,F,100,32,0,32
Anaijah,F,100,32,0,32
Analeigha,F,100,32,0,32
Analina,F,100,32,0,32
Analysia,F,100,32,0,32
Andrej,M,100,0,32,32
Angalina,F,100,32,0,32
Ange,F,100,32,0,32
Angeleena,F,100,32,0,32
Angelos,M,100,0,32,32
Anija,F,100,32,0,32
Anjelo,M,100,0,32,32
Annalina,F,100,32,0,32
Anuar,M,100,0,32,32
Arcangel,M,100,0,32,32
Areonna,F,100,32,0,32
Ariely,F,100,32,0,32
Arish,M,100,0,32,32
Ariyanah,F,100,32,0,32
Arshan,M,100,0,32,32
Arvis,M,62,12,20,32
Aryaman,M,100,0,32,32
Atira,F,100,32,0,32
Audre,F,100,32,0,32
Ayane,F,100,32,0,32
Aylinn,F,100,32,0,32
Babara,F,100,32,0,32
Banyan,M,100,0,32,32
Baran,M,59,13,19,32
Baylon,M,100,0,32,32
Berania,F,100,32,0,32
Blen,F,100,32,0,32
Blessyn,F,100,32,0,32
Blondie,F,100,32,0,32
Brendalyn,F,100,32,0,32
Briyonna,F,100,32,0,32
Bruin,M,100,0,32,32
Brydan,M,100,0,32,32
Bryssa,F,100,32,0,32
Camran,M,100,0,32,32
Candia,F,100,32,0,32
Canesha,F,100,32,0,32
Cashus,M,100,0,32,32
Cathryne,F,100,32,0,32
Caton,M,81,6,26,32
Chanika,F,100,32,0,32
Chaniyah,F,100,32,0,32
Chantale,F,100,32,0,32
Chauntel,F,100,32,0,32
Chauntelle,F,100,32,0,32
Chay,M,81,6,26,32
Cheick,M,100,0,32,32
Cherron,F,100,32,0,32
Cheveyo,M,100,0,32,32
Chizara,F,100,32,0,32
Christyne,F,100,32,0,32
Ciela,F,100,32,0,32
Claretta,F,100,32,0,32
Claudina,F,100,32,0,32
Cohan,M,100,0,32,32
Colie,M,84,5,27,32
Conchetta,F,100,32,0,32
Corion,M,100,0,32,32
Courtlynn,F,100,32,0,32
Cowen,M,100,0,32,32
Cozetta,F,100,32,0,32
Craige,M,100,0,32,32
Cristan,F,62,20,12,32
Cyris,M,100,0,32,32
Dailey,F,100,32,0,32
Dalinda,F,100,32,0,32
Danuel,M,100,0,32,32
Daoud,M,100,0,32,32
Darrelle,M,100,0,32,32
Daruis,M,100,0,32,32
Dashay,F,100,32,0,32
Davarius,M,100,0,32,32
Davionne,M,72,9,23,32
Davit,M,100,0,32,32
Dawanda,F,100,32,0,32
Dayten,M,100,0,32,32
Deby,F,100,32,0,32
Dejuana,F,100,32,0,32
Denyce,F,100,32,0,32
Deondrae,M,100,0,32,32
Deone,F,59,19,13,32
Detron,M,100,0,32,32
Devesh,M,100,0,32,32
Donnald,M,100,0,32,32
Donne,F,50,16,16,32
Dontrel,M,100,0,32,32
Draden,M,100,0,32,32
Dreyson,M,100,0,32,32
Dwon,M,100,0,32,32
Eddrick,M,100,0,32,32
Edoardo,M,100,0,32,32
Eidan,M,100,0,32,32
Elah,F,100,32,0,32
Elivia,F,100,32,0,32
Ellerie,F,100,32,0,32
Elowyn,F,100,32,0,32
Elye,M,100,0,32,32
Emelio,M,100,0,32,32
Enijah,F,100,32,0,32
Erice,M,100,0,32,32
Esra,F,100,32,0,32
Esthefany,F,100,32,0,32
Esvin,M,100,0,32,32
Eun,F,100,32,0,32
Farhad,M,100,0,32,32
Felissa,F,100,32,0,32
Fergus,M,100,0,32,32
Florina,F,100,32,0,32
Galadriel,F,100,32,0,32
Gelila,F,100,32,0,32
Gelsey,F,100,32,0,32
Genae,F,100,32,0,32
Geralynn,F,100,32,0,32
Giannina,F,100,32,0,32
Gohan,M,100,0,32,32
Gregroy,M,100,0,32,32
Greyden,M,100,0,32,32
Gurshaan,M,100,0,32,32
Gwendalynn,F,100,32,0,32
Haelyn,F,100,32,0,32
Harolyn,F,100,32,0,32
Haskel,M,100,0,32,32
Haylynn,F,100,32,0,32
Hayze,M,100,0,32,32
Henson,M,100,0,32,32
Hermann,M,100,0,32,32
Hue,M,66,11,21,32
Ikhlas,F,100,32,0,32
Ikia,F,100,32,0,32
Inda,F,100,32,0,32
Irianna,F,100,32,0,32
Ismerai,F,100,32,0,32
Isobella,F,100,32,0,32
Issabelle,F,100,32,0,32
Izeyah,M,100,0,32,32
Izreal,M,100,0,32,32
Jafeth,M,100,0,32,32
Jahara,F,84,27,5,32
Jaima,F,100,32,0,32
Jairen,M,100,0,32,32
Jamillia,F,100,32,0,32
Jamisyn,F,84,27,5,32
Jamyria,F,100,32,0,32
Janki,F,100,32,0,32
Janoah,M,100,0,32,32
Jaquelinne,F,100,32,0,32
Jaquis,M,84,5,27,32
Jarrick,M,100,0,32,32
Jasmeet,F,62,20,12,32
Jassica,F,100,32,0,32
Jasslyn,F,100,32,0,32
Jastin,M,84,5,27,32
Jatoria,F,100,32,0,32
Javeion,M,100,0,32,32
Javi,M,100,0,32,32
Javonda,F,100,32,0,32
Jaylea,F,100,32,0,32
Jaylia,F,100,32,0,32
Jaymison,M,100,0,32,32
Jazon,M,100,0,32,32
Jeannemarie,F,100,32,0,32
Jeferson,M,100,0,32,32
Jeidy,F,100,32,0,32
Jerime,M,100,0,32,32
Jerlean,F,100,32,0,32
Jerlene,F,100,32,0,32
Jerrard,M,100,0,32,32
Joash,M,100,0,32,32
Jobeth,F,100,32,0,32
Johnn,M,100,0,32,32
Jonh,M,100,0,32,32
Jordyne,F,100,32,0,32
Jozi,F,100,32,0,32
Jullianna,F,100,32,0,32
Jullie,F,100,32,0,32
Jung,M,59,13,19,32
Justyna,F,100,32,0,32
Jyoti,F,100,32,0,32
Kalyani,F,100,32,0,32
Kalynne,F,100,32,0,32
Kamare,M,100,0,32,32
Kamelia,F,100,32,0,32
Kamilia,F,100,32,0,32
Kamillah,F,100,32,0,32
Kanna,F,100,32,0,32
Karalina,F,100,32,0,32
Kathan,M,100,0,32,32
Katlyne,F,100,32,0,32
Kayann,F,100,32,0,32
Keano,M,100,0,32,32
Keerthi,F,100,32,0,32
Keilany,F,100,32,0,32
Khaila,F,100,32,0,32
Khloei,F,100,32,0,32
Kiylee,F,100,32,0,32
Kristion,M,84,5,27,32
Lakeita,F,100,32,0,32
Lamine,M,100,0,32,32
Lashara,F,100,32,0,32
Lauriel,F,100,32,0,32
Laythan,M,100,0,32,32
Leanette,F,100,32,0,32
Leeba,F,100,32,0,32
Legaci,F,100,32,0,32
Lehi,M,100,0,32,32
Leightyn,F,100,32,0,32
Leliana,F,100,32,0,32
Lennette,F,100,32,0,32
Leoni,F,100,32,0,32
Lerone,M,100,0,32,32
Letta,F,100,32,0,32
Letti,F,100,32,0,32
Leyanna,F,100,32,0,32
Lezli,F,100,32,0,32
Lindzey,F,100,32,0,32
Lorrin,F,59,19,13,32
Lucciana,F,100,32,0,32
Lynnett,F,100,32,0,32
Macaela,F,100,32,0,32
Maleeah,F,100,32,0,32
Mally,F,100,32,0,32
Mandalyn,F,100,32,0,32
Manette,F,100,32,0,32
Mariame,F,100,32,0,32
Marka,F,84,27,5,32
Martyna,F,100,32,0,32
Marwah,F,100,32,0,32
Masey,F,100,32,0,32
Matteus,M,100,0,32,32
Matvey,M,100,0,32,32
Maxmillian,M,100,0,32,32
Maycen,M,62,12,20,32
Maylea,F,100,32,0,32
Medardo,M,100,0,32,32
Meili,F,100,32,0,32
Meloni,F,100,32,0,32
Merwin,M,100,0,32,32
Miarose,F,100,32,0,32
Miette,F,100,32,0,32
Mikie,M,84,5,27,32
Mileydi,F,100,32,0,32
Milia,F,100,32,0,32
Milyn,F,100,32,0,32
Mohamud,M,100,0,32,32
Mukund,M,100,0,32,32
Myliyah,F,100,32,0,32
Nabor,M,100,0,32,32
Nadalie,F,100,32,0,32
Nandita,F,100,32,0,32
Nashly,F,100,32,0,32
Nazariah,F,100,32,0,32
Nehemie,F,100,32,0,32
Nevah,F,100,32,0,32
Nomi,F,100,32,0,32
Norvin,M,100,0,32,32
Nyanna,F,100,32,0,32
Nyiah,F,100,32,0,32
Nyzaiah,M,100,0,32,32
Okey,M,100,0,32,32
Olanda,F,56,18,14,32
Olliver,M,100,0,32,32
Oluwatimilehin,M,100,0,32,32
Oluwatosin,F,62,20,12,32
Onalee,F,100,32,0,32
Onica,F,100,32,0,32
Oretha,F,100,32,0,32
Palin,F,100,32,0,32
Phuc,M,100,0,32,32
Quantavius,M,100,0,32,32
Quintarius,M,100,0,32,32
Quron,M,100,0,32,32
Rafiq,M,100,0,32,32
Raha,F,100,32,0,32
Railee,F,100,32,0,32
Rakeb,F,100,32,0,32
Ramia,F,100,32,0,32
Ramzy,M,100,0,32,32
Raynisha,F,100,32,0,32
Reeya,F,100,32,0,32
Refael,M,100,0,32,32
Reonna,F,100,32,0,32
Richey,M,100,0,32,32
Rinaldo,M,100,0,32,32
Rocket,M,78,7,25,32
Romney,M,100,0,32,32
Rondy,M,100,0,32,32
Rosely,F,100,32,0,32
Roshawnda,F,100,32,0,32
Rynn,F,69,22,10,32
Sakai,M,72,9,23,32
Saket,M,100,0,32,32
Sallye,F,100,32,0,32
Salvator,M,100,0,32,32
Samyuktha,F,100,32,0,32
Sanad,M,100,0,32,32
Sanae,F,100,32,0,32
Sanah,F,100,32,0,32
Sandrine,F,100,32,0,32
Schneur,M,100,0,32,32
Seldon,M,100,0,32,32
Shakiera,F,100,32,0,32
Shakisha,F,100,32,0,32
Shawnae,F,100,32,0,32
Shawntia,F,100,32,0,32
Shericka,F,100,32,0,32
Siddhanth,M,100,0,32,32
Sirenity,F,100,32,0,32
Stassi,F,100,32,0,32
Stiven,M,100,0,32,32
Stormee,F,100,32,0,32
Suhayb,M,100,0,32,32
Suleyman,M,100,0,32,32
Sumayya,F,100,32,0,32
Sundee,F,100,32,0,32
Swathi,F,100,32,0,32
Swayzie,F,100,32,0,32
Syriana,F,100,32,0,32
Tahji,M,100,0,32,32
Tallan,M,100,0,32,32
Taneya,F,100,32,0,32
Tannia,F,100,32,0,32
Tarita,F,100,32,0,32
Tashema,F,100,32,0,32
Tatanisha,F,100,32,0,32
Tayquan,M,100,0,32,32
Taysom,M,100,0,32,32
Temprence,F,100,32,0,32
Terie,F,100,32,0,32
Terrisa,F,100,32,0,32
Tianne,F,100,32,0,32
Tiye,F,100,32,0,32
Tiyon,M,100,0,32,32
Tobe,M,100,0,32,32
Tomesha,F,100,32,0,32
Tonatiuh,M,100,0,32,32
Tonetta,F,100,32,0,32
Tong,M,100,0,32,32
Tremon,M,100,0,32,32
Treon,M,100,0,32,32
Trystian,M,100,0,32,32
Tuleen,F,100,32,0,32
Tylasia,F,100,32,0,32
Ulysess,M,100,0,32,32
Urian,M,100,0,32,32
Varshini,F,100,32,0,32
Vignesh,M,100,0,32,32
Wesleigh,F,100,32,0,32
Whitfield,M,100,0,32,32
Winn,M,100,0,32,32
Wylan,M,100,0,32,32
Yadriel,M,100,0,32,32
Yahira,F,100,32,0,32
Yalexa,F,100,32,0,32
Yerick,M,100,0,32,32
Yi,F,50,16,16,32
Yunior,M,100,0,32,32
Yussuf,M,100,0,32,32
Yusuke,M,100,0,32,32
Zaccary,M,100,0,32,32
Zachrey,M,100,0,32,32
Zanayah,F,100,32,0,32
Zarin,F,50,16,16,32
Zarius,M,100,0,32,32
Zaylynn,F,100,32,0,32
Zed,M,100,0,32,32
Zenda,F,100,32,0,32
Zeniah,F,100,32,0,32
Aadil,M,100,0,31,31
Aamari,M,55,14,17,31
Abdiaziz,M,100,0,31,31
Acey,M,84,5,26,31
Addalee,F,100,31,0,31
Adelise,F,100,31,0,31
Adriyana,F,100,31,0,31
Aeisha,F,100,31,0,31
Ahmere,M,100,0,31,31
Ahriana,F,100,31,0,31
Ailea,F,100,31,0,31
Aireonna,F,100,31,0,31
Aivah,F,100,31,0,31
Alannis,F,100,31,0,31
Aliayah,F,100,31,0,31
Alisse,F,100,31,0,31
Aliyanah,F,100,31,0,31
Alysandra,F,100,31,0,31
Amariona,F,100,31,0,31
Ambry,F,100,31,0,31
Americus,F,100,31,0,31
Amro,M,100,0,31,31
Anala,F,100,31,0,31
Anani,F,100,31,0,31
Angelik,F,100,31,0,31
Angelisse,F,100,31,0,31
Anival,M,100,0,31,31
Annet,F,100,31,0,31
Argie,F,100,31,0,31
Arielys,F,100,31,0,31
Arihana,F,100,31,0,31
Arkin,M,100,0,31,31
Arlisha,F,100,31,0,31
Armari,F,52,16,15,31
Arvell,M,100,0,31,31
Asenath,F,100,31,0,31
Ashad,M,100,0,31,31
Ashani,F,100,31,0,31
Audryanna,F,100,31,0,31
Ausha,F,100,31,0,31
Avanna,F,100,31,0,31
Aveion,M,100,0,31,31
Aveya,F,100,31,0,31
Aviona,F,100,31,0,31
Aviyah,F,100,31,0,31
Avrianna,F,100,31,0,31
Babatunde,M,100,0,31,31
Barbar,F,100,31,0,31
Barbette,F,100,31,0,31
Bellamia,F,100,31,0,31
Bethanny,F,100,31,0,31
Brenen,M,100,0,31,31
Brielynn,F,100,31,0,31
Brok,M,100,0,31,31
Burma,F,100,31,0,31
Calisha,F,100,31,0,31
Camielle,F,100,31,0,31
Canden,M,100,0,31,31
Carrin,F,100,31,0,31
Caydan,M,100,0,31,31
Ceili,F,100,31,0,31
Cherika,F,100,31,0,31
Chike,M,100,0,31,31
Chukwudi,M,100,0,31,31
Coal,M,100,0,31,31
Coni,F,100,31,0,31
Cosima,F,100,31,0,31
Creola,F,100,31,0,31
Cyniah,F,100,31,0,31
Dalphine,F,100,31,0,31
Damere,M,100,0,31,31
Damyia,F,100,31,0,31
Danh,M,100,0,31,31
Daquarius,M,100,0,31,31
Darely,F,100,31,0,31
Darienne,F,100,31,0,31
Daud,M,100,0,31,31
Daved,M,100,0,31,31
Davell,M,100,0,31,31
Davison,M,100,0,31,31
Daysy,F,100,31,0,31
Deandrew,M,100,0,31,31
Deitrick,M,100,0,31,31
Dejanique,F,100,31,0,31
Delsin,M,100,0,31,31
Demisha,F,100,31,0,31
Dennard,M,100,0,31,31
Deren,M,100,0,31,31
Derenda,F,100,31,0,31
Dereona,F,100,31,0,31
Derral,M,100,0,31,31
Deshauna,F,100,31,0,31
Dornell,M,100,0,31,31
Dustine,F,61,19,12,31
Dyna,F,100,31,0,31
Ebelin,F,100,31,0,31
Ebon,M,100,0,31,31
Edit,F,100,31,0,31
Edon,M,100,0,31,31
Eleah,F,100,31,0,31
Elex,M,100,0,31,31
Elizandro,M,100,0,31,31
Ellyssa,F,100,31,0,31
Emary,F,100,31,0,31
Enas,F,100,31,0,31
Eriyana,F,100,31,0,31
Evett,F,100,31,0,31
Evone,F,100,31,0,31
Fawaz,M,100,0,31,31
Fernand,M,100,0,31,31
Franziska,F,100,31,0,31
Garcia,M,100,0,31,31
Garnetta,F,100,31,0,31
Glorie,F,100,31,0,31
Gradyn,M,100,0,31,31
Grasiela,F,100,31,0,31
Green,M,100,0,31,31
Guillaume,M,100,0,31,31
Gulianna,F,100,31,0,31
Hady,M,61,12,19,31
Halla,F,100,31,0,31
Hanzel,M,100,0,31,31
Harvin,M,100,0,31,31
Hayzel,F,100,31,0,31
Hervey,M,100,0,31,31
Ilani,F,100,31,0,31
Infiniti,F,100,31,0,31
Isauro,M,100,0,31,31
Isella,F,100,31,0,31
Ivann,M,100,0,31,31
Iyad,M,100,0,31,31
Jaanvi,F,100,31,0,31
Jacci,F,100,31,0,31
Jackee,F,100,31,0,31
Jackquelyn,F,100,31,0,31
Jahmil,M,100,0,31,31
Jaiveer,M,100,0,31,31
Jaklyn,F,100,31,0,31
Jaleia,F,100,31,0,31
Jameia,F,100,31,0,31
Jamion,M,100,0,31,31
Jamis,M,100,0,31,31
Janelli,F,100,31,0,31
Japhet,M,100,0,31,31
Jaretzi,F,100,31,0,31
Jassen,M,100,0,31,31
Javoni,M,100,0,31,31
Jayelle,F,100,31,0,31
Jayleah,F,100,31,0,31
Jazman,F,100,31,0,31
Jemarcus,M,100,0,31,31
Jenevie,F,100,31,0,31
Jermiyah,F,77,24,7,31
Jetaime,F,100,31,0,31
Jianni,M,58,13,18,31
Jilberto,M,100,0,31,31
Jiles,M,100,0,31,31
Jmari,M,100,0,31,31
Jodeci,M,68,10,21,31
Johnesha,F,100,31,0,31
Johnni,F,100,31,0,31
Jolean,F,100,31,0,31
Joven,M,100,0,31,31
Jovonni,M,100,0,31,31
Julionna,F,100,31,0,31
Jullien,M,100,0,31,31
Kailynne,F,100,31,0,31
Kaiyan,M,100,0,31,31
Karagan,F,100,31,0,31
Kazia,F,100,31,0,31
Keidra,F,100,31,0,31
Kemi,F,100,31,0,31
Kendelle,F,84,26,5,31
Kenzly,F,100,31,0,31
Kerensa,F,100,31,0,31
Keyerra,F,100,31,0,31
Keymon,M,100,0,31,31
Khilee,F,100,31,0,31
Kiarrah,F,100,31,0,31
Kiko,M,68,10,21,31
Kimmi,F,100,31,0,31
Kindal,F,100,31,0,31
Kinzee,F,100,31,0,31
Klarisa,F,100,31,0,31
Koni,F,100,31,0,31
Kourosh,M,100,0,31,31
Kristalynn,F,100,31,0,31
Kristeena,F,100,31,0,31
Kyel,M,100,0,31,31
Kyriana,F,100,31,0,31
Ladarion,M,100,0,31,31
Laiah,F,100,31,0,31
Lakrisha,F,100,31,0,31
Lalani,F,100,31,0,31
Lanasia,F,100,31,0,31
Lashaya,F,100,31,0,31
Laterra,F,100,31,0,31
Laurelyn,F,100,31,0,31
Lavance,M,100,0,31,31
Leahanna,F,100,31,0,31
Leenah,F,100,31,0,31
Lehman,M,100,0,31,31
Leslea,F,100,31,0,31
Lief,M,100,0,31,31
Lilyian,F,100,31,0,31
Lorey,F,100,31,0,31
Lucah,M,100,0,31,31
Luisantonio,M,100,0,31,31
Lukis,M,100,0,31,31
Maclean,M,100,0,31,31
Maclin,M,100,0,31,31
Madi,F,100,31,0,31
Mahesh,M,100,0,31,31
Mahin,M,84,5,26,31
Maico,M,100,0,31,31
Maigan,F,100,31,0,31
Makaylyn,F,100,31,0,31
Malaia,F,100,31,0,31
Malaiyah,F,100,31,0,31
Mallarie,F,100,31,0,31
Malyk,M,100,0,31,31
Mandrell,M,100,0,31,31
Marcas,M,100,0,31,31
Marcellina,F,100,31,0,31
Margorie,F,100,31,0,31
Margurite,F,100,31,0,31
Marinna,F,100,31,0,31
Marletta,F,100,31,0,31
Marquerite,F,100,31,0,31
Maryclare,F,100,31,0,31
Maryiah,F,100,31,0,31
Mattingly,F,100,31,0,31
Maximiano,M,100,0,31,31
Mckenzye,F,100,31,0,31
Mckinzee,F,100,31,0,31
Melek,F,81,25,6,31
Melis,F,100,31,0,31
Merik,M,100,0,31,31
Mersades,F,100,31,0,31
Meshia,F,100,31,0,31
Mikaeel,M,100,0,31,31
Minah,F,100,31,0,31
Minnah,F,100,31,0,31
Miqueas,M,100,0,31,31
Mirranda,F,100,31,0,31
Moneka,F,100,31,0,31
Munirah,F,100,31,0,31
Nakyra,F,100,31,0,31
Nanami,F,100,31,0,31
Naren,M,100,0,31,31
Nasira,F,100,31,0,31
Navarro,M,100,0,31,31
Navea,F,100,31,0,31
Naviah,F,100,31,0,31
Naythen,M,100,0,31,31
Nijae,F,84,26,5,31
Nitasha,F,100,31,0,31
Noach,M,100,0,31,31
Noralyn,F,100,31,0,31
Nyaira,F,100,31,0,31
Nykolas,M,100,0,31,31
Nylia,F,100,31,0,31
Nyzir,M,100,0,31,31
Oluwasemilore,F,65,20,11,31
Orien,M,100,0,31,31
Oris,M,100,0,31,31
Paisly,F,100,31,0,31
Param,M,100,0,31,31
Payzlee,F,100,31,0,31
Peniel,M,55,14,17,31
Prashant,M,100,0,31,31
Priest,M,100,0,31,31
Radonna,F,100,31,0,31
Raeden,M,68,10,21,31
Raejean,F,100,31,0,31
Rainelle,F,100,31,0,31
Rainn,M,55,14,17,31
Raiya,F,100,31,0,31
Rane,M,100,0,31,31
Ravan,F,100,31,0,31
Renald,M,100,0,31,31
Reyan,M,100,0,31,31
Rhya,F,100,31,0,31
Rishard,M,100,0,31,31
Riyana,F,100,31,0,31
Roanne,F,100,31,0,31
Rohith,M,100,0,31,31
Romon,M,100,0,31,31
Rosena,F,100,31,0,31
Rosland,F,100,31,0,31
Roth,M,100,0,31,31
Roxas,M,100,0,31,31
Rozanna,F,100,31,0,31
Rupal,F,100,31,0,31
Sabien,M,100,0,31,31
Sabrin,F,100,31,0,31
Sajan,M,100,0,31,31
Sanyia,F,100,31,0,31
Savvy,F,100,31,0,31
Sayid,M,100,0,31,31
Seretha,F,100,31,0,31
Shacora,F,100,31,0,31
Shannin,F,100,31,0,31
Shawnell,F,84,26,5,31
Shawnita,F,100,31,0,31
Shell,F,65,20,11,31
Shemaiah,F,100,31,0,31
Sheva,F,100,31,0,31
Sheza,F,100,31,0,31
Shontelle,F,100,31,0,31
Sierria,F,100,31,0,31
Simar,F,84,26,5,31
Sirron,M,100,0,31,31
Skie,F,100,31,0,31
Solace,F,77,24,7,31
Sophronia,F,100,31,0,31
Sukhmani,F,100,31,0,31
Swetha,F,100,31,0,31
Syre,M,100,0,31,31
Talley,F,100,31,0,31
Tamyia,F,100,31,0,31
Tanai,F,100,31,0,31
Tangee,F,100,31,0,31
Tarius,M,100,0,31,31
Tasean,M,100,0,31,31
Tenecia,F,100,31,0,31
Tiannah,F,100,31,0,31
Timera,F,100,31,0,31
Tonique,F,100,31,0,31
Trig,M,100,0,31,31
Trinita,F,100,31,0,31
Tushar,M,100,0,31,31
Tyleigh,F,100,31,0,31
Tynetta,F,100,31,0,31
Vara,F,100,31,0,31
Varian,M,100,0,31,31
Vikrant,M,100,0,31,31
Vinicius,M,100,0,31,31
Voncile,F,100,31,0,31
Vonita,F,100,31,0,31
Yahshua,M,100,0,31,31
Yarelly,F,100,31,0,31
Yaron,M,100,0,31,31
Yena,F,100,31,0,31
Yesly,F,100,31,0,31
Yochanan,M,100,0,31,31
Zacaria,F,61,19,12,31
Zamariah,F,100,31,0,31
Zamyra,F,100,31,0,31
Zarianna,F,100,31,0,31
Zoejane,F,100,31,0,31
Zsazsa,F,100,31,0,31
Zula,F,100,31,0,31
Aamna,F,100,30,0,30
Aarian,M,60,12,18,30
Aaryav,M,100,0,30,30
Aasiya,F,100,30,0,30
Abryanna,F,100,30,0,30
Absalom,M,100,0,30,30
Abyan,M,83,5,25,30
Adenike,F,100,30,0,30
Adriauna,F,100,30,0,30
Aedin,M,100,0,30,30
Ahliyah,F,100,30,0,30
Ahtziry,F,100,30,0,30
Airelle,F,100,30,0,30
Airen,F,67,20,10,30
Akul,M,100,0,30,30
Alam,M,100,0,30,30
Alasha,F,100,30,0,30
Albertine,F,100,30,0,30
Almadelia,F,100,30,0,30
Alorah,F,100,30,0,30
Alycea,F,100,30,0,30
Alyssamarie,F,100,30,0,30
Aminta,F,100,30,0,30
Amontae,M,100,0,30,30
Amylah,F,100,30,0,30
Anaiz,F,100,30,0,30
Anastashia,F,100,30,0,30
Annalisia,F,100,30,0,30
Annalissa,F,100,30,0,30
Antiono,M,100,0,30,30
Anu,F,100,30,0,30
Anup,M,100,0,30,30
Anupama,F,100,30,0,30
Anzley,F,100,30,0,30
Arben,M,100,0,30,30
Arma,F,100,30,0,30
Asahel,M,100,0,30,30
Asanti,F,70,21,9,30
Ashden,M,100,0,30,30
Ashon,M,100,0,30,30
Audery,F,100,30,0,30
Austine,F,57,17,13,30
Avik,M,100,0,30,30
Ayianna,F,100,30,0,30
Ayyub,M,100,0,30,30
Badr,M,100,0,30,30
Bassel,M,100,0,30,30
Bettylou,F,100,30,0,30
Biana,F,100,30,0,30
Birch,M,100,0,30,30
Bleu,F,63,19,11,30
Blong,M,100,0,30,30
Braun,M,100,0,30,30
Brayten,M,100,0,30,30
Breigh,F,100,30,0,30
Brenon,M,100,0,30,30
Brentyn,M,100,0,30,30
Briget,F,100,30,0,30
Britaney,F,100,30,0,30
Britania,F,100,30,0,30
Brizeida,F,100,30,0,30
Brookie,F,100,30,0,30
Brooklee,F,100,30,0,30
Brya,F,100,30,0,30
Caileen,F,100,30,0,30
Caitlinn,F,100,30,0,30
Calleen,F,100,30,0,30
Caoimhe,F,100,30,0,30
Carmell,F,77,23,7,30
Caydee,F,100,30,0,30
Cebastian,M,100,0,30,30
Celita,F,100,30,0,30
Cena,F,80,24,6,30
Chaela,F,100,30,0,30
Chalise,F,100,30,0,30
Chandi,F,100,30,0,30
Charizma,F,100,30,0,30
Chasiti,F,100,30,0,30
Chasyn,M,100,0,30,30
Christana,F,100,30,0,30
Clarine,F,100,30,0,30
Clelia,F,100,30,0,30
Clete,M,100,0,30,30
Cleven,M,100,0,30,30
Cohl,M,100,0,30,30
Cormick,M,100,0,30,30
Cyana,F,100,30,0,30
Dalayza,F,100,30,0,30
Daniil,M,100,0,30,30
Danity,F,100,30,0,30
Davan,M,77,7,23,30
Dayden,M,100,0,30,30
Dearius,M,100,0,30,30
Delight,F,100,30,0,30
Desere,F,100,30,0,30
Devereaux,M,100,0,30,30
Devonda,F,100,30,0,30
Devondre,M,100,0,30,30
Dewane,M,100,0,30,30
Dominyk,M,100,0,30,30
Domnique,M,60,12,18,30
Donalda,F,100,30,0,30
Dorthey,F,100,30,0,30
Dredyn,M,100,0,30,30
Dulcinea,F,100,30,0,30
Dustina,F,100,30,0,30
Dvon,M,100,0,30,30
Dywane,M,100,0,30,30
Eban,M,100,0,30,30
Edlin,F,100,30,0,30
Egbert,M,100,0,30,30
Ehab,M,100,0,30,30
Eilidh,F,100,30,0,30
Eilleen,F,100,30,0,30
Elara,F,100,30,0,30
Elenna,F,100,30,0,30
Elishah,M,100,0,30,30
Ellary,F,100,30,0,30
Ellinor,F,100,30,0,30
Elliyah,F,100,30,0,30
Ellouise,F,100,30,0,30
Ellowyn,F,100,30,0,30
Emiline,F,100,30,0,30
Emmry,F,100,30,0,30
Eraina,F,100,30,0,30
Eriona,F,100,30,0,30
Esbeidy,F,100,30,0,30
Esly,F,100,30,0,30
Ethin,M,100,0,30,30
Everitt,M,100,0,30,30
Evetta,F,100,30,0,30
Evrett,M,100,0,30,30
Eyanna,F,100,30,0,30
Fayetta,F,100,30,0,30
Fayette,F,100,30,0,30
Fernie,M,100,0,30,30
Fong,M,100,0,30,30
Fouad,M,100,0,30,30
Frankee,F,100,30,0,30
Fransisca,F,100,30,0,30
Fue,M,100,0,30,30
Ganon,M,100,0,30,30
Garritt,M,100,0,30,30
Gavrielle,F,100,30,0,30
Genesee,F,100,30,0,30
Gerod,M,100,0,30,30
Giavonni,F,100,30,0,30
Gilad,M,100,0,30,30
Ginevra,F,100,30,0,30
Grae,F,80,24,6,30
Grantham,M,100,0,30,30
Guliana,F,100,30,0,30
Hagar,F,100,30,0,30
Halena,F,100,30,0,30
Hamlet,M,100,0,30,30
Hayk,M,100,0,30,30
Hendy,F,100,30,0,30
Henning,M,100,0,30,30
Henriette,F,100,30,0,30
Herberth,M,100,0,30,30
Hermela,F,100,30,0,30
Hila,F,100,30,0,30
Hinata,F,100,30,0,30
Honour,F,67,20,10,30
Huckleberry,M,100,0,30,30
Huma,F,100,30,0,30
Hykeem,M,100,0,30,30
Ido,M,100,0,30,30
Idy,F,100,30,0,30
Ion,M,100,0,30,30
Jadence,F,100,30,0,30
Jahson,M,100,0,30,30
Jailan,M,73,8,22,30
Jakaiden,M,100,0,30,30
Jakyah,F,100,30,0,30
Jalexis,F,100,30,0,30
Jamaiya,F,100,30,0,30
Jameika,F,100,30,0,30
Jamielyn,F,100,30,0,30
Jamori,M,100,0,30,30
Janathan,M,100,0,30,30
Jannetta,F,100,30,0,30
Jaran,M,100,0,30,30
Jaray,M,100,0,30,30
Jarmaine,M,100,0,30,30
Jasira,F,100,30,0,30
Javarion,M,100,0,30,30
Javontay,M,100,0,30,30
Jayan,M,100,0,30,30
Jaydien,M,100,0,30,30
Jaylianna,F,100,30,0,30
Jazzlin,F,100,30,0,30
Jedrek,M,100,0,30,30
Jenasis,F,100,30,0,30
Jennetta,F,100,30,0,30
Jesscia,F,100,30,0,30
Jniya,F,100,30,0,30
Joeanthony,M,100,0,30,30
Jonalyn,F,100,30,0,30
Jood,F,100,30,0,30
Joram,M,100,0,30,30
Jordynne,F,100,30,0,30
Josian,M,100,0,30,30
Jovee,F,100,30,0,30
Juliah,F,100,30,0,30
Kahlen,F,100,30,0,30
Kalaysia,F,100,30,0,30
Kallum,M,100,0,30,30
Kalyna,F,100,30,0,30
Kamaal,M,100,0,30,30
Kamaron,M,100,0,30,30
Kamarri,M,77,7,23,30
Kanan,M,100,0,30,30
Kannan,M,100,0,30,30
Karelyn,F,100,30,0,30
Karlye,F,100,30,0,30
Karmon,F,100,30,0,30
Karriem,M,100,0,30,30
Karrisa,F,100,30,0,30
Kassem,M,100,0,30,30
Katelynd,F,100,30,0,30
Keaston,M,100,0,30,30
Keenya,F,100,30,0,30
Keeshawn,M,100,0,30,30
Kenson,M,100,0,30,30
Keyandre,M,100,0,30,30
Keyani,F,100,30,0,30
Khani,M,83,5,25,30
Kimala,F,100,30,0,30
Kingslee,M,63,11,19,30
Kingstyn,M,100,0,30,30
Kippy,M,57,13,17,30
Kiven,M,100,0,30,30
Klaira,F,100,30,0,30
Klye,M,100,0,30,30
Knute,M,100,0,30,30
Konstance,F,100,30,0,30
Korryn,F,100,30,0,30
Kowen,M,100,0,30,30
Krystan,F,100,30,0,30
Laasia,F,100,30,0,30
Ladainian,M,100,0,30,30
Ladale,M,100,0,30,30
Ladarian,M,100,0,30,30
Laithan,M,100,0,30,30
Lakeem,M,100,0,30,30
Lakely,F,100,30,0,30
Laketha,F,100,30,0,30
Lanice,F,100,30,0,30
Lannah,F,100,30,0,30
Laporcha,F,100,30,0,30
Larah,F,100,30,0,30
Laressa,F,100,30,0,30
Laritza,F,100,30,0,30
Lasheka,F,100,30,0,30
Latavius,M,100,0,30,30
Lathaniel,M,100,0,30,30
Latiffany,F,100,30,0,30
Latrenda,F,100,30,0,30
Lc,M,100,0,30,30
Leam,M,100,0,30,30
Leitha,F,100,30,0,30
Lenah,F,100,30,0,30
Leno,M,100,0,30,30
Levorn,M,70,9,21,30
Lianny,F,100,30,0,30
Libbi,F,100,30,0,30
Lillyona,F,100,30,0,30
Lindey,F,100,30,0,30
Linkon,M,100,0,30,30
Lorrene,F,100,30,0,30
Luwanna,F,100,30,0,30
Lyah,F,100,30,0,30
Lyrical,F,100,30,0,30
Macaria,F,100,30,0,30
Maciel,M,60,12,18,30
Maclaine,F,70,21,9,30
Macrina,F,100,30,0,30
Makailyn,F,100,30,0,30
Makenly,F,100,30,0,30
Makinzee,F,100,30,0,30
Malayiah,F,100,30,0,30
Maleea,F,100,30,0,30
Malikye,M,100,0,30,30
Marca,F,100,30,0,30
Marda,F,100,30,0,30
Mareena,F,100,30,0,30
Mariaclara,F,100,30,0,30
Marialy,F,100,30,0,30
Marjie,F,100,30,0,30
Markeita,F,100,30,0,30
Markevious,M,100,0,30,30
Marnae,F,100,30,0,30
Marvelle,M,80,6,24,30
Marvetta,F,100,30,0,30
Matei,M,100,0,30,30
Matilynn,F,100,30,0,30
Mattheus,M,100,0,30,30
Mattia,M,80,6,24,30
Mehr,F,100,30,0,30
Meigan,F,100,30,0,30
Melquan,M,100,0,30,30
Merly,F,100,30,0,30
Messi,M,100,0,30,30
Miia,F,100,30,0,30
Millissa,F,100,30,0,30
Mithra,F,100,30,0,30
Mohanad,M,100,0,30,30
Momina,F,100,30,0,30
Monterio,M,100,0,30,30
Moosa,M,100,0,30,30
Morena,F,100,30,0,30
Mumtaz,F,100,30,0,30
Mylena,F,100,30,0,30
Myliah,F,100,30,0,30
Nairi,F,100,30,0,30
Naliah,F,100,30,0,30
Naquita,F,100,30,0,30
Nari,F,100,30,0,30
Natori,F,100,30,0,30
Nelli,F,100,30,0,30
Neriyah,F,100,30,0,30
Nicasio,M,100,0,30,30
Nihar,M,100,0,30,30
Niyanna,F,100,30,0,30
Nyelli,F,100,30,0,30
Oluwaseyi,M,70,9,21,30
Oni,F,100,30,0,30
Onofre,M,100,0,30,30
Ortencia,F,100,30,0,30
Otilio,M,100,0,30,30
Ottie,M,63,11,19,30
Ozan,M,100,0,30,30
Palak,F,100,30,0,30
Parnika,F,100,30,0,30
Pike,M,100,0,30,30
Quandarius,M,100,0,30,30
Quaneisha,F,100,30,0,30
Quynn,F,100,30,0,30
Raffaella,F,100,30,0,30
Ramata,F,100,30,0,30
Reon,M,100,0,30,30
Retaj,F,100,30,0,30
Rilie,F,100,30,0,30
Rishon,M,100,0,30,30
Robynne,F,100,30,0,30
Rockelle,F,100,30,0,30
Rockne,M,100,0,30,30
Rodricus,M,100,0,30,30
Rogina,F,100,30,0,30
Roneshia,F,100,30,0,30
Roniya,F,100,30,0,30
Ronnesha,F,100,30,0,30
Ronya,F,100,30,0,30
Rosaland,F,100,30,0,30
Rutledge,M,100,0,30,30
Ryenne,F,100,30,0,30
Saatvik,M,100,0,30,30
Sachiko,F,100,30,0,30
Sadiyah,F,100,30,0,30
Samanthajo,F,100,30,0,30
Samiyyah,F,100,30,0,30
Santi,M,100,0,30,30
Santresa,F,100,30,0,30
Saraann,F,100,30,0,30
Saraih,F,100,30,0,30
Saranya,F,100,30,0,30
Scheryl,F,100,30,0,30
Seon,M,100,0,30,30
Serenidy,F,100,30,0,30
Serenna,F,100,30,0,30
Shakeia,F,100,30,0,30
Shakerra,F,100,30,0,30
Shalandra,F,100,30,0,30
Shameek,M,100,0,30,30
Shamonica,F,100,30,0,30
Shams,F,80,24,6,30
Shanitra,F,100,30,0,30
Sheilia,F,100,30,0,30
Sherisse,F,100,30,0,30
Sherrin,F,100,30,0,30
Shevy,F,83,25,5,30
Shimshon,M,100,0,30,30
Shirlie,F,100,30,0,30
Shontavia,F,100,30,0,30
Sigfredo,M,100,0,30,30
Slyvia,F,100,30,0,30
Sneijder,M,100,0,30,30
Solina,F,100,30,0,30
Sparsh,M,100,0,30,30
Stark,M,100,0,30,30
Stefanny,F,100,30,0,30
Sweta,F,100,30,0,30
Syanna,F,100,30,0,30
Sylena,F,100,30,0,30
Takeshi,M,100,0,30,30
Takita,F,100,30,0,30
Taleyah,F,100,30,0,30
Tanara,F,100,30,0,30
Tannon,M,100,0,30,30
Taro,M,100,0,30,30
Teka,F,100,30,0,30
Telina,F,100,30,0,30
Temekia,F,100,30,0,30
Temperence,F,100,30,0,30
Tenise,F,100,30,0,30
Tevyn,M,83,5,25,30
Thurmon,M,100,0,30,30
Tichina,F,100,30,0,30
Tilley,F,100,30,0,30
Tlaloc,M,100,0,30,30
Torben,M,100,0,30,30
Traniyah,F,100,30,0,30
Travas,M,100,0,30,30
Trayden,M,100,0,30,30
Treanna,F,100,30,0,30
Trenae,F,100,30,0,30
Tyan,M,80,6,24,30
Tylyn,F,67,20,10,30
Valeta,F,100,30,0,30
Valissa,F,100,30,0,30
Victorious,M,57,13,17,30
Virat,M,100,0,30,30
Wrenn,F,100,30,0,30
Xachary,M,100,0,30,30
Xiara,F,100,30,0,30
Yann,M,100,0,30,30
Yaziel,M,100,0,30,30
Yerachmiel,M,100,0,30,30
Yeslin,F,100,30,0,30
Yitzhak,M,100,0,30,30
Zailee,F,100,30,0,30
Zakyra,F,100,30,0,30
Zariel,F,100,30,0,30
Zaveon,M,100,0,30,30
Zayon,M,100,0,30,30
Zea,F,100,30,0,30
Zeric,M,100,0,30,30
Zissel,F,100,30,0,30
Ziyana,F,100,30,0,30
Zohra,F,100,30,0,30
Zuzu,F,100,30,0,30
Aberdeen,F,100,29,0,29
Abrina,F,100,29,0,29
Agustus,M,100,0,29,29
Ahmaud,M,100,0,29,29
Ahyan,M,100,0,29,29
Ailie,F,100,29,0,29
Alcide,M,100,0,29,29
Aleksia,F,100,29,0,29
Alexxander,M,100,0,29,29
Alezander,M,100,0,29,29
Alyona,F,100,29,0,29
Amarian,M,100,0,29,29
Amaurie,F,62,18,11,29
Amberrose,F,100,29,0,29
Ameira,F,100,29,0,29
Ameriah,F,100,29,0,29
Andretta,F,100,29,0,29
Aneri,F,100,29,0,29
Aneshia,F,100,29,0,29
Anikka,F,100,29,0,29
Annalisse,F,100,29,0,29
Annastyn,F,100,29,0,29
Annebelle,F,100,29,0,29
Annell,F,100,29,0,29
Anthonee,M,100,0,29,29
Antionne,M,100,0,29,29
Aradhya,F,100,29,0,29
Arber,M,100,0,29,29
Arelys,F,100,29,0,29
Argentina,F,100,29,0,29
Arkeem,M,100,0,29,29
Arrin,M,76,7,22,29
Astoria,F,100,29,0,29
Atiyah,F,100,29,0,29
Audryna,F,100,29,0,29
Aum,M,100,0,29,29
Avleen,F,100,29,0,29
Aydien,M,100,0,29,29
Ayron,M,100,0,29,29
Azarion,M,100,0,29,29
Babak,M,100,0,29,29
Baelyn,F,100,29,0,29
Bathsheba,F,100,29,0,29
Bell,F,100,29,0,29
Benancio,M,100,0,29,29
Berneice,F,100,29,0,29
Birtha,F,100,29,0,29
Braniya,F,100,29,0,29
Braxon,M,100,0,29,29
Brealynn,F,100,29,0,29
Brevan,M,100,0,29,29
Breyson,M,100,0,29,29
Bri,F,100,29,0,29
Britiany,F,100,29,0,29
Bronsen,M,100,0,29,29
Brynda,F,100,29,0,29
Cachet,F,100,29,0,29
Caidance,F,100,29,0,29
Catia,F,100,29,0,29
Cavon,M,100,0,29,29
Chamar,M,100,0,29,29
Chanson,M,100,0,29,29
Charlita,F,100,29,0,29
Chella,F,100,29,0,29
Cherl,F,100,29,0,29
Cheyla,F,100,29,0,29
Chrishelle,F,100,29,0,29
Chrystine,F,100,29,0,29
Cipriana,F,100,29,0,29
Colan,M,100,0,29,29
Contrell,M,100,0,29,29
Corazon,F,100,29,0,29
Corita,F,100,29,0,29
Cortny,F,100,29,0,29
Cyleigh,F,100,29,0,29
Daaron,M,100,0,29,29
Dahlila,F,100,29,0,29
Dailan,M,100,0,29,29
Damali,F,100,29,0,29
Damilola,F,79,23,6,29
Damyah,F,100,29,0,29
Danasha,F,100,29,0,29
Danicka,F,100,29,0,29
Dannell,F,76,22,7,29
Darlen,F,100,29,0,29
Dashauna,F,100,29,0,29
Day,F,83,24,5,29
Dayona,F,100,29,0,29
Deaken,M,100,0,29,29
Deanie,F,100,29,0,29
Dehlia,F,100,29,0,29
Delayla,F,100,29,0,29
Delissa,F,100,29,0,29
Delrico,M,100,0,29,29
Demauri,M,100,0,29,29
Demetrica,F,100,29,0,29
Demiah,F,100,29,0,29
Deneice,F,100,29,0,29
Deneshia,F,100,29,0,29
Dereke,M,100,0,29,29
Deshan,M,100,0,29,29
Dineen,F,100,29,0,29
Diontay,M,100,0,29,29
Dishawn,M,100,0,29,29
Dolton,M,100,0,29,29
Donaldo,M,100,0,29,29
Doral,M,59,12,17,29
Dreden,M,100,0,29,29
Drina,F,100,29,0,29
Duchess,F,100,29,0,29
Duvid,M,100,0,29,29
Elanda,F,100,29,0,29
Elchonon,M,100,0,29,29
Eleftherios,M,100,0,29,29
Elesia,F,100,29,0,29
Elyan,M,100,0,29,29
Emmilee,F,100,29,0,29
Enes,M,100,0,29,29
England,F,100,29,0,29
Ereka,F,100,29,0,29
Erle,M,100,0,29,29
Erline,F,100,29,0,29
Evolett,F,100,29,0,29
Ewa,F,100,29,0,29
Ezinne,F,100,29,0,29
Farouk,M,100,0,29,29
Ferne,F,100,29,0,29
Fitzroy,M,100,0,29,29
Fontaine,M,62,11,18,29
Gavynn,M,100,0,29,29
Genora,F,100,29,0,29
Geonna,F,100,29,0,29
Giordano,M,100,0,29,29
Glendell,M,76,7,22,29
Gurman,M,100,0,29,29
Gurveer,M,100,0,29,29
Haide,F,100,29,0,29
Haitham,M,100,0,29,29
Hakop,M,100,0,29,29
Haleem,M,100,0,29,29
Hamp,M,100,0,29,29
Haralambos,M,100,0,29,29
Hasnain,M,100,0,29,29
Hatim,M,100,0,29,29
Hayato,M,100,0,29,29
Heidie,F,100,29,0,29
Helaman,M,100,0,29,29
Helder,M,100,0,29,29
Himani,F,100,29,0,29
Holten,M,100,0,29,29
Humaira,F,100,29,0,29
Ifeanyichukwu,M,100,0,29,29
Io,F,79,23,6,29
Iridian,F,100,29,0,29
Isatou,F,100,29,0,29
Iysis,F,100,29,0,29
Jadarrius,M,100,0,29,29
Jadia,F,100,29,0,29
Jahlani,M,83,5,24,29
Jahzeel,M,59,12,17,29
Jaishawn,M,100,0,29,29
Jaki,M,100,0,29,29
Jakylah,F,100,29,0,29
Janeah,F,100,29,0,29
Janeal,F,100,29,0,29
Janeya,F,100,29,0,29
Janifer,F,100,29,0,29
Jannis,F,100,29,0,29
Jarae,F,79,23,6,29
Jarome,M,100,0,29,29
Jasiri,M,76,7,22,29
Jasmon,F,76,22,7,29
Jassmin,F,100,29,0,29
Javarus,M,100,0,29,29
Javona,F,100,29,0,29
Jaxsin,M,100,0,29,29
Jayona,F,100,29,0,29
Jayzen,M,100,0,29,29
Jebadiah,M,100,0,29,29
Jentri,F,100,29,0,29
Jerrilynn,F,100,29,0,29
Jessicah,F,100,29,0,29
Jla,F,100,29,0,29
Jobany,M,100,0,29,29
Jodeen,F,100,29,0,29
Joevon,M,100,0,29,29
Johnjoseph,M,100,0,29,29
Jonan,M,100,0,29,29
Jonathyn,M,100,0,29,29
Jony,M,100,0,29,29
Jowanna,F,100,29,0,29
Juanda,F,100,29,0,29
Juandaniel,M,100,0,29,29
Julyana,F,100,29,0,29
Jvion,M,100,0,29,29
Jw,M,100,0,29,29
Kaelon,M,100,0,29,29
Kaleisha,F,100,29,0,29
Kalijah,M,79,6,23,29
Kalliopi,F,100,29,0,29
Kanishk,M,100,0,29,29
Karelly,F,100,29,0,29
Karington,F,100,29,0,29
Karlena,F,100,29,0,29
Kashon,M,100,0,29,29
Kavish,M,100,0,29,29
Kayven,M,100,0,29,29
Kazandra,F,100,29,0,29
Keagon,M,100,0,29,29
Keighan,M,100,0,29,29
Keithon,M,100,0,29,29
Kelbi,F,100,29,0,29
Keldric,M,100,0,29,29
Kelen,M,100,0,29,29
Keyaan,M,100,0,29,29
Keyleigh,F,100,29,0,29
Keyondra,F,100,29,0,29
Keyosha,F,100,29,0,29
Khaidyn,M,100,0,29,29
Kinzlie,F,100,29,0,29
Klein,M,100,0,29,29
Koal,M,100,0,29,29
Kyser,M,100,0,29,29
Labella,F,100,29,0,29
Labrandon,M,100,0,29,29
Ladonya,F,100,29,0,29
Lailyn,F,100,29,0,29
Lamarius,M,100,0,29,29
Laportia,F,100,29,0,29
Larwence,M,100,0,29,29
Lataisha,F,100,29,0,29
Lateka,F,100,29,0,29
Latroya,F,100,29,0,29
Laurell,F,100,29,0,29
Lavonya,F,100,29,0,29
Leeasia,F,100,29,0,29
Leng,M,100,0,29,29
Lenix,F,52,15,14,29
Lennyn,F,59,17,12,29
Leonte,M,100,0,29,29
Lexii,F,100,29,0,29
Librada,F,100,29,0,29
Lilyahna,F,100,29,0,29
Lilyanah,F,100,29,0,29
Lindalee,F,100,29,0,29
Lineth,F,100,29,0,29
Linnaea,F,100,29,0,29
Lolah,F,100,29,0,29
Lorella,F,100,29,0,29
Loribeth,F,100,29,0,29
Luba,F,100,29,0,29
Madysin,F,100,29,0,29
Maecy,F,100,29,0,29
Mahmud,M,100,0,29,29
Makale,M,100,0,29,29
Makila,F,100,29,0,29
Malayasia,F,100,29,0,29
Maleeyah,F,100,29,0,29
Manvir,M,83,5,24,29
Mao,F,100,29,0,29
Marae,F,100,29,0,29
Marcelus,M,100,0,29,29
Margy,F,100,29,0,29
Mariesa,F,100,29,0,29
Marlis,F,100,29,0,29
Marny,F,100,29,0,29
Martia,F,100,29,0,29
Maruice,M,100,0,29,29
Marybell,F,100,29,0,29
Masie,F,100,29,0,29
Maytal,F,100,29,0,29
Mayuri,F,100,29,0,29
Mazi,F,79,23,6,29
Melicia,F,100,29,0,29
Merick,M,100,0,29,29
Mersadie,F,100,29,0,29
Mieka,F,100,29,0,29
Mikyle,M,100,0,29,29
Milayna,F,100,29,0,29
Mirinda,F,100,29,0,29
Mishawn,M,52,14,15,29
Molley,F,100,29,0,29
Moriyah,F,100,29,0,29
Muntaha,F,100,29,0,29
Nakyia,F,100,29,0,29
Nathalya,F,100,29,0,29
Nation,M,100,0,29,29
Nazeer,M,100,0,29,29
Neeka,F,100,29,0,29
Nekita,F,100,29,0,29
Niaja,F,100,29,0,29
Nicklos,M,100,0,29,29
Nilson,M,100,0,29,29
Nirvan,M,100,0,29,29
Norita,F,100,29,0,29
Novalie,F,100,29,0,29
Nusaybah,F,100,29,0,29
Nzinga,F,100,29,0,29
Ogden,M,100,0,29,29
Oliviana,F,100,29,0,29
Orrie,M,100,0,29,29
Patsey,F,100,29,0,29
Pearlean,F,100,29,0,29
Phiona,F,100,29,0,29
Piercen,M,100,0,29,29
Preciosa,F,100,29,0,29
Quantae,M,100,0,29,29
Quenisha,F,100,29,0,29
Rachna,F,100,29,0,29
Raiford,M,100,0,29,29
Raima,F,100,29,0,29
Ranny,M,100,0,29,29
Raveena,F,100,29,0,29
Reine,F,100,29,0,29
Reneta,F,100,29,0,29
Reshonda,F,100,29,0,29
Rhegan,F,100,29,0,29
Ripken,M,100,0,29,29
Rivan,M,100,0,29,29
Rohaan,M,100,0,29,29
Roniyah,F,100,29,0,29
Rosalea,F,100,29,0,29
Roshad,M,100,0,29,29
Rutger,M,100,0,29,29
Sabiha,F,100,29,0,29
Salam,F,100,29,0,29
Saliha,F,100,29,0,29
Sanaiya,F,100,29,0,29
Sarin,F,62,18,11,29
Saturnino,M,100,0,29,29
Sencere,M,100,0,29,29
Shalese,F,100,29,0,29
Sharna,F,100,29,0,29
Shawnetta,F,100,29,0,29
Shekita,F,100,29,0,29
Shenee,F,100,29,0,29
Shere,F,100,29,0,29
Shirlyn,F,100,29,0,29
Shivali,F,100,29,0,29
Silus,M,100,0,29,29
Simya,F,100,29,0,29
Standley,M,100,0,29,29
Stehanie,F,100,29,0,29
Suellyn,F,100,29,0,29
Sumeet,M,83,5,24,29
Summerlyn,F,100,29,0,29
Syrah,F,100,29,0,29
Taffany,F,100,29,0,29
Tajon,M,100,0,29,29
Takeia,F,100,29,0,29
Tamecia,F,100,29,0,29
Tatym,F,100,29,0,29
Temprance,F,100,29,0,29
Tessy,F,100,29,0,29
Tevion,M,100,0,29,29
Thedore,M,100,0,29,29
Theoden,M,100,0,29,29
Timithy,M,100,0,29,29
Timohty,M,100,0,29,29
Tiziana,F,100,29,0,29
Tonjia,F,100,29,0,29
Toyna,F,100,29,0,29
Trevelle,M,100,0,29,29
Tsering,F,72,21,8,29
Tunisha,F,100,29,0,29
Turki,M,100,0,29,29
Tyke,M,100,0,29,29
Tymesha,F,100,29,0,29
Vanesha,F,100,29,0,29
Vashaun,M,100,0,29,29
Vayla,F,100,29,0,29
Victorino,M,100,0,29,29
Viktoriya,F,100,29,0,29
Vitoria,F,100,29,0,29
Wendelin,F,100,29,0,29
Wynell,F,100,29,0,29
Yacob,M,100,0,29,29
Yanel,F,100,29,0,29
Yarelli,F,100,29,0,29
Yashua,M,100,0,29,29
Ytzel,F,100,29,0,29
Yuto,M,100,0,29,29
Yvett,F,100,29,0,29
Yvone,F,100,29,0,29
Zaahir,M,100,0,29,29
Zadrian,M,100,0,29,29
Zafirah,F,100,29,0,29
Zakeria,F,100,29,0,29
Zamzam,F,100,29,0,29
Zanai,F,100,29,0,29
Zaryan,M,100,0,29,29
Zaryn,F,59,17,12,29
Zayyan,M,100,0,29,29
Zeferino,M,100,0,29,29
Zlaty,F,100,29,0,29
Aahna,F,100,28,0,28
Abdalrahman,M,100,0,28,28
Abenezer,M,100,0,28,28
Abhi,M,100,0,28,28
Acxel,M,100,0,28,28
Adamarie,F,100,28,0,28
Adamarys,F,100,28,0,28
Adaora,F,100,28,0,28
Addasyn,F,100,28,0,28
Adelae,F,100,28,0,28
Ahnika,F,100,28,0,28
Ahrianna,F,100,28,0,28
Airon,M,100,0,28,28
Aizlyn,F,100,28,0,28
Ajayla,F,100,28,0,28
Akshath,M,100,0,28,28
Alegandra,F,100,28,0,28
Alexandera,F,100,28,0,28
Aleysia,F,100,28,0,28
Alfrieda,F,100,28,0,28
Alhassan,M,100,0,28,28
Alicianna,F,100,28,0,28
Allaina,F,100,28,0,28
Allyna,F,100,28,0,28
Alvita,F,100,28,0,28
Amante,M,100,0,28,28
Amorah,F,100,28,0,28
Anaja,F,100,28,0,28
Anajah,F,100,28,0,28
Anayely,F,100,28,0,28
Angeligue,F,100,28,0,28
Angelys,F,100,28,0,28
Anisia,F,100,28,0,28
Anjelique,F,100,28,0,28
Antar,M,100,0,28,28
Antawan,M,100,0,28,28
Antoria,F,100,28,0,28
Antwoin,M,100,0,28,28
Anushree,F,100,28,0,28
Anzal,F,100,28,0,28
Aqeel,M,100,0,28,28
Araiya,F,100,28,0,28
Areesha,F,100,28,0,28
Arias,M,82,5,23,28
Arlicia,F,100,28,0,28
Armonte,M,100,0,28,28
Aroush,F,100,28,0,28
Arye,M,100,0,28,28
Aryianna,F,100,28,0,28
Ashleynicole,F,100,28,0,28
Audel,M,100,0,28,28
Audwin,M,100,0,28,28
Azaryah,F,71,20,8,28
Azaylia,F,100,28,0,28
Azel,M,79,6,22,28
Bailynn,F,100,28,0,28
Beretta,F,100,28,0,28
Betzabeth,F,100,28,0,28
Billal,M,100,0,28,28
Blaike,M,61,11,17,28
Braelynne,F,100,28,0,28
Brahm,M,100,0,28,28
Braian,M,100,0,28,28
Brayley,F,100,28,0,28
Breandan,M,100,0,28,28
Breyton,M,100,0,28,28
Brietta,F,100,28,0,28
Cabella,F,100,28,0,28
Caldwell,M,100,0,28,28
Camaria,F,100,28,0,28
Camaya,F,100,28,0,28
Cantrell,M,100,0,28,28
Carmalita,F,100,28,0,28
Cashis,M,100,0,28,28
Charae,F,100,28,0,28
Charnise,F,100,28,0,28
Chayson,M,100,0,28,28
Cheryn,F,100,28,0,28
Christalyn,F,100,28,0,28
Christeena,F,100,28,0,28
Clarie,F,100,28,0,28
Cleavon,M,100,0,28,28
Coraima,F,100,28,0,28
Cortavious,M,100,0,28,28
Coulson,M,100,0,28,28
Daelon,M,100,0,28,28
Dagmawi,M,100,0,28,28
Daichi,M,100,0,28,28
Dajohn,M,100,0,28,28
Dalaya,F,100,28,0,28
Daneshia,F,100,28,0,28
Danile,M,82,5,23,28
Dannetta,F,100,28,0,28
Dardan,M,100,0,28,28
Daveyon,M,100,0,28,28
Dawood,M,100,0,28,28
Deasha,F,100,28,0,28
Delainy,F,100,28,0,28
Delfin,M,100,0,28,28
Delise,F,100,28,0,28
Denetria,F,100,28,0,28
Derrika,F,100,28,0,28
Deshone,M,79,6,22,28
Deslyn,F,100,28,0,28
Desmin,M,82,5,23,28
Detrice,F,100,28,0,28
Devlon,M,100,0,28,28
Docia,F,100,28,0,28
Domique,M,64,10,18,28
Donni,F,100,28,0,28
Dragan,M,100,0,28,28
Drevion,M,100,0,28,28
Dyrell,M,100,0,28,28
Elianne,F,100,28,0,28
Eliasar,M,100,0,28,28
Ellanore,F,100,28,0,28
Elloise,F,100,28,0,28
Ellsie,F,100,28,0,28
Emberleigh,F,100,28,0,28
Emet,M,100,0,28,28
Emmakate,F,100,28,0,28
Emonii,F,100,28,0,28
Erikson,M,100,0,28,28
Erinne,F,100,28,0,28
Estiven,M,100,0,28,28
Eustacio,M,100,0,28,28
Evangaline,F,100,28,0,28
Evangelene,F,100,28,0,28
Eymi,F,100,28,0,28
Ezmae,F,100,28,0,28
Faizah,F,100,28,0,28
Feliciana,F,100,28,0,28
Fin,M,100,0,28,28
Finesse,F,82,23,5,28
Foxx,M,100,0,28,28
Francella,F,100,28,0,28
Fredrika,F,100,28,0,28
Gabreil,M,82,5,23,28
Gabrian,M,100,0,28,28
Ganesh,M,100,0,28,28
Genesi,F,100,28,0,28
Gianelle,F,100,28,0,28
Gloriann,F,100,28,0,28
Glorious,F,100,28,0,28
Govanni,M,100,0,28,28
Graesyn,M,61,11,17,28
Greenley,F,100,28,0,28
Haeli,F,100,28,0,28
Hagop,M,100,0,28,28
Haidar,M,100,0,28,28
Hanne,F,100,28,0,28
Harrietta,F,100,28,0,28
Harsha,M,100,0,28,28
Harshita,F,100,28,0,28
Hibba,F,100,28,0,28
Hilaria,F,100,28,0,28
Hinley,F,100,28,0,28
Isidora,F,100,28,0,28
Ivet,F,100,28,0,28
Iviana,F,100,28,0,28
Ivis,F,54,15,13,28
Jacobey,M,100,0,28,28
Jacquelina,F,100,28,0,28
Jaeli,F,100,28,0,28
Jaeshawn,M,100,0,28,28
Jahkari,M,100,0,28,28
Jaidy,F,100,28,0,28
Jaiel,M,57,12,16,28
Jailyne,F,100,28,0,28
Jaine,F,100,28,0,28
Jaisen,M,100,0,28,28
Jakie,M,100,0,28,28
Jaleal,M,100,0,28,28
Jamilex,F,100,28,0,28
Janilah,F,100,28,0,28
Jaquisha,F,100,28,0,28
Jaqwan,M,100,0,28,28
Jaremy,M,100,0,28,28
Jariana,F,100,28,0,28
Javed,M,100,0,28,28
Javonnie,M,82,5,23,28
Jayleene,F,100,28,0,28
Jeananne,F,100,28,0,28
Jenalee,F,100,28,0,28
Jennice,F,100,28,0,28
Jeoffrey,M,100,0,28,28
Jeriyah,F,100,28,0,28
Jerricka,F,100,28,0,28
Jeselle,F,100,28,0,28
Jhayden,M,100,0,28,28
Jivan,M,100,0,28,28
Jiyah,F,100,28,0,28
Jolaine,F,100,28,0,28
Joncarlo,M,100,0,28,28
Jontavius,M,100,0,28,28
Joscelin,F,100,28,0,28
Jove,M,100,0,28,28
Jozee,F,100,28,0,28
Kable,M,100,0,28,28
Kabrina,F,100,28,0,28
Kaelob,M,100,0,28,28
Kairos,M,100,0,28,28
Kalla,F,100,28,0,28
Kameko,F,100,28,0,28
Kanden,M,100,0,28,28
Kateria,F,100,28,0,28
Katiya,F,100,28,0,28
Kayliah,F,100,28,0,28
Kayona,F,100,28,0,28
Keanen,M,100,0,28,28
Keath,M,100,0,28,28
Keiasia,F,100,28,0,28
Keiffer,M,100,0,28,28
Keilin,F,64,18,10,28
Keimani,F,57,16,12,28
Keiosha,F,100,28,0,28
Kell,M,100,0,28,28
Kelsay,F,100,28,0,28
Kendyn,M,100,0,28,28
Kentley,F,75,21,7,28
Kerim,M,100,0,28,28
Kerith,F,100,28,0,28
Khadeeja,F,100,28,0,28
Khalel,M,100,0,28,28
Kiala,F,100,28,0,28
Kiannah,F,100,28,0,28
Kianni,F,100,28,0,28
Kimela,F,100,28,0,28
Kinya,F,100,28,0,28
Kioni,F,100,28,0,28
Kipling,M,100,0,28,28
Kiree,M,100,0,28,28
Korena,F,100,28,0,28
Korver,M,100,0,28,28
Krystalynn,F,100,28,0,28
Kurtiss,M,100,0,28,28
Kyani,F,100,28,0,28
Kyllie,F,100,28,0,28
Kynan,M,100,0,28,28
Kynlei,F,100,28,0,28
Kynnadi,F,100,28,0,28
Kyoko,F,100,28,0,28
Ladeana,F,100,28,0,28
Lafaye,F,100,28,0,28
Lakeria,F,100,28,0,28
Lamyra,F,100,28,0,28
Laquanna,F,100,28,0,28
Lareen,F,100,28,0,28
Larone,M,100,0,28,28
Latausha,F,100,28,0,28
Laterica,F,100,28,0,28
Laurielle,F,100,28,0,28
Lavanya,F,100,28,0,28
Lawonda,F,100,28,0,28
Laymon,M,100,0,28,28
Leahna,F,100,28,0,28
Leanny,F,100,28,0,28
Lekia,F,100,28,0,28
Leonette,F,100,28,0,28
Lezley,F,100,28,0,28
Liela,F,100,28,0,28
Lilleigh,F,100,28,0,28
Lilliah,F,100,28,0,28
Lillyth,F,100,28,0,28
Lilymae,F,100,28,0,28
Linkyn,M,100,0,28,28
Lio,M,100,0,28,28
Lion,M,100,0,28,28
Livier,F,100,28,0,28
Londin,F,100,28,0,28
Lonnette,F,100,28,0,28
Loriel,F,100,28,0,28
Lowry,M,100,0,28,28
Lucrezia,F,100,28,0,28
Luster,M,100,0,28,28
Lynnelle,F,100,28,0,28
Macgregor,M,100,0,28,28
Makaylynn,F,100,28,0,28
Makenze,F,100,28,0,28
Makyra,F,100,28,0,28
Malakhai,M,100,0,28,28
Manika,F,100,28,0,28
Manson,M,100,0,28,28
Marcellis,M,100,0,28,28
Marilla,F,100,28,0,28
Markella,F,100,28,0,28
Marquay,M,100,0,28,28
Martese,M,100,0,28,28
Marvyn,M,100,0,28,28
Mathews,M,100,0,28,28
Mattelyn,F,100,28,0,28
Mckenzey,F,100,28,0,28
Mckinsley,F,100,28,0,28
Mearl,M,100,0,28,28
Meleana,F,100,28,0,28
Metzli,F,100,28,0,28
Mialynn,F,100,28,0,28
Miami,F,100,28,0,28
Michaeljohn,M,100,0,28,28
Miro,M,100,0,28,28
Misaki,F,100,28,0,28
Mithcell,M,100,0,28,28
Miyonna,F,100,28,0,28
Muneer,M,100,0,28,28
Murrell,M,100,0,28,28
Myelle,F,100,28,0,28
Myrical,F,100,28,0,28
Mystery,F,100,28,0,28
Nain,M,100,0,28,28
Naria,F,100,28,0,28
Natina,F,100,28,0,28
Navneet,F,79,22,6,28
Nekoda,M,100,0,28,28
Neosha,F,100,28,0,28
Nesta,M,82,5,23,28
Noga,F,100,28,0,28
Nuh,M,100,0,28,28
Nyashia,F,100,28,0,28
Nyasiah,F,100,28,0,28
Nyellie,F,100,28,0,28
Nyleah,F,100,28,0,28
Nyliah,F,100,28,0,28
Olufemi,M,100,0,28,28
Partick,M,100,0,28,28
Philisha,F,100,28,0,28
Platon,M,100,0,28,28
Princesa,F,100,28,0,28
Quana,F,100,28,0,28
Quincee,F,100,28,0,28
Raden,M,100,0,28,28
Rakel,F,100,28,0,28
Rasaan,M,100,0,28,28
Rayya,F,100,28,0,28
Real,M,100,0,28,28
Reganne,F,100,28,0,28
Rehanna,F,100,28,0,28
Remmie,F,100,28,0,28
Renalda,F,100,28,0,28
Renesmae,F,100,28,0,28
Richell,F,100,28,0,28
Riyanna,F,100,28,0,28
Rogene,F,100,28,0,28
Rosabel,F,100,28,0,28
Rosemaria,F,100,28,0,28
Royston,M,100,0,28,28
Ruchel,F,100,28,0,28
Rudell,M,61,11,17,28
Ryson,M,100,0,28,28
Sabriyah,F,100,28,0,28
Safina,F,100,28,0,28
Safira,F,100,28,0,28
Sagal,F,100,28,0,28
Sahithi,F,100,28,0,28
Salmaan,M,100,0,28,28
Samanyu,M,100,0,28,28
Sameria,F,100,28,0,28
Samona,F,100,28,0,28
Sanay,M,79,6,22,28
Satin,F,100,28,0,28
Secundino,M,100,0,28,28
Seham,F,100,28,0,28
Selinda,F,100,28,0,28
Seline,F,100,28,0,28
Semone,F,100,28,0,28
Shabazz,M,100,0,28,28
Shahzaib,M,100,0,28,28
Shailah,F,100,28,0,28
Shaima,F,100,28,0,28
Shantoria,F,100,28,0,28
Sheala,F,100,28,0,28
Shenique,F,100,28,0,28
Sherece,F,100,28,0,28
Sherlyne,F,100,28,0,28
Shina,F,100,28,0,28
Shiza,F,100,28,0,28
Shterna,F,100,28,0,28
Shulamis,F,100,28,0,28
Shyasia,F,100,28,0,28
Skyllar,F,100,28,0,28
Sony,M,100,0,28,28
Sophiamarie,F,100,28,0,28
Ta,F,68,19,9,28
Tabria,F,100,28,0,28
Taiylor,F,100,28,0,28
Tajia,F,100,28,0,28
Takela,F,100,28,0,28
Takeo,M,100,0,28,28
Taline,F,100,28,0,28
Talula,F,100,28,0,28
Tambria,F,100,28,0,28
Tamirah,F,100,28,0,28
Taquisha,F,100,28,0,28
Tazia,F,100,28,0,28
Teighlor,F,100,28,0,28
Terrianne,F,100,28,0,28
Terrionna,F,100,28,0,28
Terrius,M,100,0,28,28
Timi,F,100,28,0,28
Timisha,F,100,28,0,28
Tinya,F,100,28,0,28
Tishana,F,100,28,0,28
Tobenna,M,100,0,28,28
Trevaun,M,100,0,28,28
Tyeasha,F,100,28,0,28
Tylea,F,100,28,0,28
Tyleek,M,100,0,28,28
Tynasia,F,100,28,0,28
Tyrease,M,100,0,28,28
Uday,M,100,0,28,28
Ulani,F,100,28,0,28
Urias,M,100,0,28,28
Usiel,M,100,0,28,28
Vaani,F,100,28,0,28
Valley,F,100,28,0,28
Vanissa,F,100,28,0,28
Vash,M,100,0,28,28
Vedika,F,100,28,0,28
Vianny,F,100,28,0,28
Vicenta,F,100,28,0,28
Vicktoria,F,100,28,0,28
Vinayak,M,100,0,28,28
Vyom,M,100,0,28,28
Wei,M,100,0,28,28
Weyman,M,100,0,28,28
Wolfe,M,100,0,28,28
Yaa,F,100,28,0,28
Yamen,M,100,0,28,28
Yancarlos,M,100,0,28,28
Yaremi,F,100,28,0,28
Yaritzel,F,100,28,0,28
Yaxiel,M,100,0,28,28
Yazleemar,F,100,28,0,28
Yida,M,100,0,28,28
Yizel,F,100,28,0,28
Zakhia,F,100,28,0,28
Zayanna,F,100,28,0,28
Zeba,F,100,28,0,28
Zuley,F,100,28,0,28
Zyrah,F,100,28,0,28
Abdi,M,100,0,27,27
Abdirizak,M,100,0,27,27
Abiola,F,78,21,6,27
Adael,M,100,0,27,27
Adarian,M,100,0,27,27
Adasyn,F,100,27,0,27
Adeana,F,100,27,0,27
Adeleigh,F,100,27,0,27
Adilenne,F,100,27,0,27
Aeon,M,63,10,17,27
Afiya,F,100,27,0,27
Afrika,F,100,27,0,27
Afsheen,F,100,27,0,27
Aiyannah,F,100,27,0,27
Alaiza,F,100,27,0,27
Alegria,F,100,27,0,27
Alireza,M,100,0,27,27
Alixander,M,100,0,27,27
Allona,F,100,27,0,27
Alp,M,100,0,27,27
Amarius,M,100,0,27,27
Amea,F,100,27,0,27
Ameilia,F,100,27,0,27
Ameliana,F,100,27,0,27
Amilee,F,100,27,0,27
Anabeth,F,100,27,0,27
Andreka,F,100,27,0,27
Anella,F,100,27,0,27
Angelice,F,100,27,0,27
Anju,F,100,27,0,27
Annakate,F,100,27,0,27
Annalysia,F,100,27,0,27
Antara,F,100,27,0,27
Ardyce,F,100,27,0,27
Areatha,F,100,27,0,27
Arionne,F,100,27,0,27
Aritza,F,100,27,0,27
Arleene,F,100,27,0,27
Arlys,F,100,27,0,27
Arnesha,F,100,27,0,27
Ashvin,M,100,0,27,27
Auguste,M,100,0,27,27
Aujanae,F,100,27,0,27
Auset,F,100,27,0,27
Avalene,F,100,27,0,27
Averyanna,F,100,27,0,27
Aviannah,F,100,27,0,27
Aviella,F,100,27,0,27
Avien,M,100,0,27,27
Axelle,F,100,27,0,27
Aydrien,M,100,0,27,27
Barth,M,100,0,27,27
Basha,F,100,27,0,27
Basheer,M,100,0,27,27
Beauford,M,100,0,27,27
Berish,M,100,0,27,27
Bethenny,F,100,27,0,27
Beyza,F,100,27,0,27
Bhavik,M,100,0,27,27
Bonne,F,100,27,0,27
Brandey,F,100,27,0,27
Brayln,M,100,0,27,27
Brealyn,F,100,27,0,27
Brentin,M,100,0,27,27
Burhanuddin,M,100,0,27,27
Burnadette,F,100,27,0,27
Cadynce,F,100,27,0,27
Caid,M,100,0,27,27
Calle,F,100,27,0,27
Camar,M,100,0,27,27
Camy,F,100,27,0,27
Capricia,F,100,27,0,27
Carnesha,F,100,27,0,27
Carrieanne,F,100,27,0,27
Casee,F,100,27,0,27
Channah,F,100,27,0,27
Chasin,M,100,0,27,27
Chaze,M,100,0,27,27
Chima,M,100,0,27,27
Chinita,F,100,27,0,27
Chritopher,M,100,0,27,27
Chrystle,F,100,27,0,27
Chynah,F,100,27,0,27
Cierrah,F,100,27,0,27
Clevon,M,100,0,27,27
Cloee,F,100,27,0,27
Coreyon,M,100,0,27,27
Craven,M,100,0,27,27
Cynde,F,100,27,0,27
Czar,M,100,0,27,27
Daeshaun,M,100,0,27,27
Dagon,M,100,0,27,27
Daion,M,100,0,27,27
Daisi,F,100,27,0,27
Dallyn,M,78,6,21,27
Daly,F,81,22,5,27
Damarkus,M,100,0,27,27
Dametria,F,100,27,0,27
Danilyn,F,100,27,0,27
Danine,F,100,27,0,27
Daphna,F,100,27,0,27
Dariona,F,100,27,0,27
Dartanian,M,100,0,27,27
Deara,F,100,27,0,27
Debara,F,100,27,0,27
Debria,F,100,27,0,27
Dejanee,F,100,27,0,27
Delancey,F,56,15,12,27
Delaynee,F,100,27,0,27
Deldrick,M,100,0,27,27
Deliliah,F,100,27,0,27
Deondray,M,100,0,27,27
Devera,F,100,27,0,27
Devere,M,100,0,27,27
Devinne,F,100,27,0,27
Devy,F,100,27,0,27
Dhanvi,F,100,27,0,27
Dhanya,F,100,27,0,27
Dhruvi,F,100,27,0,27
Donnella,F,100,27,0,27
Dontel,M,100,0,27,27
Doriann,F,100,27,0,27
Dovber,M,100,0,27,27
Eaden,M,100,0,27,27
Eisen,M,100,0,27,27
Eliberto,M,100,0,27,27
Eliska,F,100,27,0,27
Ellarie,F,100,27,0,27
Eluterio,M,100,0,27,27
Emett,M,100,0,27,27
Emigdio,M,100,0,27,27
Emilyrose,F,100,27,0,27
Emogene,F,100,27,0,27
Emylia,F,100,27,0,27
Ernesta,F,100,27,0,27
Essynce,F,100,27,0,27
Esten,M,100,0,27,27
Evalynne,F,100,27,0,27
Evani,F,100,27,0,27
Everhett,M,100,0,27,27
Evoleht,F,100,27,0,27
Farhana,F,100,27,0,27
Faydra,F,100,27,0,27
Fitz,M,100,0,27,27
Franci,F,100,27,0,27
Frederich,M,100,0,27,27
Gaddiel,M,100,0,27,27
Geffrey,M,100,0,27,27
Gerritt,M,100,0,27,27
Gertha,F,100,27,0,27
Ghada,F,100,27,0,27
Gissela,F,100,27,0,27
Glenford,M,100,0,27,27
Grizelda,F,100,27,0,27
Gustavus,M,100,0,27,27
Haidy,F,100,27,0,27
Hanalei,F,100,27,0,27
Harrel,M,100,0,27,27
Hartlyn,F,100,27,0,27
Harvie,M,100,0,27,27
Hazem,M,100,0,27,27
Heyden,M,100,0,27,27
Heydy,F,100,27,0,27
Hilbert,M,100,0,27,27
Hildegard,F,100,27,0,27
Hillari,F,100,27,0,27
Hridhaan,M,100,0,27,27
Hughes,M,100,0,27,27
Idalie,F,100,27,0,27
Idil,F,100,27,0,27
Ilean,F,100,27,0,27
Imer,M,100,0,27,27
Irelynd,F,100,27,0,27
Ishmeal,M,100,0,27,27
Izela,F,100,27,0,27
Izick,M,100,0,27,27
Jabarie,M,100,0,27,27
Jabarri,M,100,0,27,27
Jabrea,F,100,27,0,27
Jacara,F,100,27,0,27
Jacquis,M,81,5,22,27
Jaesean,M,100,0,27,27
Jah,M,100,0,27,27
Jahmya,F,100,27,0,27
Jahnia,F,100,27,0,27
Jaiyden,M,100,0,27,27
Jakaila,F,100,27,0,27
Jaleya,F,100,27,0,27
Jamai,M,100,0,27,27
Jamarco,M,100,0,27,27
Jamas,M,100,0,27,27
Jameya,F,100,27,0,27
Jamyrah,F,100,27,0,27
Jance,M,81,5,22,27
Janeil,F,81,22,5,27
Janila,F,100,27,0,27
Janiqua,F,100,27,0,27
Janitza,F,100,27,0,27
Jarita,F,100,27,0,27
Jarvin,M,100,0,27,27
Jasa,F,100,27,0,27
Jasmond,M,52,13,14,27
Jasyn,M,100,0,27,27
Jatavius,M,100,0,27,27
Jayen,M,100,0,27,27
Jayma,F,100,27,0,27
Jaysin,M,100,0,27,27
Jenaye,F,100,27,0,27
Jennfier,F,100,27,0,27
Jerrit,M,100,0,27,27
Jersi,F,100,27,0,27
Jessah,F,100,27,0,27
Jesten,M,100,0,27,27
Jhordyn,F,81,22,5,27
Jhoselyn,F,100,27,0,27
Jilliane,F,100,27,0,27
Joedy,M,81,5,22,27
Joshus,M,100,0,27,27
Joslynne,F,100,27,0,27
Josuha,M,100,0,27,27
Jourdain,M,70,8,19,27
Joyelle,F,100,27,0,27
Jyllian,F,100,27,0,27
Jyron,M,100,0,27,27
Kaedynce,F,100,27,0,27
Kaesyn,M,100,0,27,27
Kahne,M,100,0,27,27
Kamali,M,74,7,20,27
Kamariah,F,100,27,0,27
Kanyla,F,100,27,0,27
Kashus,M,100,0,27,27
Kateryn,F,100,27,0,27
Kathline,F,100,27,0,27
Katricia,F,100,27,0,27
Katura,F,100,27,0,27
Kayceon,M,100,0,27,27
Kaylum,M,100,0,27,27
Keaundra,F,100,27,0,27
Kehaulani,F,100,27,0,27
Kelvyn,M,100,0,27,27
Kenita,F,100,27,0,27
Kenniya,F,100,27,0,27
Kennley,F,100,27,0,27
Kentavius,M,100,0,27,27
Kenyana,F,100,27,0,27
Kenyanna,F,100,27,0,27
Keo,M,100,0,27,27
Kerah,F,100,27,0,27
Kesi,F,100,27,0,27
Kestrel,F,100,27,0,27
Kevis,M,100,0,27,27
Kewanna,F,100,27,0,27
Khamiya,F,100,27,0,27
Kharon,M,100,0,27,27
Khrystyne,F,100,27,0,27
Kiaria,F,100,27,0,27
Kinston,M,100,0,27,27
Kjersten,F,100,27,0,27
Kolbey,M,100,0,27,27
Kolsen,M,100,0,27,27
Kongmeng,M,100,0,27,27
Korvin,M,100,0,27,27
Kosta,M,100,0,27,27
Krisandra,F,100,27,0,27
Krishawn,M,74,7,20,27
Krist,M,100,0,27,27
Kyarra,F,100,27,0,27
Kyi,M,78,6,21,27
Kylinn,F,100,27,0,27
Kyro,M,100,0,27,27
Ladarien,M,100,0,27,27
Lailoni,F,100,27,0,27
Laityn,F,100,27,0,27
Lanyiah,F,100,27,0,27
Lariya,F,100,27,0,27
Larrisa,F,100,27,0,27
Laurann,F,100,27,0,27
Lauria,F,100,27,0,27
Lauris,F,59,16,11,27
Lavaeh,F,100,27,0,27
Leanda,F,100,27,0,27
Leannah,F,100,27,0,27
Leiya,F,100,27,0,27
Lenardo,M,100,0,27,27
Lenton,M,100,0,27,27
Leonda,F,100,27,0,27
Leonidus,M,100,0,27,27
Levert,M,100,0,27,27
Liliah,F,100,27,0,27
Lilja,F,100,27,0,27
Lilou,F,100,27,0,27
Lindsee,F,100,27,0,27
Litisha,F,100,27,0,27
Lowen,M,100,0,27,27
Luisfernando,M,100,0,27,27
Macai,M,100,0,27,27
Madeliene,F,100,27,0,27
Maelani,F,100,27,0,27
Magdeline,F,100,27,0,27
Mahagony,F,100,27,0,27
Maizee,F,100,27,0,27
Makayli,F,100,27,0,27
Makinsley,F,100,27,0,27
Makinzi,F,100,27,0,27
Malekai,M,100,0,27,27
Malissia,F,100,27,0,27
Marcea,F,100,27,0,27
Mareo,M,100,0,27,27
Markiya,F,100,27,0,27
Marlette,F,100,27,0,27
Marsheila,F,100,27,0,27
Masa,F,74,20,7,27
Masha,F,100,27,0,27
Massimiliano,M,100,0,27,27
Maziyah,F,100,27,0,27
Mazzie,F,100,27,0,27
Mc,F,70,19,8,27
Meagon,F,100,27,0,27
Mellie,F,100,27,0,27
Metta,F,100,27,0,27
Mickle,M,100,0,27,27
Mikenzi,F,100,27,0,27
Mikesha,F,100,27,0,27
Mikyah,F,100,27,0,27
Million,M,100,0,27,27
Minahil,F,100,27,0,27
Miroslav,M,100,0,27,27
Molleigh,F,100,27,0,27
Moraima,F,100,27,0,27
Muneeb,M,100,0,27,27
Murtaza,M,100,0,27,27
Mykale,M,100,0,27,27
Mylani,F,100,27,0,27
Na,F,100,27,0,27
Nadra,F,100,27,0,27
Nakaya,F,100,27,0,27
Nancyann,F,100,27,0,27
Nargis,F,100,27,0,27
Naszir,M,100,0,27,27
Nathalee,F,100,27,0,27
Naviyah,F,100,27,0,27
Nefi,M,100,0,27,27
Nehal,F,100,27,0,27
Nekesha,F,100,27,0,27
Neya,F,100,27,0,27
Nickayla,F,100,27,0,27
Nicolae,M,100,0,27,27
Nisreen,F,100,27,0,27
Nivek,M,100,0,27,27
Nohealani,F,100,27,0,27
Noya,F,100,27,0,27
Nurah,F,100,27,0,27
Olina,F,100,27,0,27
Olivianna,F,100,27,0,27
Oliwia,F,100,27,0,27
Oluwafemi,M,100,0,27,27
Pao,M,100,0,27,27
Parys,F,100,27,0,27
Patrecia,F,100,27,0,27
Persephanie,F,100,27,0,27
Phu,M,100,0,27,27
Pinchos,M,100,0,27,27
Pinky,F,100,27,0,27
Prosper,M,100,0,27,27
Pryor,M,100,0,27,27
Quinette,F,100,27,0,27
Raeana,F,100,27,0,27
Ramla,F,100,27,0,27
Ras,M,100,0,27,27
Rayni,F,100,27,0,27
Reinhold,M,100,0,27,27
Renley,F,63,17,10,27
Reshaun,M,100,0,27,27
Reyn,M,100,0,27,27
Riordan,M,100,0,27,27
Rober,M,100,0,27,27
Rodderick,M,100,0,27,27
Roi,M,100,0,27,27
Rollins,M,100,0,27,27
Ronnetta,F,100,27,0,27
Rosealee,F,100,27,0,27
Roselinda,F,100,27,0,27
Royer,M,100,0,27,27
Runa,F,100,27,0,27
Sadira,F,100,27,0,27
Sairah,F,100,27,0,27
Samanda,F,100,27,0,27
Samyrah,F,100,27,0,27
Santosh,M,100,0,27,27
Sanyiah,F,100,27,0,27
Sarahgrace,F,100,27,0,27
Savannha,F,100,27,0,27
Savita,F,100,27,0,27
Sayvon,M,100,0,27,27
Seidy,F,100,27,0,27
Selam,F,100,27,0,27
Seve,M,100,0,27,27
Shakinah,F,100,27,0,27
Shamal,M,100,0,27,27
Shamera,F,100,27,0,27
Shantasia,F,100,27,0,27
Shanvi,F,100,27,0,27
Sharetha,F,100,27,0,27
Sharin,F,100,27,0,27
Sharmain,F,100,27,0,27
Sharmayne,F,100,27,0,27
Shatera,F,100,27,0,27
Shawni,F,100,27,0,27
Shenae,F,100,27,0,27
Shevelle,F,100,27,0,27
Shikha,F,100,27,0,27
Shimeka,F,100,27,0,27
Shonn,M,100,0,27,27
Shontia,F,100,27,0,27
Shriyans,M,100,0,27,27
Shyler,F,81,22,5,27
Soniya,F,100,27,0,27
Soua,F,81,22,5,27
Starasia,F,100,27,0,27
Stellah,F,100,27,0,27
Stephanny,F,100,27,0,27
Storey,F,100,27,0,27
Suhaylah,F,100,27,0,27
Sundi,F,100,27,0,27
Suriya,F,100,27,0,27
Suzane,F,100,27,0,27
Sybella,F,100,27,0,27
Symeon,M,100,0,27,27
Tabita,F,100,27,0,27
Tacarra,F,100,27,0,27
Taison,M,100,0,27,27
Taiyo,M,100,0,27,27
Takashi,M,100,0,27,27
Talar,F,100,27,0,27
Tamani,F,100,27,0,27
Tamarius,M,100,0,27,27
Tamey,F,100,27,0,27
Tamla,F,100,27,0,27
Tantania,F,100,27,0,27
Tariana,F,100,27,0,27
Tashea,F,100,27,0,27
Tayelor,F,100,27,0,27
Teddrick,M,100,0,27,27
Teffany,F,100,27,0,27
Telecia,F,100,27,0,27
Terryon,M,100,0,27,27
Tery,M,74,7,20,27
Thayden,M,100,0,27,27
Thinh,M,100,0,27,27
Timaya,F,100,27,0,27
Tinslee,F,100,27,0,27
Tiras,M,100,0,27,27
Tollie,M,100,0,27,27
Toree,F,100,27,0,27
Traeton,M,100,0,27,27
Trayshawn,M,100,0,27,27
Tressia,F,100,27,0,27
Truc,F,100,27,0,27
Tydarius,M,100,0,27,27
Tykesha,F,100,27,0,27
Tykira,F,100,27,0,27
Tylene,F,100,27,0,27
Tylik,M,100,0,27,27
Tymia,F,100,27,0,27
Tymothy,M,100,0,27,27
Tyronica,F,100,27,0,27
Uzma,F,100,27,0,27
Vale,F,70,19,8,27
Valora,F,100,27,0,27
Vedanshi,F,100,27,0,27
Vedha,F,100,27,0,27
Velton,M,100,0,27,27
Verline,F,100,27,0,27
Vicci,F,100,27,0,27
Viren,M,100,0,27,27
Warda,F,100,27,0,27
Wessley,M,100,0,27,27
Willliam,M,100,0,27,27
Woods,M,100,0,27,27
Xerxes,M,100,0,27,27
Xuan,F,100,27,0,27
Xyler,M,100,0,27,27
Yajayra,F,100,27,0,27
Yaman,M,100,0,27,27
Yamaris,F,100,27,0,27
Yariah,F,100,27,0,27
Yarianna,F,100,27,0,27
Yevonne,F,100,27,0,27
Yitzel,F,100,27,0,27
Yobany,M,100,0,27,27
Yolander,F,100,27,0,27
Yony,M,100,0,27,27
Youa,F,100,27,0,27
Yousaf,M,100,0,27,27
Youssouf,M,100,0,27,27
Yuriy,M,100,0,27,27
Yuuki,M,100,0,27,27
Zaeem,M,100,0,27,27
Zaevion,M,100,0,27,27
Zaidee,F,100,27,0,27
Zaineb,F,100,27,0,27
Zakry,M,100,0,27,27
Zaley,F,100,27,0,27
Zalika,F,100,27,0,27
Zamier,M,100,0,27,27
Zaylyn,F,59,16,11,27
Zedric,M,100,0,27,27
Zenab,F,100,27,0,27
Zeniyah,F,100,27,0,27
Zerenity,F,100,27,0,27
Zillah,F,100,27,0,27
Zo,F,63,17,10,27
Zyad,M,100,0,27,27
Zymire,M,100,0,27,27
Aarik,M,100,0,26,26
Aasia,F,100,26,0,26
Aayansh,M,100,0,26,26
Aceyn,M,100,0,26,26
Adanya,F,100,26,0,26
Addalie,F,100,26,0,26
Aditri,F,100,26,0,26
Adriyanna,F,100,26,0,26
Afreen,F,100,26,0,26
Ahlana,F,100,26,0,26
Ahlayah,F,100,26,0,26
Ahri,F,100,26,0,26
Aigner,F,100,26,0,26
Alaija,F,100,26,0,26
Alayha,F,100,26,0,26
Albion,M,100,0,26,26
Alean,F,100,26,0,26
Alecsander,M,100,0,26,26
Alexcis,F,100,26,0,26
Alizeh,F,100,26,0,26
Aloha,F,100,26,0,26
Alyzae,F,100,26,0,26
Amarionna,F,100,26,0,26
Amariz,F,100,26,0,26
Ammaar,M,100,0,26,26
Anaelle,F,100,26,0,26
Anallely,F,100,26,0,26
Angala,F,100,26,0,26
Anguel,M,100,0,26,26
Aniel,M,100,0,26,26
Aniza,F,100,26,0,26
Anoop,M,100,0,26,26
Anthonette,F,100,26,0,26
Antonious,M,100,0,26,26
Areon,M,62,10,16,26
Ariabella,F,100,26,0,26
Arijana,F,100,26,0,26
Arlina,F,100,26,0,26
Armina,F,100,26,0,26
Arryanna,F,100,26,0,26
Arslan,M,100,0,26,26
Ashana,F,100,26,0,26
Atalaya,F,100,26,0,26
Audreyana,F,100,26,0,26
Audy,M,100,0,26,26
Avyukth,M,100,0,26,26
Ayame,F,100,26,0,26
Aylyn,F,100,26,0,26
Ayodeji,M,100,0,26,26
Ayodele,M,69,8,18,26
Azion,M,77,6,20,26
Azyiah,F,100,26,0,26
Baneen,F,100,26,0,26
Barbera,F,100,26,0,26
Bayle,F,81,21,5,26
Benjermin,M,100,0,26,26
Beonka,F,100,26,0,26
Bolivar,M,100,0,26,26
Brailen,M,100,0,26,26
Brandalynn,F,100,26,0,26
Brazos,M,100,0,26,26
Brendaliz,F,100,26,0,26
Brennin,M,100,0,26,26
Brittnei,F,100,26,0,26
Brookley,F,100,26,0,26
Brooklinn,F,100,26,0,26
Bryannah,F,100,26,0,26
Burnie,M,100,0,26,26
Caeson,M,100,0,26,26
Calais,F,100,26,0,26
Caleigha,F,100,26,0,26
Cammeron,M,100,0,26,26
Cannen,M,100,0,26,26
Carinne,F,100,26,0,26
Caryssa,F,100,26,0,26
Cathaleen,F,100,26,0,26
Cathlyn,F,100,26,0,26
Cay,F,100,26,0,26
Caymen,M,100,0,26,26
Caytlyn,F,100,26,0,26
Chalmer,M,100,0,26,26
Chamaine,F,100,26,0,26
Charolett,F,100,26,0,26
Cheryln,F,100,26,0,26
Chloeann,F,100,26,0,26
Christifer,M,100,0,26,26
Ciarah,F,100,26,0,26
Claudene,F,100,26,0,26
Clell,M,100,0,26,26
Conard,M,100,0,26,26
Concha,F,100,26,0,26
Constantin,M,100,0,26,26
Corderro,M,100,0,26,26
Cortana,F,100,26,0,26
Criston,M,73,7,19,26
Crixus,M,100,0,26,26
Crystalynn,F,100,26,0,26
Crystin,F,100,26,0,26
Cyndia,F,100,26,0,26
Cyrah,F,100,26,0,26
Daishaun,M,100,0,26,26
Daleiza,F,100,26,0,26
Dallie,F,100,26,0,26
Dama,F,100,26,0,26
Damonique,F,100,26,0,26
Damont,M,100,0,26,26
Daneka,F,100,26,0,26
Darroll,M,100,0,26,26
Dauna,F,100,26,0,26
Dawnya,F,100,26,0,26
Dayshon,M,100,0,26,26
Deah,F,100,26,0,26
Deantae,M,100,0,26,26
Decklin,M,100,0,26,26
Dejanay,F,100,26,0,26
Delpha,F,100,26,0,26
Delsie,F,100,26,0,26
Demichael,M,100,0,26,26
Deniro,M,100,0,26,26
Derrien,M,100,0,26,26
Desman,M,100,0,26,26
Destaney,F,100,26,0,26
Devanee,F,100,26,0,26
Devell,M,100,0,26,26
Dezaree,F,100,26,0,26
Dezman,M,100,0,26,26
Diamonte,M,100,0,26,26
Dinero,M,100,0,26,26
Diogo,M,100,0,26,26
Dionel,M,100,0,26,26
Doak,M,100,0,26,26
Doloris,F,100,26,0,26
Donnajean,F,100,26,0,26
Doralee,F,100,26,0,26
Dynesha,F,100,26,0,26
Edinson,M,100,0,26,26
Eisha,F,100,26,0,26
Ej,M,100,0,26,26
Elainna,F,100,26,0,26
Eleftheria,F,100,26,0,26
Eliani,F,100,26,0,26
Ellayna,F,100,26,0,26
Ellina,F,100,26,0,26
Emalina,F,100,26,0,26
Emireth,F,100,26,0,26
Emmalia,F,100,26,0,26
Emmersen,F,100,26,0,26
Emrick,M,100,0,26,26
Eryck,M,100,0,26,26
Esmond,M,100,0,26,26
Espn,M,100,0,26,26
Estefana,F,100,26,0,26
Evaleigh,F,100,26,0,26
Everson,M,100,0,26,26
Fable,F,100,26,0,26
Fairy,F,100,26,0,26
Fatemah,F,100,26,0,26
Fizza,F,100,26,0,26
Gabbie,F,100,26,0,26
Gabi,F,100,26,0,26
Gae,F,100,26,0,26
Galileah,F,100,26,0,26
Gavinn,M,100,0,26,26
Gerasimos,M,100,0,26,26
Giulietta,F,100,26,0,26
Grigor,M,100,0,26,26
Gwenetta,F,100,26,0,26
Hae,F,100,26,0,26
Haja,F,100,26,0,26
Hamzeh,M,100,0,26,26
Hannahmarie,F,100,26,0,26
Havish,M,100,0,26,26
Hazelyn,F,100,26,0,26
Hemi,M,73,7,19,26
Hiroto,M,100,0,26,26
Hulon,M,100,0,26,26
Hyde,M,100,0,26,26
Icela,F,100,26,0,26
Ife,F,100,26,0,26
Indio,M,100,0,26,26
Isiaih,M,100,0,26,26
Izmael,M,100,0,26,26
Jaequan,M,100,0,26,26
Jahmeer,M,100,0,26,26
Jaianna,F,100,26,0,26
Jaisean,M,100,0,26,26
Jaishaun,M,100,0,26,26
Jaivyn,M,100,0,26,26
Jakaria,F,100,26,0,26
Jakolby,M,100,0,26,26
Jamorris,M,100,0,26,26
Jamyron,M,100,0,26,26
Janah,F,100,26,0,26
Janeene,F,100,26,0,26
Janith,F,100,26,0,26
Jaquarious,M,100,0,26,26
Jarmal,M,100,0,26,26
Jaycub,M,100,0,26,26
Jaydrian,M,100,0,26,26
Jensy,M,54,12,14,26
Jerik,M,100,0,26,26
Jermari,M,100,0,26,26
Jerritt,M,100,0,26,26
Jeslynn,F,100,26,0,26
Jetson,M,100,0,26,26
Jinnie,F,100,26,0,26
Jocob,M,100,0,26,26
Joeleen,F,100,26,0,26
Jonanthony,M,100,0,26,26
Jonquil,F,81,21,5,26
Jullisa,F,100,26,0,26
Juniel,M,100,0,26,26
Juri,F,100,26,0,26
Kadar,M,100,0,26,26
Kaisey,F,100,26,0,26
Kalimah,F,100,26,0,26
Kamalani,F,100,26,0,26
Karmah,F,100,26,0,26
Kasch,M,100,0,26,26
Kashawna,F,100,26,0,26
Kasiah,F,100,26,0,26
Katlynne,F,100,26,0,26
Kayal,F,100,26,0,26
Kaylub,M,100,0,26,26
Kealii,M,100,0,26,26
Keanthony,M,100,0,26,26
Kelijah,M,100,0,26,26
Kennethia,F,100,26,0,26
Keriana,F,100,26,0,26
Kerisha,F,100,26,0,26
Keymoni,F,77,20,6,26
Khala,F,100,26,0,26
Khriz,M,100,0,26,26
Khylei,F,100,26,0,26
Kinlie,F,100,26,0,26
Kiosha,F,100,26,0,26
Kiron,M,100,0,26,26
Kishia,F,100,26,0,26
Klair,F,100,26,0,26
Kmari,F,54,14,12,26
Konnar,M,100,0,26,26
Korene,F,100,26,0,26
Korine,F,100,26,0,26
Kotaro,M,100,0,26,26
Krisi,F,100,26,0,26
Kristinia,F,100,26,0,26
Kristol,F,100,26,0,26
Kumar,M,100,0,26,26
Kyjuan,M,100,0,26,26
Laakea,M,100,0,26,26
Labrea,F,100,26,0,26
Ladene,F,100,26,0,26
Lakedra,F,100,26,0,26
Lakisa,F,100,26,0,26
Lalia,F,100,26,0,26
Larra,F,100,26,0,26
Latice,F,100,26,0,26
Latoia,F,100,26,0,26
Latravia,F,100,26,0,26
Lavel,M,100,0,26,26
Leelynn,M,81,5,21,26
Leetta,F,100,26,0,26
Lekendrick,M,100,0,26,26
Lelaina,F,100,26,0,26
Lemon,M,62,10,16,26
Leodan,M,100,0,26,26
Letrell,M,100,0,26,26
Levii,M,100,0,26,26
Levina,F,100,26,0,26
Levonte,M,100,0,26,26
Lexiana,F,100,26,0,26
Liahna,F,100,26,0,26
Lilyauna,F,100,26,0,26
Lindia,F,100,26,0,26
Livan,M,100,0,26,26
Livian,F,100,26,0,26
Lorain,F,100,26,0,26
Lorean,F,100,26,0,26
Lorel,F,100,26,0,26
Lucette,F,100,26,0,26
Lydon,M,100,0,26,26
Lyzette,F,100,26,0,26
Maciah,F,54,14,12,26
Maitland,M,54,12,14,26
Makaylia,F,100,26,0,26
Makhayla,F,100,26,0,26
Makinzy,F,100,26,0,26
Makyiah,F,100,26,0,26
Maleiah,F,100,26,0,26
Maloree,F,100,26,0,26
Manmeet,F,73,19,7,26
Manoah,M,100,0,26,26
Mansur,M,100,0,26,26
Maranatha,F,100,26,0,26
Marbin,M,100,0,26,26
Margert,F,100,26,0,26
Marguita,F,100,26,0,26
Marieta,F,100,26,0,26
Marik,M,100,0,26,26
Marquavis,M,100,0,26,26
Marquavius,M,100,0,26,26
Marqui,M,73,7,19,26
Maryl,F,100,26,0,26
Mattisyn,F,100,26,0,26
Mayur,M,100,0,26,26
Mckenize,F,100,26,0,26
Mclain,M,100,0,26,26
Meeya,F,100,26,0,26
Meha,F,100,26,0,26
Mehek,F,100,26,0,26
Melayah,F,100,26,0,26
Meleena,F,100,26,0,26
Melinna,F,100,26,0,26
Melisse,F,100,26,0,26
Merryn,F,100,26,0,26
Micala,F,100,26,0,26
Mikayah,F,100,26,0,26
Mikolaj,M,100,0,26,26
Milayah,F,100,26,0,26
Miraj,M,81,5,21,26
Moksha,F,100,26,0,26
Monserratt,F,100,26,0,26
Montrail,M,100,0,26,26
Moriya,F,100,26,0,26
Morley,M,54,12,14,26
Mumin,M,100,0,26,26
Myleen,F,100,26,0,26
Mylei,F,100,26,0,26
Mylinh,F,100,26,0,26
Myrikal,F,100,26,0,26
Naarah,F,100,26,0,26
Naphtali,M,100,0,26,26
Nashae,F,100,26,0,26
Natalyia,F,100,26,0,26
Nayden,M,100,0,26,26
Nazim,M,100,0,26,26
Neeley,F,100,26,0,26
Neli,F,100,26,0,26
Nevaan,M,100,0,26,26
Ngai,M,100,0,26,26
Nhia,M,77,6,20,26
Niaya,F,100,26,0,26
Nicklous,M,100,0,26,26
Nickoles,M,100,0,26,26
Nikiyah,F,100,26,0,26
Nyeshia,F,100,26,0,26
Nyja,F,100,26,0,26
Nykeba,F,100,26,0,26
Nysha,F,100,26,0,26
Nyshawn,M,100,0,26,26
Nysir,M,100,0,26,26
Olson,M,100,0,26,26
Oluwatomisin,F,58,15,11,26
Orelia,F,100,26,0,26
Orlena,F,100,26,0,26
Ornella,F,100,26,0,26
Paizleigh,F,100,26,0,26
Papa,M,100,0,26,26
Parag,M,100,0,26,26
Pariss,F,100,26,0,26
Patrese,F,100,26,0,26
Patrici,F,100,26,0,26
Petrona,F,100,26,0,26
Philipe,M,100,0,26,26
Poseidon,M,100,0,26,26
Quorra,F,100,26,0,26
Rachana,F,100,26,0,26
Radek,M,100,0,26,26
Raenell,F,100,26,0,26
Rafferty,M,100,0,26,26
Raghad,F,100,26,0,26
Raheel,M,100,0,26,26
Raivyn,F,100,26,0,26
Ramaya,F,100,26,0,26
Rashae,F,100,26,0,26
Rashmi,F,100,26,0,26
Rayhana,F,100,26,0,26
Reason,M,81,5,21,26
Rebakah,F,100,26,0,26
Reida,F,100,26,0,26
Reise,M,81,5,21,26
Ressie,F,100,26,0,26
Retal,F,100,26,0,26
Reyaansh,M,100,0,26,26
Rieley,F,81,21,5,26
Roberts,M,100,0,26,26
Rockland,M,100,0,26,26
Romey,F,73,19,7,26
Rontrell,M,100,0,26,26
Roselind,F,100,26,0,26
Rozetta,F,100,26,0,26
Ruari,F,58,15,11,26
Rutherford,M,100,0,26,26
Sadonna,F,100,26,0,26
Saivon,M,100,0,26,26
Salahuddin,M,100,0,26,26
Saliah,F,100,26,0,26
Sameka,F,100,26,0,26
Sammye,F,100,26,0,26
Sankalp,M,100,0,26,26
Saraiyah,F,100,26,0,26
Satara,F,100,26,0,26
Savier,M,100,0,26,26
Sayward,F,100,26,0,26
Seba,F,100,26,0,26
Sevan,M,81,5,21,26
Shaakira,F,100,26,0,26
Shahara,F,100,26,0,26
Shaiann,F,100,26,0,26
Shakiyah,F,100,26,0,26
Shaletha,F,100,26,0,26
Shamarr,M,100,0,26,26
Shamecca,F,100,26,0,26
Shanasia,F,100,26,0,26
Sharline,F,100,26,0,26
Sharronda,F,100,26,0,26
Shatika,F,100,26,0,26
Shaunee,F,100,26,0,26
Shavelle,F,100,26,0,26
Shawon,M,81,5,21,26
Shellye,F,100,26,0,26
Sher,F,62,16,10,26
Sherral,F,100,26,0,26
Sherronda,F,100,26,0,26
Shine,F,69,18,8,26
Shiya,F,100,26,0,26
Sholanda,F,100,26,0,26
Shrika,F,100,26,0,26
Si,M,100,0,26,26
Simuel,M,100,0,26,26
Skylynne,F,100,26,0,26
Sokhna,F,100,26,0,26
Soo,F,100,26,0,26
Sophiea,F,100,26,0,26
Stormey,F,73,19,7,26
Suad,F,100,26,0,26
Suhey,F,100,26,0,26
Sulamita,F,100,26,0,26
Sundeep,M,100,0,26,26
Tahiri,F,100,26,0,26
Takuma,M,100,0,26,26
Tanji,F,100,26,0,26
Tanvir,M,100,0,26,26
Taquilla,F,100,26,0,26
Tel,M,100,0,26,26
Teralyn,F,100,26,0,26
Teven,M,100,0,26,26
Teyona,F,100,26,0,26
Thelbert,M,100,0,26,26
Thomson,M,100,0,26,26
Thresea,F,100,26,0,26
Tiajuana,F,100,26,0,26
Tieshia,F,100,26,0,26
Tiffane,F,100,26,0,26
Tiffinie,F,100,26,0,26
Tikisha,F,100,26,0,26
Tilmon,M,100,0,26,26
Tomie,M,54,12,14,26
Tomorrow,F,100,26,0,26
Traylon,M,100,0,26,26
Trella,F,100,26,0,26
Trentan,M,100,0,26,26
Trinaty,F,100,26,0,26
Tyee,M,100,0,26,26
Tyia,F,100,26,0,26
Tyshawna,F,100,26,0,26
Uziah,M,100,0,26,26
Valaria,F,100,26,0,26
Valetta,F,100,26,0,26
Vallen,M,100,0,26,26
Vayden,M,100,0,26,26
Victoriana,F,100,26,0,26
Vikash,M,100,0,26,26
Vishruth,M,100,0,26,26
Wassim,M,100,0,26,26
Wileen,F,100,26,0,26
Xanthe,F,100,26,0,26
Xiong,M,100,0,26,26
Xylon,M,100,0,26,26
Yohann,M,100,0,26,26
Yomaira,F,100,26,0,26
Yue,F,54,14,12,26
Yvonda,F,100,26,0,26
Zai,M,81,5,21,26
Zailynn,F,100,26,0,26
Zainah,F,100,26,0,26
Zavior,M,100,0,26,26
Zavon,M,100,0,26,26
Zein,M,100,0,26,26
Zenja,F,100,26,0,26
Zionah,F,100,26,0,26
Aaban,M,100,0,25,25
Aaran,M,100,0,25,25
Aarini,F,100,25,0,25
Aashka,F,100,25,0,25
Abbee,F,100,25,0,25
Abbye,F,100,25,0,25
Abdinasir,M,100,0,25,25
Adaira,F,100,25,0,25
Adalae,F,100,25,0,25
Adayah,F,100,25,0,25
Adelheid,F,100,25,0,25
Adib,M,100,0,25,25
Adylin,F,100,25,0,25
Aerionna,F,100,25,0,25
Agueda,F,100,25,0,25
Ahlia,F,100,25,0,25
Ahmiya,F,100,25,0,25
Aideen,F,80,20,5,25
Ainhoa,F,100,25,0,25
Aithan,M,100,0,25,25
Akeema,F,100,25,0,25
Akeisha,F,100,25,0,25
Aking,M,100,0,25,25
Aladdin,M,100,0,25,25
Aleli,F,100,25,0,25
Alenah,F,100,25,0,25
Alexea,F,100,25,0,25
Alianah,F,100,25,0,25
Alicha,F,100,25,0,25
Aliegha,F,100,25,0,25
Aliyha,F,100,25,0,25
Alontae,M,100,0,25,25
Altonio,M,100,0,25,25
Alyda,F,100,25,0,25
Amaryah,F,100,25,0,25
Amesha,F,100,25,0,25
Analea,F,100,25,0,25
Ananiah,F,100,25,0,25
Anastassia,F,100,25,0,25
Aneya,F,100,25,0,25
Angellica,F,100,25,0,25
Anjolaoluwa,F,100,25,0,25
Annayah,F,100,25,0,25
Annelies,F,100,25,0,25
Anniya,F,100,25,0,25
Annya,F,100,25,0,25
Anquinette,F,100,25,0,25
Anterio,M,100,0,25,25
Antoinetta,F,100,25,0,25
Arasely,F,100,25,0,25
Ariez,M,100,0,25,25
Arrabella,F,100,25,0,25
Arrionna,F,100,25,0,25
Artist,M,100,0,25,25
Artyom,M,100,0,25,25
Ashdon,M,100,0,25,25
Ashe,M,80,5,20,25
Ashima,F,100,25,0,25
Atika,F,100,25,0,25
Atzel,M,100,0,25,25
Aubreana,F,100,25,0,25
Averyana,F,100,25,0,25
Avontae,M,100,0,25,25
Avriel,F,76,19,6,25
Azzam,M,100,0,25,25
Bartosz,M,100,0,25,25
Bhargav,M,100,0,25,25
Blessed,F,52,13,12,25
Bohdi,M,100,0,25,25
Brahim,M,100,0,25,25
Bralon,M,100,0,25,25
Brave,M,100,0,25,25
Brayam,M,100,0,25,25
Breely,F,100,25,0,25
Brehanna,F,100,25,0,25
Breken,M,100,0,25,25
Brekyn,F,80,20,5,25
Breyah,F,100,25,0,25
Briani,F,100,25,0,25
Bridney,F,100,25,0,25
Britley,F,100,25,0,25
Brityn,F,100,25,0,25
Brizeyda,F,100,25,0,25
Broadus,M,100,0,25,25
Bryndon,M,100,0,25,25
Bulmaro,M,100,0,25,25
Burnetta,F,100,25,0,25
Byrant,M,100,0,25,25
Caeleigh,F,100,25,0,25
Calena,F,100,25,0,25
Callin,M,100,0,25,25
Camarie,F,100,25,0,25
Cambelle,F,100,25,0,25
Camil,F,100,25,0,25
Cane,M,100,0,25,25
Carlas,M,100,0,25,25
Carmesha,F,100,25,0,25
Carrson,M,100,0,25,25
Catcher,M,100,0,25,25
Catrell,M,100,0,25,25
Chalon,F,52,13,12,25
Chandrea,F,100,25,0,25
Channelle,F,100,25,0,25
Chanya,F,100,25,0,25
Charnetta,F,100,25,0,25
Charo,F,100,25,0,25
Chasitie,F,100,25,0,25
Chasta,F,100,25,0,25
Chelci,F,100,25,0,25
Chelesa,F,100,25,0,25
Chelsia,F,100,25,0,25
Cherity,F,100,25,0,25
Cherysh,F,100,25,0,25
Chevie,F,80,20,5,25
Chistina,F,100,25,0,25
Chrissi,F,100,25,0,25
Christiann,F,100,25,0,25
Christol,F,100,25,0,25
Christophere,M,100,0,25,25
Clarnce,M,100,0,25,25
Conlee,M,64,9,16,25
Cordney,M,100,0,25,25
Corisa,F,100,25,0,25
Cornesha,F,100,25,0,25
Cortlynn,F,100,25,0,25
Courtnei,F,100,25,0,25
Crandall,M,100,0,25,25
Cynia,F,100,25,0,25
Daemien,M,100,0,25,25
Daesean,M,100,0,25,25
Dairon,M,100,0,25,25
Dalani,F,100,25,0,25
Damira,F,100,25,0,25
Danene,F,100,25,0,25
Danon,M,100,0,25,25
Dantavious,M,100,0,25,25
Danzell,M,100,0,25,25
Darcelle,F,100,25,0,25
Darrold,M,100,0,25,25
Daryana,F,100,25,0,25
Daundre,M,100,0,25,25
Davarion,M,100,0,25,25
Daziah,F,100,25,0,25
Debbora,F,100,25,0,25
Delando,M,100,0,25,25
Demarian,M,100,0,25,25
Demaya,F,100,25,0,25
Demetreus,M,100,0,25,25
Deniese,F,100,25,0,25
Dennette,F,100,25,0,25
Deovion,M,52,12,13,25
Deran,M,100,0,25,25
Deryn,F,80,20,5,25
Devaney,F,100,25,0,25
Dhiya,F,100,25,0,25
Dierdra,F,100,25,0,25
Dionicia,F,100,25,0,25
Dom,M,100,0,25,25
Donalee,F,100,25,0,25
Donelda,F,100,25,0,25
Donnesha,F,100,25,0,25
Dontell,M,100,0,25,25
Donye,M,72,7,18,25
Dyke,M,100,0,25,25
Ein,M,100,0,25,25
Elad,M,100,0,25,25
Elberta,F,100,25,0,25
Elieser,M,100,0,25,25
Eliette,F,100,25,0,25
Elky,F,100,25,0,25
Ellanora,F,100,25,0,25
Ellice,F,100,25,0,25
Elowen,F,100,25,0,25
Elver,M,100,0,25,25
Emeterio,M,100,0,25,25
Emmary,F,100,25,0,25
Emonee,F,100,25,0,25
Estreya,F,100,25,0,25
Eustace,M,100,0,25,25
Evanny,F,100,25,0,25
Exie,F,100,25,0,25
Eyob,M,100,0,25,25
Fadel,M,100,0,25,25
Faten,F,100,25,0,25
Finnbar,M,100,0,25,25
Francena,F,100,25,0,25
Gared,M,100,0,25,25
Geneen,F,100,25,0,25
Geselle,F,100,25,0,25
Gilman,M,100,0,25,25
Giulian,M,100,0,25,25
Gorgeous,F,100,25,0,25
Graceson,M,100,0,25,25
Gustaf,M,100,0,25,25
Gyanna,F,100,25,0,25
Haizley,F,100,25,0,25
Halana,F,100,25,0,25
Hamdan,M,100,0,25,25
Hanz,M,100,0,25,25
Hason,M,100,0,25,25
Hasset,F,100,25,0,25
Hazelynn,F,100,25,0,25
Hilma,F,100,25,0,25
Hitesh,M,100,0,25,25
Hiyab,F,80,20,5,25
Honorio,M,100,0,25,25
Ieesha,F,100,25,0,25
Ilayda,F,100,25,0,25
Iliya,M,72,7,18,25
Isabele,F,100,25,0,25
Isabellamarie,F,100,25,0,25
Isiac,M,100,0,25,25
Ivelis,F,100,25,0,25
Iyani,F,100,25,0,25
Jacobb,M,100,0,25,25
Jadriel,M,100,0,25,25
Jaedah,F,100,25,0,25
Jaggar,M,100,0,25,25
Jaid,F,80,20,5,25
Jailey,F,100,25,0,25
Jailon,M,100,0,25,25
Jalaine,F,100,25,0,25
Jamariya,F,100,25,0,25
Jamaury,M,100,0,25,25
Jameah,F,100,25,0,25
Jamone,M,100,0,25,25
Janayla,F,100,25,0,25
Janda,F,100,25,0,25
Jannessa,F,100,25,0,25
Jaree,F,64,16,9,25
Jasie,F,100,25,0,25
Jaslyne,F,100,25,0,25
Jaslynne,F,100,25,0,25
Javelle,M,100,0,25,25
Jaymarie,F,100,25,0,25
Jayston,M,100,0,25,25
Jaythen,M,100,0,25,25
Jazmaine,F,100,25,0,25
Jeanita,F,100,25,0,25
Jeffifer,F,100,25,0,25
Jenavee,F,100,25,0,25
Jenese,F,100,25,0,25
Jenissa,F,100,25,0,25
Jennet,F,100,25,0,25
Jequan,M,100,0,25,25
Jericha,F,100,25,0,25
Jerral,M,100,0,25,25
Jessicia,F,100,25,0,25
Joakim,M,100,0,25,25
Joas,M,100,0,25,25
Johsua,M,100,0,25,25
Joran,M,100,0,25,25
Jorrell,M,100,0,25,25
Joselle,F,100,25,0,25
Joyann,F,100,25,0,25
Juleah,F,100,25,0,25
Jurney,F,100,25,0,25
Jurnie,F,100,25,0,25
Juwon,M,100,0,25,25
Kabria,F,100,25,0,25
Kailon,M,100,0,25,25
Kaisy,F,100,25,0,25
Kalyan,M,100,0,25,25
Kanton,M,100,0,25,25
Kasai,M,100,0,25,25
Kashlynn,F,100,25,0,25
Kastin,M,100,0,25,25
Katherene,F,100,25,0,25
Kawhi,M,100,0,25,25
Kawon,M,100,0,25,25
Kayna,F,100,25,0,25
Kearah,F,100,25,0,25
Kearstyn,F,100,25,0,25
Keayra,F,100,25,0,25
Kedarius,M,100,0,25,25
Keileigh,F,100,25,0,25
Keiondra,F,100,25,0,25
Keliyah,F,100,25,0,25
Kely,F,100,25,0,25
Keniah,F,100,25,0,25
Kenlei,F,100,25,0,25
Kensli,F,100,25,0,25
Kerina,F,100,25,0,25
Kerryann,F,100,25,0,25
Keryn,F,100,25,0,25
Keymari,M,76,6,19,25
Khalifa,M,100,0,25,25
Khayree,M,100,0,25,25
Kiearra,F,100,25,0,25
Kiegan,M,80,5,20,25
Kimra,F,100,25,0,25
Kingjames,M,100,0,25,25
Kinzy,F,100,25,0,25
Kiwana,F,100,25,0,25
Klea,F,100,25,0,25
Klohe,F,100,25,0,25
Korissa,F,100,25,0,25
Kritika,F,100,25,0,25
Kshawn,M,100,0,25,25
Kuuipo,F,100,25,0,25
Kyilee,F,100,25,0,25
Kynzleigh,F,100,25,0,25
Lacosta,F,100,25,0,25
Laelani,F,100,25,0,25
Lainy,F,100,25,0,25
Lakeasha,F,100,25,0,25
Lakendria,F,100,25,0,25
Lamberto,M,100,0,25,25
Latonda,F,100,25,0,25
Latressa,F,100,25,0,25
Latunya,F,100,25,0,25
Laurana,F,100,25,0,25
Leahann,F,100,25,0,25
Leelyn,M,100,0,25,25
Leilan,M,100,0,25,25
Leily,F,100,25,0,25
Lem,M,100,0,25,25
Leshaun,M,100,0,25,25
Lexander,M,100,0,25,25
Lillah,F,100,25,0,25
Lillionna,F,100,25,0,25
Lilo,F,100,25,0,25
Linnae,F,100,25,0,25
Loreley,F,100,25,0,25
Lorrayne,F,100,25,0,25
Luberta,F,100,25,0,25
Luken,M,100,0,25,25
Lynnie,F,100,25,0,25
Lynnleigh,F,100,25,0,25
Madelina,F,100,25,0,25
Madisun,F,100,25,0,25
Maebelle,F,100,25,0,25
Mahkayla,F,100,25,0,25
Mailin,F,100,25,0,25
Mailynn,F,100,25,0,25
Maimuna,F,100,25,0,25
Mairyn,F,100,25,0,25
Makaiyah,F,100,25,0,25
Makela,F,100,25,0,25
Makenzey,F,100,25,0,25
Maleke,M,100,0,25,25
Malynn,F,100,25,0,25
Man,F,52,13,12,25
Mandell,M,100,0,25,25
Mandisa,F,100,25,0,25
Marcina,F,100,25,0,25
Margareth,F,100,25,0,25
Marquia,F,100,25,0,25
Marsela,F,100,25,0,25
Marshun,M,100,0,25,25
Martavion,M,100,0,25,25
Martavis,M,100,0,25,25
Mashal,F,100,25,0,25
Matson,M,100,0,25,25
Maurie,F,100,25,0,25
Maysie,F,100,25,0,25
Mckinzey,F,100,25,0,25
Menaal,F,100,25,0,25
Miata,F,100,25,0,25
Michaelah,F,100,25,0,25
Micholas,M,100,0,25,25
Mija,F,100,25,0,25
Mikeya,F,100,25,0,25
Minnette,F,100,25,0,25
Miron,M,100,0,25,25
Monda,F,100,25,0,25
Mylez,M,100,0,25,25
Myosha,F,100,25,0,25
Naba,F,100,25,0,25
Nafeesa,F,100,25,0,25
Nakeia,F,100,25,0,25
Nakiesha,F,100,25,0,25
Nancey,F,100,25,0,25
Nandan,M,100,0,25,25
Nathanuel,M,100,0,25,25
Naveya,F,100,25,0,25
Nazyia,F,100,25,0,25
Nesanel,M,100,0,25,25
Neysha,F,100,25,0,25
Niaomi,F,100,25,0,25
Nickoli,M,100,0,25,25
Njeri,F,100,25,0,25
Noheli,F,100,25,0,25
Norvel,M,100,0,25,25
Novia,F,100,25,0,25
Nyron,M,100,0,25,25
Oanh,F,100,25,0,25
Oasis,F,100,25,0,25
Obryan,M,100,0,25,25
Oluwakemi,F,100,25,0,25
Omair,M,100,0,25,25
Omara,F,100,25,0,25
Onix,M,100,0,25,25
Osmond,M,100,0,25,25
Pahola,F,100,25,0,25
Pantera,F,100,25,0,25
Paylin,F,100,25,0,25
Peng,M,100,0,25,25
Peregrine,M,72,7,18,25
Perlita,F,100,25,0,25
Pio,M,100,0,25,25
Poet,F,76,19,6,25
Poonam,F,100,25,0,25
Preethi,F,100,25,0,25
Psalm,M,60,10,15,25
Quavion,M,100,0,25,25
Quinlin,M,80,5,20,25
Quintasia,F,100,25,0,25
Quinterius,M,100,0,25,25
Rafay,M,100,0,25,25
Ramelo,M,100,0,25,25
Ramesh,M,100,0,25,25
Ranferi,M,100,0,25,25
Raunak,M,100,0,25,25
Raydel,M,100,0,25,25
Rayjon,M,100,0,25,25
Raynah,F,100,25,0,25
Reizel,F,100,25,0,25
Remas,F,100,25,0,25
Rheana,F,100,25,0,25
Rheba,F,100,25,0,25
Rhylin,F,56,14,11,25
Riata,F,100,25,0,25
Riese,F,60,15,10,25
Rip,M,100,0,25,25
Riven,M,60,10,15,25
Rochella,F,100,25,0,25
Romar,M,100,0,25,25
Romulus,M,100,0,25,25
Ronee,F,100,25,0,25
Ronia,F,100,25,0,25
Roshard,M,100,0,25,25
Rowin,M,72,7,18,25
Ryheem,M,100,0,25,25
Ryot,M,100,0,25,25
Saifan,M,100,0,25,25
Sakara,F,100,25,0,25
Sakiya,F,100,25,0,25
Saleah,F,100,25,0,25
Samreen,F,100,25,0,25
Sarabella,F,100,25,0,25
Sarahelizabeth,F,100,25,0,25
Sayana,F,100,25,0,25
Sayvion,M,100,0,25,25
Senia,F,100,25,0,25
Seriyah,F,100,25,0,25
Sevon,M,100,0,25,25
Shaeleigh,F,100,25,0,25
Shaily,F,100,25,0,25
Shakeira,F,100,25,0,25
Shameria,F,100,25,0,25
Shamicka,F,100,25,0,25
Shamirah,F,100,25,0,25
Shanavia,F,100,25,0,25
Shanyn,F,100,25,0,25
Sharah,F,100,25,0,25
Shareena,F,100,25,0,25
Sharnita,F,100,25,0,25
Shaterra,F,100,25,0,25
Shauntelle,F,100,25,0,25
Shayonna,F,100,25,0,25
Shayra,F,100,25,0,25
Shealee,F,100,25,0,25
Shoshannah,F,100,25,0,25
Shreyansh,M,100,0,25,25
Sindia,F,100,25,0,25
Skyeler,F,64,16,9,25
Solangel,F,100,25,0,25
Solyana,F,100,25,0,25
Solymar,F,100,25,0,25
Sonna,F,100,25,0,25
Sonyia,F,100,25,0,25
Srija,F,100,25,0,25
Stanislaw,M,100,0,25,25
Stepan,M,100,0,25,25
Sway,F,80,20,5,25
Syanne,F,100,25,0,25
Sylvanus,M,100,0,25,25
Taariq,M,100,0,25,25
Tabby,F,80,20,5,25
Tacie,F,100,25,0,25
Taejon,M,100,0,25,25
Takari,M,72,7,18,25
Talasia,F,100,25,0,25
Talik,M,100,0,25,25
Tameko,F,100,25,0,25
Tanav,M,100,0,25,25
Taquana,F,100,25,0,25
Tarahji,F,100,25,0,25
Tashona,F,100,25,0,25
Tavi,F,68,17,8,25
Taylorann,F,100,25,0,25
Teriana,F,100,25,0,25
Terilynn,F,100,25,0,25
Tessica,F,100,25,0,25
Toan,M,100,0,25,25
Tovia,M,68,8,17,25
Tranae,F,100,25,0,25
Trason,M,100,0,25,25
Travia,F,100,25,0,25
Tresten,M,100,0,25,25
Trevone,M,100,0,25,25
Trinady,F,100,25,0,25
Tykisha,F,100,25,0,25
Tynika,F,100,25,0,25
Ugochi,F,100,25,0,25
Ulyana,F,100,25,0,25
Umaiza,F,100,25,0,25
Unice,F,80,20,5,25
Valiant,M,100,0,25,25
Vallarie,F,100,25,0,25
Verdie,F,100,25,0,25
Vernecia,F,100,25,0,25
Vesna,F,100,25,0,25
Victorhugo,M,100,0,25,25
Wava,F,100,25,0,25
Wenonah,F,100,25,0,25
Wilian,M,100,0,25,25
Winda,F,100,25,0,25
Wisam,M,100,0,25,25
Xavius,M,100,0,25,25
Xcaret,F,100,25,0,25
Xela,F,100,25,0,25
Ximenna,F,100,25,0,25
Xitlalic,F,100,25,0,25
Yarah,F,100,25,0,25
Yasemin,F,100,25,0,25
Yasmen,F,100,25,0,25
Yecheskel,M,100,0,25,25
Yichen,M,80,5,20,25
Yolunda,F,100,25,0,25
Yossef,M,100,0,25,25
Yousra,F,100,25,0,25
Zaide,M,76,6,19,25
Zanaiya,F,100,25,0,25
Zanaria,F,100,25,0,25
Zandrea,F,100,25,0,25
Zaraya,F,100,25,0,25
Zaul,M,100,0,25,25
Zawadi,F,100,25,0,25
Zaydyn,M,100,0,25,25
Zayquan,M,100,0,25,25
Zeek,M,100,0,25,25
Zeven,M,100,0,25,25
Zhara,F,100,25,0,25
Zyanne,F,100,25,0,25
Zyire,M,100,0,25,25
Zyshawn,M,100,0,25,25
Aariona,F,100,24,0,24
Abdou,M,100,0,24,24
Abdulwahab,M,100,0,24,24
Abhimanyu,M,100,0,24,24
Adahlia,F,100,24,0,24
Adaliah,F,100,24,0,24
Adelai,F,100,24,0,24
Adiya,F,100,24,0,24
Adlyn,F,100,24,0,24
Adorian,M,100,0,24,24
Adraine,F,79,19,5,24
Adriella,F,100,24,0,24
Ahmaya,F,100,24,0,24
Ahria,F,100,24,0,24
Ailah,F,100,24,0,24
Aimi,F,100,24,0,24
Airica,F,100,24,0,24
Akera,F,100,24,0,24
Akeria,F,100,24,0,24
Alabama,F,100,24,0,24
Alaisa,F,100,24,0,24
Alando,M,100,0,24,24
Aleeha,F,100,24,0,24
Alekhya,F,100,24,0,24
Alexio,M,100,0,24,24
Aliha,F,100,24,0,24
Alioune,M,100,0,24,24
Alizea,F,100,24,0,24
Allyiah,F,100,24,0,24
Almendra,F,100,24,0,24
Alois,M,100,0,24,24
Alquan,M,100,0,24,24
Alverto,M,100,0,24,24
Alyscia,F,100,24,0,24
Amali,F,100,24,0,24
Amanpreet,F,62,15,9,24
Amylee,F,100,24,0,24
Amyri,F,100,24,0,24
Amyria,F,100,24,0,24
Anab,F,100,24,0,24
Anael,F,100,24,0,24
Anaisabel,F,100,24,0,24
Analysa,F,100,24,0,24
Ancil,M,100,0,24,24
Anda,F,100,24,0,24
Andry,M,100,0,24,24
Aneliz,F,100,24,0,24
Anetra,F,100,24,0,24
Anikah,F,100,24,0,24
Anjelika,F,100,24,0,24
Annaleigha,F,100,24,0,24
Annelisa,F,100,24,0,24
Annise,F,100,24,0,24
Antigone,F,100,24,0,24
Apolo,M,100,0,24,24
Apostolos,M,100,0,24,24
Arabel,F,100,24,0,24
Arel,M,100,0,24,24
Ariannie,F,100,24,0,24
Ariaunna,F,100,24,0,24
Arieon,F,58,14,10,24
Arinze,M,100,0,24,24
Ariyona,F,100,24,0,24
Arlind,M,100,0,24,24
Artesha,F,100,24,0,24
Aryiana,F,100,24,0,24
Asharia,F,100,24,0,24
Ashrith,M,100,0,24,24
Ason,M,100,0,24,24
Aubrionna,F,100,24,0,24
Audryana,F,100,24,0,24
Aundray,M,100,0,24,24
Avyana,F,100,24,0,24
Ayaat,F,100,24,0,24
Ayanni,F,100,24,0,24
Aybree,F,100,24,0,24
Aysiah,F,100,24,0,24
Azarie,F,100,24,0,24
Azyah,F,100,24,0,24
Beckem,M,100,0,24,24
Bedford,M,100,0,24,24
Bhakti,F,100,24,0,24
Blaiden,M,100,0,24,24
Blanton,M,100,0,24,24
Blessen,F,100,24,0,24
Blinda,F,100,24,0,24
Bracen,M,100,0,24,24
Breckan,M,100,0,24,24
Breckon,M,100,0,24,24
Brendia,F,100,24,0,24
Brittish,F,100,24,0,24
Broderic,M,100,0,24,24
Brogen,M,100,0,24,24
Bryli,F,100,24,0,24
Brynlea,F,100,24,0,24
Cabot,M,100,0,24,24
Cacey,F,100,24,0,24
Caidon,M,100,0,24,24
Carollynn,F,100,24,0,24
Carolyna,F,100,24,0,24
Casimer,M,100,0,24,24
Casy,F,50,12,12,24
Ceil,F,100,24,0,24
Chaitra,F,100,24,0,24
Chaley,F,100,24,0,24
Chang,M,100,0,24,24
Chaniece,F,100,24,0,24
Chaniqua,F,100,24,0,24
Charlett,F,100,24,0,24
Charmagne,F,100,24,0,24
Charnette,F,100,24,0,24
Charonda,F,100,24,0,24
Chawn,M,71,7,17,24
Chen,M,100,0,24,24
Cherene,F,100,24,0,24
Cheril,F,100,24,0,24
Christe,F,100,24,0,24
Chrisy,F,100,24,0,24
Chukwuebuka,M,100,0,24,24
Chyrel,F,100,24,0,24
Clydell,M,75,6,18,24
Connelly,F,67,16,8,24
Coretha,F,100,24,0,24
Covey,M,100,0,24,24
Cresta,F,100,24,0,24
Cristabel,F,100,24,0,24
Curlie,F,58,14,10,24
Cyriah,F,100,24,0,24
Dabria,F,100,24,0,24
Dail,F,67,16,8,24
Dalaina,F,100,24,0,24
Daleisa,F,100,24,0,24
Damacio,M,100,0,24,24
Damareon,M,100,0,24,24
Damarko,M,100,0,24,24
Danett,F,100,24,0,24
Danniella,F,100,24,0,24
Danyela,F,100,24,0,24
Daphene,F,100,24,0,24
Darcella,F,100,24,0,24
Darcus,F,79,19,5,24
Darolyn,F,100,24,0,24
Davaris,M,100,0,24,24
Davier,M,100,0,24,24
Daviona,F,100,24,0,24
Daviyon,M,100,0,24,24
Daymion,M,100,0,24,24
Dayshaun,M,100,0,24,24
Deaire,M,100,0,24,24
Deaisha,F,100,24,0,24
Dekendrick,M,100,0,24,24
Delbra,F,100,24,0,24
Demesha,F,100,24,0,24
Demetrie,M,100,0,24,24
Deneise,F,100,24,0,24
Denicia,F,100,24,0,24
Denson,M,100,0,24,24
Desmen,M,100,0,24,24
Desmund,M,100,0,24,24
Devyne,F,71,17,7,24
Dhairya,M,100,0,24,24
Didi,F,100,24,0,24
Dniyah,F,100,24,0,24
Dore,F,79,19,5,24
Doreena,F,100,24,0,24
Dorin,M,100,0,24,24
Dougles,M,100,0,24,24
Duong,M,100,0,24,24
Duwan,M,100,0,24,24
Ebrima,M,100,0,24,24
Eduin,M,100,0,24,24
Eevee,F,100,24,0,24
Ehtan,M,100,0,24,24
Elea,F,100,24,0,24
Eleno,M,100,0,24,24
Eliyas,M,100,0,24,24
Ellarae,F,100,24,0,24
Elridge,M,100,0,24,24
Emaree,F,100,24,0,24
Emilija,F,100,24,0,24
Emilyanne,F,100,24,0,24
Emmali,F,100,24,0,24
Emmalise,F,100,24,0,24
Emoree,F,100,24,0,24
Enis,M,100,0,24,24
Erminio,M,100,0,24,24
Estephan,M,100,0,24,24
Estil,M,100,0,24,24
Ethanjames,M,100,0,24,24
Evalise,F,100,24,0,24
Evanne,F,100,24,0,24
Evelette,F,100,24,0,24
Everlena,F,100,24,0,24
Ezrael,M,100,0,24,24
Faolan,M,100,0,24,24
Fartun,F,100,24,0,24
Felisia,F,100,24,0,24
Ferlin,M,100,0,24,24
Fleur,F,100,24,0,24
Florance,F,100,24,0,24
Frandy,M,100,0,24,24
Fuller,M,100,0,24,24
Geofrey,M,100,0,24,24
Geovana,F,100,24,0,24
Geriann,F,100,24,0,24
Ghazal,F,100,24,0,24
Giordana,F,100,24,0,24
Glenisha,F,100,24,0,24
Graclyn,F,100,24,0,24
Graylon,M,100,0,24,24
Gricel,F,100,24,0,24
Hadessah,F,100,24,0,24
Halim,M,100,0,24,24
Halynn,F,100,24,0,24
Harl,M,100,0,24,24
Heer,F,100,24,0,24
Herve,M,100,0,24,24
Hiilani,F,100,24,0,24
Hind,F,100,24,0,24
Ibtisam,F,100,24,0,24
Iisha,F,100,24,0,24
Ildefonso,M,100,0,24,24
Illona,F,100,24,0,24
Imraan,M,100,0,24,24
Indi,F,100,24,0,24
Isahi,M,100,0,24,24
Isavel,F,100,24,0,24
Isel,F,100,24,0,24
Ivaan,M,100,0,24,24
Iviona,F,100,24,0,24
Iyahna,F,100,24,0,24
Izyan,M,100,0,24,24
Jackelynn,F,100,24,0,24
Jacyln,F,100,24,0,24
Jadamarie,F,100,24,0,24
Jaelyne,F,100,24,0,24
Jahliyah,F,100,24,0,24
Jahmire,M,100,0,24,24
Jahnya,F,100,24,0,24
Jaiah,F,100,24,0,24
Jaiona,F,100,24,0,24
Jaisa,F,100,24,0,24
Jaishon,M,100,0,24,24
Jakala,F,100,24,0,24
Jakaya,F,100,24,0,24
Jakkia,F,67,16,8,24
Jaleeah,F,100,24,0,24
Jamina,F,100,24,0,24
Janari,M,58,10,14,24
Janeka,F,100,24,0,24
Janesia,F,100,24,0,24
Jannae,F,100,24,0,24
Jasalyn,F,100,24,0,24
Jasmarie,F,100,24,0,24
Jasyah,M,79,5,19,24
Javia,F,100,24,0,24
Jaxxen,M,100,0,24,24
Jaycelynn,F,100,24,0,24
Jazelyn,F,100,24,0,24
Jazira,F,100,24,0,24
Jehad,M,100,0,24,24
Jennife,F,100,24,0,24
Jeno,M,100,0,24,24
Jerie,F,100,24,0,24
Jerimah,M,100,0,24,24
Jermone,M,100,0,24,24
Jerni,F,100,24,0,24
Jerran,M,100,0,24,24
Jeryn,M,79,5,19,24
Jibri,M,100,0,24,24
Joelie,F,100,24,0,24
Johnel,M,100,0,24,24
Jontrell,M,100,0,24,24
Jonus,M,100,0,24,24
Josaphine,F,100,24,0,24
Jujuan,M,100,0,24,24
Julitza,F,100,24,0,24
Justiss,F,100,24,0,24
Jyssica,F,100,24,0,24
Kaevon,M,100,0,24,24
Kahliyah,F,100,24,0,24
Kairah,F,100,24,0,24
Kairyn,M,79,5,19,24
Kalieb,M,100,0,24,24
Kamariya,F,100,24,0,24
Kamsiyochukwu,M,67,8,16,24
Kavian,M,100,0,24,24
Kayti,F,100,24,0,24
Kaytlen,F,100,24,0,24
Kazimir,M,100,0,24,24
Keiarra,F,100,24,0,24
Keimya,F,100,24,0,24
Keishia,F,100,24,0,24
Keiyon,M,100,0,24,24
Kelina,F,100,24,0,24
Kelsa,F,100,24,0,24
Kendarious,M,100,0,24,24
Kendrew,M,100,0,24,24
Kennet,M,100,0,24,24
Kennetta,F,100,24,0,24
Kervens,M,100,0,24,24
Ketara,F,100,24,0,24
Kevona,F,100,24,0,24
Keysi,F,100,24,0,24
Khadeejah,F,100,24,0,24
Khaleed,M,100,0,24,24
Khalfani,M,100,0,24,24
Khamron,M,100,0,24,24
Khilyn,F,67,16,8,24
Kijuan,M,100,0,24,24
Kilyn,F,79,19,5,24
Kimblery,F,100,24,0,24
Kimbly,F,100,24,0,24
Kinan,M,100,0,24,24
Kingdavid,M,100,0,24,24
Kinney,M,100,0,24,24
Klaryssa,F,100,24,0,24
Kohei,M,100,0,24,24
Kol,M,100,0,24,24
Kurk,M,100,0,24,24
Kyair,M,100,0,24,24
Kyisha,F,100,24,0,24
Kyrielle,F,100,24,0,24
Kyrra,F,100,24,0,24
Lailee,F,100,24,0,24
Lajada,F,100,24,0,24
Lamiracle,F,100,24,0,24
Lamount,M,100,0,24,24
Lanecia,F,100,24,0,24
Lasasha,F,100,24,0,24
Lashannon,F,100,24,0,24
Lashika,F,100,24,0,24
Latesia,F,100,24,0,24
Latiesha,F,100,24,0,24
Lauraann,F,100,24,0,24
Lavren,F,100,24,0,24
Layonna,F,100,24,0,24
Leani,F,100,24,0,24
Leiann,F,100,24,0,24
Lenia,F,100,24,0,24
Lenyx,F,75,18,6,24
Leontine,F,100,24,0,24
Leovardo,M,100,0,24,24
Letesha,F,100,24,0,24
Letetia,F,100,24,0,24
Levie,M,100,0,24,24
Levita,F,100,24,0,24
Lilliahna,F,100,24,0,24
Lindyn,F,100,24,0,24
Lohgan,F,67,16,8,24
Lonzie,M,100,0,24,24
Loralyn,F,100,24,0,24
Loudon,M,100,0,24,24
Lovey,F,100,24,0,24
Lucine,F,100,24,0,24
Luismiguel,M,100,0,24,24
Lunna,F,100,24,0,24
Luretha,F,100,24,0,24
Lyann,F,100,24,0,24
Lylee,F,100,24,0,24
Maclane,M,100,0,24,24
Magdalynn,F,100,24,0,24
Magdelena,F,100,24,0,24
Magenta,F,100,24,0,24
Makinze,F,100,24,0,24
Malaiah,F,100,24,0,24
Maleki,M,100,0,24,24
Maley,F,100,24,0,24
Mallissa,F,100,24,0,24
Malloree,F,100,24,0,24
Maly,F,100,24,0,24
Malya,F,100,24,0,24
Manan,M,100,0,24,24
Manford,M,100,0,24,24
Marianny,F,100,24,0,24
Maricia,F,100,24,0,24
Mariem,F,100,24,0,24
Markeise,M,100,0,24,24
Marlisha,F,100,24,0,24
Marnisha,F,100,24,0,24
Marquet,M,100,0,24,24
Marston,M,100,0,24,24
Marvene,F,100,24,0,24
Marzetta,F,100,24,0,24
Matasha,F,100,24,0,24
Matheson,M,100,0,24,24
Mauriah,F,100,24,0,24
Maurisha,F,100,24,0,24
Mavryk,M,100,0,24,24
Maybell,F,100,24,0,24
Mazy,F,100,24,0,24
Mckensey,F,100,24,0,24
Mclean,M,100,0,24,24
Megin,F,100,24,0,24
Mehtab,M,100,0,24,24
Meiah,F,100,24,0,24
Melondy,F,100,24,0,24
Melyna,F,100,24,0,24
Merin,F,100,24,0,24
Milcah,F,100,24,0,24
Millena,F,100,24,0,24
Millisa,F,100,24,0,24
Miyoshi,F,100,24,0,24
Muaz,M,100,0,24,24
Mykenzi,F,100,24,0,24
Mylea,F,100,24,0,24
Myna,F,100,24,0,24
Myrl,M,79,5,19,24
Myshawn,M,100,0,24,24
Naika,F,100,24,0,24
Nakeem,M,100,0,24,24
Name,M,54,11,13,24
Naomia,F,100,24,0,24
Nastassja,F,100,24,0,24
Natacia,F,100,24,0,24
Nathin,M,100,0,24,24
Neilson,M,100,0,24,24
Nelvin,M,100,0,24,24
Niani,F,100,24,0,24
Nichlas,M,100,0,24,24
Nicko,M,100,0,24,24
Nikeisha,F,100,24,0,24
Nikholas,M,100,0,24,24
Nikiah,F,100,24,0,24
Nissim,M,100,0,24,24
Nkosi,M,100,0,24,24
Nole,M,100,0,24,24
Nox,M,100,0,24,24
Nuchem,M,100,0,24,24
Nyara,F,100,24,0,24
Octavion,M,100,0,24,24
Odaliz,F,100,24,0,24
Oliviagrace,F,100,24,0,24
Olumide,M,100,0,24,24
Orchid,F,100,24,0,24
Pacen,M,100,0,24,24
Pailyn,F,100,24,0,24
Pama,F,100,24,0,24
Patina,F,100,24,0,24
Phoua,F,100,24,0,24
Pieper,F,100,24,0,24
Pleshette,F,100,24,0,24
Porcia,F,100,24,0,24
Pride,M,100,0,24,24
Purcell,M,100,0,24,24
Quentyn,M,100,0,24,24
Quinne,F,100,24,0,24
Quinnley,F,100,24,0,24
Qusai,M,100,0,24,24
Radiance,F,100,24,0,24
Raef,M,100,0,24,24
Rafal,M,100,0,24,24
Raidon,M,100,0,24,24
Rakeisha,F,100,24,0,24
Ramanda,F,100,24,0,24
Ramello,M,100,0,24,24
Raun,M,100,0,24,24
Ravensymone,F,100,24,0,24
Raydon,M,100,0,24,24
Raylinn,F,100,24,0,24
Rehaan,M,100,0,24,24
Renelda,F,100,24,0,24
Renezmae,F,100,24,0,24
Renota,F,100,24,0,24
Rewa,F,100,24,0,24
Rhonna,F,100,24,0,24
Ricahrd,M,100,0,24,24
Rickelle,F,100,24,0,24
Rigdon,M,100,0,24,24
Rissa,F,100,24,0,24
Roch,M,100,0,24,24
Rodriques,M,100,0,24,24
Romano,M,100,0,24,24
Roslin,F,100,24,0,24
Rubbie,F,100,24,0,24
Ruweyda,F,100,24,0,24
Ryin,F,54,13,11,24
Saafir,M,100,0,24,24
Sabryn,F,100,24,0,24
Sadhana,F,100,24,0,24
Safi,M,100,0,24,24
Saheed,M,100,0,24,24
Sahory,F,100,24,0,24
Salley,F,100,24,0,24
Sandralee,F,100,24,0,24
Saraphina,F,100,24,0,24
Saveah,F,100,24,0,24
Savio,M,100,0,24,24
Seanpatrick,M,100,0,24,24
Seira,F,100,24,0,24
Seng,M,100,0,24,24
Shaleena,F,100,24,0,24
Shamere,M,54,11,13,24
Shantele,F,100,24,0,24
Shaquasia,F,100,24,0,24
Sharetta,F,100,24,0,24
Sharmel,F,100,24,0,24
Sharonica,F,100,24,0,24
Shaunette,F,100,24,0,24
Shawnika,F,100,24,0,24
Shawny,F,100,24,0,24
Shekina,F,100,24,0,24
Shekira,F,100,24,0,24
Shenice,F,100,24,0,24
Sheyna,F,100,24,0,24
Shivan,M,100,0,24,24
Shresta,F,100,24,0,24
Shuan,M,100,0,24,24
Sianni,F,100,24,0,24
Sidrah,F,100,24,0,24
Sinda,F,100,24,0,24
Skylier,F,50,12,12,24
Snyder,M,100,0,24,24
Sonita,F,100,24,0,24
Sophiagrace,F,100,24,0,24
Stace,M,58,10,14,24
Starlin,M,79,5,19,24
Sumit,M,100,0,24,24
Susa,F,100,24,0,24
Talbot,M,100,0,24,24
Tamrah,F,100,24,0,24
Tamula,F,100,24,0,24
Taneeka,F,100,24,0,24
Taniela,M,100,0,24,24
Tanmay,M,100,0,24,24
Tannen,M,100,0,24,24
Tannis,F,100,24,0,24
Taronda,F,100,24,0,24
Tashanda,F,100,24,0,24
Tashima,F,100,24,0,24
Tattiana,F,100,24,0,24
Tavita,M,71,7,17,24
Taylinn,F,100,24,0,24
Tayshon,M,100,0,24,24
Teandre,M,100,0,24,24
Telissa,F,100,24,0,24
Tianah,F,100,24,0,24
Tiearra,F,100,24,0,24
Tilton,M,100,0,24,24
Timathy,M,100,0,24,24
Tishara,F,100,24,0,24
Tishia,F,100,24,0,24
Toben,M,100,0,24,24
Tolbert,M,100,0,24,24
Toleen,F,100,24,0,24
Tomeika,F,100,24,0,24
Tomeko,F,100,24,0,24
Tomoki,M,100,0,24,24
Trampus,M,100,0,24,24
Trennon,M,100,0,24,24
Tria,F,100,24,0,24
Tryniti,F,100,24,0,24
Tunya,F,100,24,0,24
Tuwana,F,100,24,0,24
Tuyen,F,71,17,7,24
Tyeler,M,71,7,17,24
Tymel,M,100,0,24,24
Tyrisha,F,100,24,0,24
Valjean,F,100,24,0,24
Varick,M,100,0,24,24
Vasilis,M,100,0,24,24
Vasilisa,F,100,24,0,24
Velencia,F,100,24,0,24
Verenise,F,100,24,0,24
Vernisha,F,100,24,0,24
Vibhav,M,100,0,24,24
Vidalia,F,100,24,0,24
Vuk,M,100,0,24,24
Wiktoria,F,100,24,0,24
Willoughby,F,75,18,6,24
Wyat,M,100,0,24,24
Xzavien,M,100,0,24,24
Yaiden,M,100,0,24,24
Yohance,M,100,0,24,24
Yoland,F,100,24,0,24
Yoltzin,M,58,10,14,24
Yosselyn,F,100,24,0,24
Yulitza,F,100,24,0,24
Zahirah,F,100,24,0,24
Zarayah,F,100,24,0,24
Zaron,M,100,0,24,24
Zevin,M,100,0,24,24
Zimri,M,100,0,24,24
Zorah,F,100,24,0,24
Zyhir,M,100,0,24,24
Zyren,M,100,0,24,24
Aadarsh,M,100,0,23,23
Aamani,F,100,23,0,23
Aariel,F,100,23,0,23
Aarish,M,100,0,23,23
Aariya,F,100,23,0,23
Ab,M,100,0,23,23
Abbegail,F,100,23,0,23
Abbigal,F,100,23,0,23
Abdelaziz,M,100,0,23,23
Abdulrahim,M,100,0,23,23
Abigaelle,F,100,23,0,23
Adabelle,F,100,23,0,23
Adasha,F,100,23,0,23
Addalynne,F,100,23,0,23
Adedamola,M,100,0,23,23
Adilen,F,100,23,0,23
Adir,M,100,0,23,23
Adisen,F,100,23,0,23
Adlynn,F,100,23,0,23
Adrick,M,100,0,23,23
Aerilynn,F,100,23,0,23
Afrah,F,100,23,0,23
Aika,F,100,23,0,23
Aireana,F,100,23,0,23
Alanya,F,100,23,0,23
Alazne,F,100,23,0,23
Aleese,F,100,23,0,23
Alichia,F,100,23,0,23
Alija,M,61,9,14,23
Aliviya,F,100,23,0,23
Alverna,F,100,23,0,23
Amala,F,100,23,0,23
Amarise,F,100,23,0,23
Amarys,F,100,23,0,23
Amaura,F,100,23,0,23
Amily,F,100,23,0,23
Amitai,M,100,0,23,23
Analena,F,100,23,0,23
Anastasija,F,100,23,0,23
Andriea,F,100,23,0,23
Aneth,F,100,23,0,23
Angelyne,F,100,23,0,23
Anhthu,F,100,23,0,23
Annalis,F,100,23,0,23
Annalycia,F,100,23,0,23
Annsleigh,F,100,23,0,23
Anorah,F,100,23,0,23
Anshu,F,100,23,0,23
Anthonia,F,100,23,0,23
Anzlee,F,100,23,0,23
Ardyth,F,100,23,0,23
Arjuna,M,100,0,23,23
Armonii,F,100,23,0,23
Artelia,F,100,23,0,23
Aryaan,M,100,0,23,23
Aryon,M,70,7,16,23
Ascencion,M,100,0,23,23
Ashaz,M,100,0,23,23
Ashelyn,F,100,23,0,23
Ashvik,M,100,0,23,23
Atavia,F,100,23,0,23
Atha,F,100,23,0,23
Aubria,F,100,23,0,23
Averianna,F,100,23,0,23
Avid,M,100,0,23,23
Axxel,M,100,0,23,23
Ayeisha,F,100,23,0,23
Ayiden,M,100,0,23,23
Aylana,F,100,23,0,23
Azai,M,100,0,23,23
Babacar,M,100,0,23,23
Bakary,M,100,0,23,23
Bana,F,100,23,0,23
Banjamin,M,100,0,23,23
Bastien,M,100,0,23,23
Beaulah,F,100,23,0,23
Bekah,F,100,23,0,23
Belina,F,100,23,0,23
Benoit,M,100,0,23,23
Bernestine,F,100,23,0,23
Blayklee,F,100,23,0,23
Boni,F,100,23,0,23
Brandolyn,F,100,23,0,23
Branndon,M,100,0,23,23
Brayn,M,100,0,23,23
Breanah,F,100,23,0,23
Breion,M,100,0,23,23
Brendt,M,100,0,23,23
Briany,F,100,23,0,23
Bridie,F,100,23,0,23
Brielyn,F,100,23,0,23
Briniyah,F,100,23,0,23
Broox,M,100,0,23,23
Bryony,F,100,23,0,23
Bryttani,F,100,23,0,23
Buren,M,100,0,23,23
Burgundy,F,100,23,0,23
Cabe,M,100,0,23,23
Caedence,F,100,23,0,23
Calisa,F,100,23,0,23
Caliya,F,100,23,0,23
Camyla,F,100,23,0,23
Cariana,F,100,23,0,23
Carlosdaniel,M,100,0,23,23
Casanova,M,100,0,23,23
Catharina,F,100,23,0,23
Ceciley,F,100,23,0,23
Cela,F,100,23,0,23
Celester,M,57,10,13,23
Cesily,F,100,23,0,23
Chaitanya,M,100,0,23,23
Chalee,F,100,23,0,23
Chanah,F,100,23,0,23
Chanee,F,100,23,0,23
Chaneta,F,100,23,0,23
Chantil,F,100,23,0,23
Chantrell,F,100,23,0,23
Charlei,F,100,23,0,23
Chaska,M,78,5,18,23
Chelcee,F,100,23,0,23
Cherina,F,100,23,0,23
Chiane,F,100,23,0,23
Chrisie,F,100,23,0,23
Christianjames,M,100,0,23,23
Chrys,F,100,23,0,23
Clarrisa,F,100,23,0,23
Clent,M,100,0,23,23
Coleby,M,100,0,23,23
Comfort,F,100,23,0,23
Corrado,M,100,0,23,23
Correne,F,100,23,0,23
Crislyn,F,100,23,0,23
Cuahutemoc,M,100,0,23,23
Cyerra,F,100,23,0,23
Daemyn,M,100,0,23,23
Dai,M,52,11,12,23
Daijha,F,100,23,0,23
Daisa,F,100,23,0,23
Daisee,F,100,23,0,23
Daiveon,M,100,0,23,23
Dakiya,F,100,23,0,23
Dalicia,F,100,23,0,23
Dally,F,100,23,0,23
Dameka,F,100,23,0,23
Damesha,F,100,23,0,23
Damonica,F,100,23,0,23
Danitra,F,100,23,0,23
Darriana,F,100,23,0,23
Davene,F,100,23,0,23
Davonn,M,100,0,23,23
Dayvian,M,100,0,23,23
Deaaron,M,100,0,23,23
Debralee,F,100,23,0,23
Dedee,F,100,23,0,23
Deeya,F,100,23,0,23
Dejour,M,100,0,23,23
Demarlo,M,100,0,23,23
Demarrion,M,100,0,23,23
Denario,M,100,0,23,23
Derrike,M,100,0,23,23
Deunta,M,100,0,23,23
Devann,F,100,23,0,23
Diago,M,100,0,23,23
Dinari,M,100,0,23,23
Diogenes,M,100,0,23,23
Dontai,M,100,0,23,23
Dorette,F,100,23,0,23
Drae,M,100,0,23,23
Draeden,M,100,0,23,23
Draydon,M,100,0,23,23
Dreshaun,M,100,0,23,23
Dyami,M,100,0,23,23
Dylana,F,100,23,0,23
Dyllen,M,100,0,23,23
Dynasia,F,100,23,0,23
El,M,100,0,23,23
Elajah,F,100,23,0,23
Eldar,M,100,0,23,23
Elek,M,100,0,23,23
Elhadj,M,100,0,23,23
Eliabeth,F,100,23,0,23
Elissia,F,100,23,0,23
Eliz,F,100,23,0,23
Elizeth,F,100,23,0,23
Elliannah,F,100,23,0,23
Emalia,F,100,23,0,23
Engelbert,M,100,0,23,23
Etai,M,100,0,23,23
Evania,F,100,23,0,23
Fabion,M,100,0,23,23
Fady,M,100,0,23,23
Fajr,F,100,23,0,23
Fayez,M,100,0,23,23
French,M,100,0,23,23
Gal,F,52,12,11,23
Gargi,F,100,23,0,23
Gelisa,F,100,23,0,23
Gerron,M,100,0,23,23
Gleb,M,100,0,23,23
Glenice,F,100,23,0,23
Gonsalo,M,100,0,23,23
Graceanna,F,100,23,0,23
Gracious,F,100,23,0,23
Greenleigh,F,100,23,0,23
Gualberto,M,100,0,23,23
Gust,M,100,0,23,23
Hajer,F,100,23,0,23
Halea,F,100,23,0,23
Hannahgrace,F,100,23,0,23
Hargun,F,100,23,0,23
Heli,F,100,23,0,23
Herold,M,100,0,23,23
Hilari,F,100,23,0,23
Hildred,F,70,16,7,23
Hoover,M,100,0,23,23
Huyen,F,100,23,0,23
Iara,F,100,23,0,23
Icis,F,100,23,0,23
Idriss,M,100,0,23,23
Ilka,F,100,23,0,23
Imanie,F,100,23,0,23
Irvine,M,100,0,23,23
Issis,F,100,23,0,23
Ivelise,F,100,23,0,23
Jacqulyne,F,100,23,0,23
Jadavion,M,100,0,23,23
Jaelani,F,100,23,0,23
Jaevin,M,100,0,23,23
Jahel,M,100,0,23,23
Jahrell,M,100,0,23,23
Jaken,M,100,0,23,23
Jaloni,M,78,5,18,23
Jamariyah,F,100,23,0,23
Jamonica,F,100,23,0,23
Jamylah,F,100,23,0,23
Jandiel,M,100,0,23,23
Janeliz,F,100,23,0,23
Janicia,F,100,23,0,23
Janthony,M,100,0,23,23
Jaquanna,F,100,23,0,23
Jaquell,M,100,0,23,23
Jasdeep,M,78,5,18,23
Jaselynn,F,100,23,0,23
Javae,F,57,13,10,23
Jaxie,F,100,23,0,23
Jazae,F,100,23,0,23
Jazier,M,100,0,23,23
Jedaiah,M,100,0,23,23
Jeet,M,100,0,23,23
Jeily,F,100,23,0,23
Jenilee,F,100,23,0,23
Jennessy,F,100,23,0,23
Jenya,F,100,23,0,23
Jerene,F,100,23,0,23
Jerilee,F,100,23,0,23
Jeris,M,78,5,18,23
Jesson,M,100,0,23,23
Jeyren,M,100,0,23,23
Joangel,M,100,0,23,23
Jobani,M,100,0,23,23
Jochebed,F,100,23,0,23
Joeziah,M,100,0,23,23
Johnathin,M,100,0,23,23
Joice,F,100,23,0,23
Jonovan,M,100,0,23,23
Josedaniel,M,100,0,23,23
Joshalyn,F,100,23,0,23
Joshaua,M,100,0,23,23
Jream,F,100,23,0,23
Json,M,100,0,23,23
Juanice,F,100,23,0,23
Juanmiguel,M,100,0,23,23
Juddson,M,100,0,23,23
Julen,M,100,0,23,23
Juliani,F,100,23,0,23
Juvencio,M,100,0,23,23
Kahiau,M,100,0,23,23
Kaicen,M,100,0,23,23
Kaide,M,100,0,23,23
Kaimani,M,100,0,23,23
Kaivon,M,100,0,23,23
Kalya,F,100,23,0,23
Kamaiya,F,100,23,0,23
Kameria,F,100,23,0,23
Kamilo,M,100,0,23,23
Karista,F,100,23,0,23
Karron,F,65,15,8,23
Kasara,F,100,23,0,23
Kashten,M,100,0,23,23
Kashtyn,M,78,5,18,23
Katerra,F,100,23,0,23
Kaylaann,F,100,23,0,23
Kden,M,100,0,23,23
Keandrea,F,100,23,0,23
Keari,F,100,23,0,23
Keelynn,F,78,18,5,23
Keiland,M,100,0,23,23
Keiri,F,100,23,0,23
Keishla,F,100,23,0,23
Kelda,F,100,23,0,23
Kenedee,F,100,23,0,23
Kenetra,F,100,23,0,23
Keslie,F,100,23,0,23
Kewana,F,100,23,0,23
Keyshia,F,100,23,0,23
Khadim,M,100,0,23,23
Khadir,M,100,0,23,23
Khalik,M,100,0,23,23
Khamila,F,100,23,0,23
Khamille,F,100,23,0,23
Khiree,M,100,0,23,23
Kiandre,M,100,0,23,23
Kiffany,F,100,23,0,23
Kileen,F,100,23,0,23
Kimbella,F,100,23,0,23
Kincade,M,100,0,23,23
Kindell,F,74,17,6,23
Kolbee,F,52,12,11,23
Korrina,F,100,23,0,23
Kourtnei,F,100,23,0,23
Krina,F,100,23,0,23
Kristell,F,100,23,0,23
Kwana,F,100,23,0,23
Kweli,M,100,0,23,23
Kylani,F,100,23,0,23
Lacheryl,F,100,23,0,23
Ladawna,F,100,23,0,23
Ladoris,F,100,23,0,23
Laetitia,F,100,23,0,23
Lafe,M,100,0,23,23
Lahela,F,100,23,0,23
Lakeva,F,100,23,0,23
Lameisha,F,100,23,0,23
Laneshia,F,100,23,0,23
Laquasia,F,100,23,0,23
Larance,M,100,0,23,23
Larron,M,100,0,23,23
Lashane,F,78,18,5,23
Lateria,F,100,23,0,23
Latoyna,F,100,23,0,23
Latrise,F,100,23,0,23
Lawyer,M,100,0,23,23
Layani,F,100,23,0,23
Laylee,F,100,23,0,23
Leara,F,100,23,0,23
Legna,F,100,23,0,23
Leul,M,100,0,23,23
Lillianah,F,100,23,0,23
Lizmary,F,100,23,0,23
Llesenia,F,100,23,0,23
Loc,M,100,0,23,23
Lonetta,F,100,23,0,23
Lopaka,M,100,0,23,23
Lorely,F,100,23,0,23
Loreto,M,100,0,23,23
Lorilei,F,100,23,0,23
Lurline,F,100,23,0,23
Lyonel,M,100,0,23,23
Mackinze,F,100,23,0,23
Macrae,M,100,0,23,23
Madesyn,F,100,23,0,23
Madlynn,F,100,23,0,23
Maeci,F,100,23,0,23
Makensey,F,100,23,0,23
Makilah,F,100,23,0,23
Manases,M,100,0,23,23
Manasi,F,100,23,0,23
Marabella,F,100,23,0,23
Marialena,F,100,23,0,23
Marien,F,100,23,0,23
Marjan,F,100,23,0,23
Marquon,M,100,0,23,23
Marria,F,100,23,0,23
Martice,M,100,0,23,23
Marvine,F,100,23,0,23
Marytza,F,100,23,0,23
Masud,M,100,0,23,23
Maxi,M,74,6,17,23
Mayank,M,100,0,23,23
Mayrani,F,100,23,0,23
Mckoy,M,100,0,23,23
Meilech,M,100,0,23,23
Mekel,M,78,5,18,23
Meko,M,100,0,23,23
Menna,F,100,23,0,23
Mercadez,F,100,23,0,23
Merlina,F,100,23,0,23
Meryn,F,100,23,0,23
Mikailah,F,100,23,0,23
Mikalyn,F,100,23,0,23
Miliyah,F,100,23,0,23
Minami,F,100,23,0,23
Miquela,F,100,23,0,23
Miriya,F,100,23,0,23
Mischell,F,100,23,0,23
Monice,F,100,23,0,23
Monik,F,100,23,0,23
Montay,M,100,0,23,23
Morayma,F,100,23,0,23
Morgane,F,100,23,0,23
Morrie,M,100,0,23,23
Mouhamad,M,100,0,23,23
Mourad,M,100,0,23,23
Mukhtar,M,100,0,23,23
Myley,F,100,23,0,23
Myrakle,F,100,23,0,23
Nadyne,F,100,23,0,23
Najja,M,70,7,16,23
Nalanie,F,100,23,0,23
Nameer,M,100,0,23,23
Narjis,F,100,23,0,23
Nataliee,F,100,23,0,23
Natallia,F,100,23,0,23
Natanel,M,100,0,23,23
Navraj,M,100,0,23,23
Naw,F,100,23,0,23
Naylin,F,100,23,0,23
Neithan,M,100,0,23,23
Neytiri,F,100,23,0,23
Nicolena,F,100,23,0,23
Nikie,F,100,23,0,23
Nimra,F,100,23,0,23
Nishika,F,100,23,0,23
Nolah,F,100,23,0,23
Noma,F,100,23,0,23
Olaoluwa,M,100,0,23,23
Oliana,F,100,23,0,23
Omeed,M,100,0,23,23
Omir,M,100,0,23,23
Orman,M,100,0,23,23
Otelia,F,100,23,0,23
Padme,F,100,23,0,23
Panayiotis,M,100,0,23,23
Pharrah,F,100,23,0,23
Phinneas,M,100,0,23,23
Polette,F,100,23,0,23
Priscillia,F,100,23,0,23
Purity,F,100,23,0,23
Quandra,F,100,23,0,23
Quaneshia,F,100,23,0,23
Quantavis,M,100,0,23,23
Quinta,F,74,17,6,23
Rada,F,100,23,0,23
Raeford,M,100,0,23,23
Raela,F,100,23,0,23
Raevon,M,100,0,23,23
Rafel,M,100,0,23,23
Rahn,M,100,0,23,23
Ranbir,M,100,0,23,23
Ranson,M,100,0,23,23
Raushanah,F,100,23,0,23
Ravion,M,74,6,17,23
Raynold,M,100,0,23,23
Reality,F,100,23,0,23
Ree,F,100,23,0,23
Refugia,F,100,23,0,23
Reigan,F,100,23,0,23
Reighlynn,F,100,23,0,23
Reyden,M,100,0,23,23
Rhesa,F,100,23,0,23
Rhilee,F,100,23,0,23
Riad,M,100,0,23,23
Rileyann,F,100,23,0,23
Riyaan,M,100,0,23,23
Rolfe,M,100,0,23,23
Rosene,F,100,23,0,23
Roshaunda,F,100,23,0,23
Roylene,F,100,23,0,23
Rukiya,F,100,23,0,23
Sabrinia,F,100,23,0,23
Sahej,F,78,18,5,23
Sahirah,F,100,23,0,23
Sajjad,M,100,0,23,23
Samba,M,100,0,23,23
Samie,M,57,10,13,23
Samyak,M,100,0,23,23
Sanii,F,100,23,0,23
Saniyyah,F,100,23,0,23
Sarya,F,100,23,0,23
Sebasthian,M,100,0,23,23
Sebastyan,M,100,0,23,23
Secilia,F,100,23,0,23
Sefora,F,100,23,0,23
Sema,F,100,23,0,23
Semiko,F,100,23,0,23
Semir,M,100,0,23,23
Seynabou,F,100,23,0,23
Shahab,M,100,0,23,23
Shahida,F,100,23,0,23
Shahir,M,100,0,23,23
Shajuan,M,57,10,13,23
Shalona,F,100,23,0,23
Shameer,M,100,0,23,23
Shamieka,F,100,23,0,23
Shamra,F,100,23,0,23
Shany,F,100,23,0,23
Shaquitta,F,100,23,0,23
Sharief,M,100,0,23,23
Sharonne,F,100,23,0,23
Shaton,F,100,23,0,23
Shavaughn,F,100,23,0,23
Shavona,F,100,23,0,23
Shavonn,F,100,23,0,23
Shawnmichael,M,100,0,23,23
Sherlynn,F,100,23,0,23
Shiah,M,57,10,13,23
Shivonne,F,100,23,0,23
Shlomie,M,100,0,23,23
Shoni,F,100,23,0,23
Sirus,M,100,0,23,23
Siyah,F,100,23,0,23
Smaran,M,100,0,23,23
Sonoma,F,100,23,0,23
Steaven,M,100,0,23,23
Stefhanie,F,100,23,0,23
Strummer,M,100,0,23,23
Suhaan,M,100,0,23,23
Sunjai,F,100,23,0,23
Suriah,F,100,23,0,23
Syrai,F,100,23,0,23
Taequan,M,100,0,23,23
Taevin,M,100,0,23,23
Tahara,F,100,23,0,23
Taje,F,57,13,10,23
Takenya,F,100,23,0,23
Takeria,F,100,23,0,23
Tamber,F,100,23,0,23
Tamlyn,F,100,23,0,23
Tamma,F,100,23,0,23
Tanajah,F,100,23,0,23
Tandrea,F,100,23,0,23
Taquila,F,100,23,0,23
Tay,M,78,5,18,23
Tearsa,F,100,23,0,23
Temitope,F,52,12,11,23
Terryann,F,100,23,0,23
Thersea,F,100,23,0,23
Tieara,F,100,23,0,23
Tima,F,100,23,0,23
Timiya,F,100,23,0,23
Tipton,M,100,0,23,23
Tjay,M,100,0,23,23
Tongela,F,100,23,0,23
Tonni,F,100,23,0,23
Traniya,F,100,23,0,23
Travontae,M,100,0,23,23
Trichelle,F,100,23,0,23
Trinten,M,100,0,23,23
Trinty,F,100,23,0,23
Tyr,M,100,0,23,23
Undrea,F,70,16,7,23
Valaree,F,100,23,0,23
Venisha,F,100,23,0,23
Veron,M,100,0,23,23
Vertis,M,70,7,16,23
Viera,F,100,23,0,23
Vin,M,100,0,23,23
Vinetta,F,100,23,0,23
Virgel,M,100,0,23,23
Vung,F,100,23,0,23
Waldon,M,100,0,23,23
Wyndell,M,100,0,23,23
Xabi,M,100,0,23,23
Xzayvion,M,100,0,23,23
Yachet,F,100,23,0,23
Yakima,F,100,23,0,23
Yanette,F,100,23,0,23
Yarixa,F,100,23,0,23
Yeraldi,F,100,23,0,23
Yeva,F,100,23,0,23
Yogi,M,100,0,23,23
Yukiko,F,100,23,0,23
Yumiko,F,100,23,0,23
Yvaine,F,100,23,0,23
Zabian,M,100,0,23,23
Zaiah,F,74,17,6,23
Zailah,F,100,23,0,23
Zailen,M,100,0,23,23
Zakeya,F,100,23,0,23
Zakya,F,100,23,0,23
Zakyah,F,100,23,0,23
Zala,F,100,23,0,23
Zalea,F,100,23,0,23
Zaniel,M,100,0,23,23
Zanita,F,100,23,0,23
Zarinah,F,100,23,0,23
Zelphia,F,100,23,0,23
Zenas,M,100,0,23,23
Zettie,F,100,23,0,23
Zhoey,F,100,23,0,23
Zhuri,F,100,23,0,23
Ziair,M,100,0,23,23
Zorion,M,100,0,23,23
Zubayr,M,100,0,23,23
Zyere,M,100,0,23,23
Zyian,F,65,15,8,23
Zymeir,M,100,0,23,23
Zymier,M,100,0,23,23
Aaleigha,F,100,22,0,22
Abbigael,F,100,22,0,22
Abdikadir,M,100,0,22,22
Abdimalik,M,100,0,22,22
Abed,M,100,0,22,22
Abem,M,100,0,22,22
Abiageal,F,100,22,0,22
Abryana,F,100,22,0,22
Adaleena,F,100,22,0,22
Adalid,M,77,5,17,22
Adea,F,100,22,0,22
Adelei,F,100,22,0,22
Adelisa,F,100,22,0,22
Adely,F,100,22,0,22
Adilynne,F,100,22,0,22
Adisynn,F,100,22,0,22
Aibhlinn,F,100,22,0,22
Airis,F,77,17,5,22
Akeia,F,100,22,0,22
Akeila,F,100,22,0,22
Akin,M,100,0,22,22
Alaja,F,100,22,0,22
Alayziah,F,100,22,0,22
Aldous,M,100,0,22,22
Alem,M,100,0,22,22
Alexxia,F,100,22,0,22
Aliscia,F,100,22,0,22
Alle,F,100,22,0,22
Allesandra,F,100,22,0,22
Allyce,F,100,22,0,22
Alverta,F,100,22,0,22
Alvester,M,100,0,22,22
Alyria,F,100,22,0,22
Amarylis,F,100,22,0,22
Amberlie,F,100,22,0,22
Amedeo,M,100,0,22,22
Anahla,F,100,22,0,22
Analiya,F,100,22,0,22
Anberlyn,F,100,22,0,22
Anelia,F,100,22,0,22
Annaliah,F,100,22,0,22
Annaliz,F,100,22,0,22
Annamary,F,100,22,0,22
Annasofia,F,100,22,0,22
Anndee,F,100,22,0,22
Annisha,F,100,22,0,22
Annmargaret,F,100,22,0,22
Anothony,M,100,0,22,22
Antion,M,100,0,22,22
Anurag,M,100,0,22,22
Anyae,F,100,22,0,22
Aodhan,M,100,0,22,22
Arbor,F,100,22,0,22
Ardie,M,77,5,17,22
Arlenne,F,100,22,0,22
Arrayah,F,100,22,0,22
Arti,F,100,22,0,22
Artice,M,77,5,17,22
Arva,F,100,22,0,22
Arvilla,F,100,22,0,22
Ashkan,M,100,0,22,22
Ashonti,F,100,22,0,22
Atari,F,55,12,10,22
Aury,F,77,17,5,22
Avarey,F,100,22,0,22
Avishai,M,100,0,22,22
Aviyana,F,100,22,0,22
Avyaan,M,100,0,22,22
Avyay,M,100,0,22,22
Azaliyah,F,100,22,0,22
Azarius,M,100,0,22,22
Azrielle,F,100,22,0,22
Azyria,F,100,22,0,22
Bacilio,M,100,0,22,22
Barabara,F,100,22,0,22
Barett,M,100,0,22,22
Bartlett,M,100,0,22,22
Baylynn,F,100,22,0,22
Benjy,M,100,0,22,22
Betzabe,F,100,22,0,22
Betzalel,M,100,0,22,22
Beyonca,F,100,22,0,22
Bg,F,100,22,0,22
Biance,F,100,22,0,22
Billey,M,100,0,22,22
Bing,M,100,0,22,22
Blessings,F,100,22,0,22
Bodin,M,100,0,22,22
Bran,M,100,0,22,22
Breane,F,100,22,0,22
Breindel,F,100,22,0,22
Brenin,M,100,0,22,22
Brezlyn,F,100,22,0,22
Briceson,M,100,0,22,22
Briceyda,F,100,22,0,22
Bricia,F,100,22,0,22
Brigetta,F,100,22,0,22
Briggette,F,100,22,0,22
Britlee,F,100,22,0,22
Brittane,F,100,22,0,22
Brizza,F,100,22,0,22
Brodin,M,100,0,22,22
Brylyn,F,77,17,5,22
Brynnly,F,100,22,0,22
Brysan,M,100,0,22,22
Buddie,M,100,0,22,22
Buzz,M,100,0,22,22
Cadel,M,100,0,22,22
Cadi,F,100,22,0,22
California,F,100,22,0,22
Calyx,M,64,8,14,22
Camaryn,F,100,22,0,22
Canda,F,100,22,0,22
Capone,M,100,0,22,22
Caramia,F,100,22,0,22
Carmelle,F,100,22,0,22
Carmencita,F,100,22,0,22
Carmichael,M,100,0,22,22
Carmie,F,100,22,0,22
Carrera,F,100,22,0,22
Cathyann,F,100,22,0,22
Cavion,M,100,0,22,22
Ceceilia,F,100,22,0,22
Celisa,F,100,22,0,22
Ceniyah,F,100,22,0,22
Cerra,F,100,22,0,22
Chapin,M,73,6,16,22
Chariti,F,100,22,0,22
Charma,F,100,22,0,22
Chealsea,F,100,22,0,22
Chelcy,F,100,22,0,22
Cheria,F,100,22,0,22
Chessie,F,100,22,0,22
Cheynne,F,100,22,0,22
Chinelo,F,100,22,0,22
Chinenye,F,100,22,0,22
Chrisotpher,M,100,0,22,22
Cid,M,100,0,22,22
Clarene,F,100,22,0,22
Clemencia,F,100,22,0,22
Cleotilde,F,100,22,0,22
Clora,F,100,22,0,22
Contrina,F,100,22,0,22
Cordaryl,M,100,0,22,22
Cornellius,M,100,0,22,22
Corran,M,100,0,22,22
Coumba,F,100,22,0,22
Crosley,M,73,6,16,22
Dahmir,M,100,0,22,22
Daianna,F,100,22,0,22
Damisha,F,100,22,0,22
Darleny,F,100,22,0,22
Darlinda,F,100,22,0,22
Dashan,M,100,0,22,22
Dasiah,F,100,22,0,22
Davione,M,77,5,17,22
Daylah,F,100,22,0,22
Deanglo,M,100,0,22,22
Deitrich,M,100,0,22,22
Delona,F,100,22,0,22
Demontay,M,100,0,22,22
Denney,M,100,0,22,22
Dennisha,F,100,22,0,22
Derreon,M,100,0,22,22
Desa,F,100,22,0,22
Desteni,F,100,22,0,22
Dezyre,F,100,22,0,22
Dilia,F,100,22,0,22
Dimond,F,100,22,0,22
Dodd,M,100,0,22,22
Donalyn,F,100,22,0,22
Donasia,F,100,22,0,22
Donshay,M,77,5,17,22
Donyea,M,59,9,13,22
Dorothey,F,100,22,0,22
Dot,F,100,22,0,22
Dquan,M,100,0,22,22
Dragon,M,100,0,22,22
Duha,F,100,22,0,22
Durant,M,100,0,22,22
Duyen,F,100,22,0,22
Dynisha,F,100,22,0,22
Dyonna,F,100,22,0,22
Ebba,F,100,22,0,22
Ebonique,F,100,22,0,22
Edrei,M,100,0,22,22
Eduar,M,100,0,22,22
Eirene,F,100,22,0,22
Elaijah,F,100,22,0,22
Elaiza,F,100,22,0,22
Elaysha,F,100,22,0,22
Elese,F,100,22,0,22
Elih,M,100,0,22,22
Elleah,F,100,22,0,22
Ellionna,F,100,22,0,22
Elysabeth,F,100,22,0,22
Emanuella,F,100,22,0,22
Emauri,M,73,6,16,22
Emberli,F,100,22,0,22
Embrie,F,100,22,0,22
Emilene,F,100,22,0,22
Emmelina,F,100,22,0,22
Emunah,F,100,22,0,22
Ericha,F,100,22,0,22
Eriyah,F,100,22,0,22
Erynne,F,100,22,0,22
Essam,M,100,0,22,22
Evelene,F,100,22,0,22
Faatimah,F,100,22,0,22
Fabianna,F,100,22,0,22
Fareeda,F,100,22,0,22
Faruk,M,100,0,22,22
Farzana,F,100,22,0,22
Fatina,F,100,22,0,22
Feliberto,M,100,0,22,22
Fiora,F,100,22,0,22
Fontella,F,100,22,0,22
Gabrella,F,100,22,0,22
Garek,M,100,0,22,22
Gatlyn,M,100,0,22,22
Geral,M,77,5,17,22
Gershom,M,100,0,22,22
Gillis,M,100,0,22,22
Ginni,F,100,22,0,22
Haddy,F,100,22,0,22
Halsey,F,77,17,5,22
Hanako,F,100,22,0,22
Hardie,M,100,0,22,22
Haset,F,100,22,0,22
Hasina,F,100,22,0,22
Hau,M,64,8,14,22
Havah,F,100,22,0,22
Hawke,M,100,0,22,22
Hayzen,M,100,0,22,22
Hinckley,M,100,0,22,22
Hiya,F,100,22,0,22
Hobson,M,100,0,22,22
Honestee,F,100,22,0,22
Iantha,F,100,22,0,22
Idamae,F,100,22,0,22
Idrissa,M,100,0,22,22
Ihor,M,100,0,22,22
Indiah,F,100,22,0,22
Indiyah,F,100,22,0,22
Ireoluwa,F,73,16,6,22
Isabellarose,F,100,22,0,22
Ishi,F,100,22,0,22
Ismelda,F,100,22,0,22
Ivannia,F,100,22,0,22
Iveliz,F,100,22,0,22
Izic,M,100,0,22,22
Izzabell,F,100,22,0,22
Izzah,F,100,22,0,22
Jaclin,F,100,22,0,22
Jacson,M,100,0,22,22
Jadeveon,M,100,0,22,22
Jakarie,M,100,0,22,22
Jakavion,M,100,0,22,22
Jakeira,F,100,22,0,22
Jakyrah,F,100,22,0,22
Jaleena,F,100,22,0,22
Jalei,F,100,22,0,22
Jamarii,M,100,0,22,22
Jamarquis,M,100,0,22,22
Jamilya,F,100,22,0,22
Janaiyah,F,100,22,0,22
Janiyha,F,100,22,0,22
Jaquari,M,100,0,22,22
Jaquavis,M,100,0,22,22
Jaque,M,77,5,17,22
Jaquelynn,F,100,22,0,22
Jash,M,100,0,22,22
Jatia,F,100,22,0,22
Jauna,F,100,22,0,22
Javel,M,100,0,22,22
Javious,M,100,0,22,22
Jaydis,M,100,0,22,22
Jaylina,F,100,22,0,22
Jayseon,M,100,0,22,22
Jaysun,M,100,0,22,22
Jayziah,M,100,0,22,22
Jazilyn,F,100,22,0,22
Jeffey,M,100,0,22,22
Jenan,F,100,22,0,22
Jennalynn,F,100,22,0,22
Jeorgia,F,100,22,0,22
Jermale,M,100,0,22,22
Jessamy,F,100,22,0,22
Jessel,F,100,22,0,22
Jettson,M,100,0,22,22
Jhanvi,F,100,22,0,22
Jjesus,M,100,0,22,22
Joanthony,M,100,0,22,22
Joesphine,F,100,22,0,22
Jolea,F,100,22,0,22
Jonasia,F,100,22,0,22
Jonnette,F,100,22,0,22
Jovonne,F,77,17,5,22
Jp,M,100,0,22,22
Julianah,F,100,22,0,22
Julita,F,100,22,0,22
Kacelyn,F,100,22,0,22
Kaimen,M,100,0,22,22
Kaitelyn,F,100,22,0,22
Kaitlyne,F,100,22,0,22
Kalese,F,100,22,0,22
Kallel,M,100,0,22,22
Kandon,M,100,0,22,22
Karinne,F,100,22,0,22
Kashana,F,100,22,0,22
Kashe,M,68,7,15,22
Kathalene,F,100,22,0,22
Kathreen,F,100,22,0,22
Kathyann,F,100,22,0,22
Katrisha,F,100,22,0,22
Kawena,F,100,22,0,22
Kayd,M,100,0,22,22
Kaydenn,M,100,0,22,22
Kaydie,F,100,22,0,22
Kayveon,M,100,0,22,22
Keelen,M,100,0,22,22
Keerat,F,100,22,0,22
Kellon,M,100,0,22,22
Kemyra,F,100,22,0,22
Ketura,F,100,22,0,22
Key,M,77,5,17,22
Keyarah,F,100,22,0,22
Keyari,F,100,22,0,22
Keysean,M,100,0,22,22
Keyuna,F,100,22,0,22
Khalon,M,100,0,22,22
Kimiyah,F,100,22,0,22
Kimmarie,F,100,22,0,22
Kimyah,F,100,22,0,22
Kirston,F,100,22,0,22
Kirubel,M,100,0,22,22
Kobyn,M,100,0,22,22
Koki,M,100,0,22,22
Kolyn,M,100,0,22,22
Krishana,F,100,22,0,22
Krissia,F,100,22,0,22
Krosby,M,100,0,22,22
Krystofer,M,100,0,22,22
Kyandra,F,100,22,0,22
Kyce,M,100,0,22,22
Kycen,M,100,0,22,22
Kyshaun,M,100,0,22,22
Labaron,M,100,0,22,22
Labresha,F,100,22,0,22
Labrian,M,100,0,22,22
Ladasia,F,100,22,0,22
Ladonte,M,100,0,22,22
Lai,F,100,22,0,22
Lajune,F,100,22,0,22
Lakea,F,100,22,0,22
Laksh,M,100,0,22,22
Lanijah,F,100,22,0,22
Larene,F,100,22,0,22
Lashante,F,100,22,0,22
Lashonta,F,100,22,0,22
Latiana,F,100,22,0,22
Latondra,F,100,22,0,22
Layloni,F,100,22,0,22
Layza,F,100,22,0,22
Leiliana,F,100,22,0,22
Lelend,M,100,0,22,22
Lendy,F,100,22,0,22
Lenea,F,100,22,0,22
Lenetta,F,100,22,0,22
Lestine,F,100,22,0,22
Letzy,F,100,22,0,22
Levis,M,100,0,22,22
Lexxie,F,100,22,0,22
Lilac,F,100,22,0,22
Lilu,F,100,22,0,22
Lilyona,F,100,22,0,22
Linet,F,100,22,0,22
Linsy,F,100,22,0,22
Liyla,F,100,22,0,22
Lonette,F,100,22,0,22
Loraina,F,100,22,0,22
Lovelee,F,100,22,0,22
Lucielle,F,100,22,0,22
Lucita,F,100,22,0,22
Lujane,F,100,22,0,22
Luv,F,100,22,0,22
Lyniah,F,100,22,0,22
Lynsay,F,100,22,0,22
Mabrey,F,100,22,0,22
Mackson,M,100,0,22,22
Madiha,F,100,22,0,22
Madinah,F,100,22,0,22
Maecie,F,100,22,0,22
Maicie,F,100,22,0,22
Majeed,M,100,0,22,22
Makalynn,F,100,22,0,22
Makayah,F,100,22,0,22
Makaylen,F,100,22,0,22
Makita,F,100,22,0,22
Maleaha,F,100,22,0,22
Maleak,M,100,0,22,22
Malikhi,M,100,0,22,22
Maloni,F,100,22,0,22
Mardelle,F,100,22,0,22
Marga,F,100,22,0,22
Margaree,F,100,22,0,22
Margi,F,100,22,0,22
Marijean,F,100,22,0,22
Marijose,F,100,22,0,22
Mariona,F,100,22,0,22
Markiesha,F,100,22,0,22
Martise,M,100,0,22,22
Marzell,M,100,0,22,22
Maui,M,64,8,14,22
Maurico,M,100,0,22,22
Maurio,M,100,0,22,22
Maxwel,M,100,0,22,22
Mayco,M,100,0,22,22
Mayley,F,100,22,0,22
Maysin,M,77,5,17,22
Meiko,F,50,11,11,22
Melissaann,F,100,22,0,22
Mellina,F,100,22,0,22
Mellonie,F,100,22,0,22
Mercie,F,100,22,0,22
Meriem,F,100,22,0,22
Metztli,F,100,22,0,22
Miakoda,F,100,22,0,22
Miara,F,100,22,0,22
Mickala,F,100,22,0,22
Mikea,F,100,22,0,22
Mikylah,F,100,22,0,22
Milenia,F,100,22,0,22
Mirela,F,100,22,0,22
Mirko,M,100,0,22,22
Mishon,M,100,0,22,22
Momin,M,100,0,22,22
Montague,M,100,0,22,22
Mustaf,M,100,0,22,22
Myan,M,77,5,17,22
Nachum,M,100,0,22,22
Nalini,F,100,22,0,22
Namiyah,F,100,22,0,22
Nanea,F,100,22,0,22
Nanetta,F,100,22,0,22
Natausha,F,100,22,0,22
Nathian,M,100,0,22,22
Nautika,F,100,22,0,22
Neeva,F,100,22,0,22
Neidy,F,100,22,0,22
Neita,F,100,22,0,22
Nelissa,F,100,22,0,22
Neveyah,F,100,22,0,22
Nezar,M,100,0,22,22
Nickolaos,M,100,0,22,22
Nicolis,M,100,0,22,22
Nihira,F,100,22,0,22
Nikolos,M,100,0,22,22
Nikolus,M,100,0,22,22
Nilo,M,100,0,22,22
Nochum,M,100,0,22,22
Noela,F,100,22,0,22
Nolawi,M,100,0,22,22
Noriko,F,100,22,0,22
Norleen,F,100,22,0,22
Normajean,F,100,22,0,22
Nyaire,M,68,7,15,22
Nyala,F,100,22,0,22
Nyzier,M,100,0,22,22
Ohanna,F,100,22,0,22
Olimpia,F,100,22,0,22
Oluchi,F,100,22,0,22
Omere,M,100,0,22,22
Osias,M,100,0,22,22
Osie,F,55,12,10,22
Osmel,M,100,0,22,22
Othello,M,100,0,22,22
Oviya,F,100,22,0,22
Owynn,M,77,5,17,22
Patriciaann,F,100,22,0,22
Patrycja,F,100,22,0,22
Phallon,F,100,22,0,22
Phillippe,M,100,0,22,22
Piers,M,100,0,22,22
Pistol,M,77,5,17,22
Prabhjot,M,77,5,17,22
Prajna,F,100,22,0,22
Quante,M,100,0,22,22
Querida,F,100,22,0,22
Quinlee,F,100,22,0,22
Raelie,F,100,22,0,22
Rahima,F,100,22,0,22
Ranier,M,100,0,22,22
Ravneet,F,100,22,0,22
Rayder,M,100,0,22,22
Redonna,F,100,22,0,22
Reginna,F,100,22,0,22
Renaye,F,100,22,0,22
Renessa,F,100,22,0,22
Rexanne,F,100,22,0,22
Reyhan,M,100,0,22,22
Rhen,M,55,10,12,22
Rhena,F,100,22,0,22
Rhyland,M,100,0,22,22
Rhylynn,F,100,22,0,22
Rishav,M,100,0,22,22
Rishit,M,100,0,22,22
Roc,M,100,0,22,22
Rodarius,M,100,0,22,22
Rosali,F,100,22,0,22
Roselynne,F,100,22,0,22
Roshana,F,100,22,0,22
Ruffin,M,100,0,22,22
Ruhani,F,100,22,0,22
Rumeal,M,100,0,22,22
Rustyn,M,100,0,22,22
Ruta,F,100,22,0,22
Ryeleigh,F,100,22,0,22
Ryhanna,F,100,22,0,22
Rylah,F,100,22,0,22
Sabel,F,100,22,0,22
Sabirin,F,100,22,0,22
Sael,M,100,0,22,22
Safiyya,F,100,22,0,22
Saharah,F,100,22,0,22
Saharra,F,100,22,0,22
Sahmir,M,100,0,22,22
Saleema,F,100,22,0,22
Salinda,F,100,22,0,22
Samella,F,100,22,0,22
Sandford,M,100,0,22,22
Santia,F,100,22,0,22
Saraiya,F,100,22,0,22
Saurav,M,100,0,22,22
Sava,M,100,0,22,22
Saveon,M,100,0,22,22
Savien,M,100,0,22,22
Scherrie,F,100,22,0,22
Scottlynn,F,100,22,0,22
Seairra,F,100,22,0,22
Setareh,F,100,22,0,22
Seydou,M,100,0,22,22
Shakendra,F,100,22,0,22
Shamaine,F,100,22,0,22
Shanetra,F,100,22,0,22
Shaniquia,F,100,22,0,22
Sharnetta,F,100,22,0,22
Sharnice,F,100,22,0,22
Shaunita,F,100,22,0,22
Shavonte,F,100,22,0,22
Sheetal,F,100,22,0,22
Shenetta,F,100,22,0,22
Sherea,F,100,22,0,22
Sherin,F,100,22,0,22
Sherleen,F,100,22,0,22
Sheyli,F,100,22,0,22
Shondrea,F,100,22,0,22
Sila,F,100,22,0,22
Siler,M,100,0,22,22
Sinclaire,F,100,22,0,22
Staphanie,F,100,22,0,22
Stefanee,F,100,22,0,22
Stephanye,F,100,22,0,22
Suan,M,77,5,17,22
Suella,F,100,22,0,22
Suhaila,F,100,22,0,22
Sula,F,100,22,0,22
Surabhi,F,100,22,0,22
Surena,F,100,22,0,22
Symiah,F,100,22,0,22
Tabia,F,100,22,0,22
Taeveon,M,100,0,22,22
Taheerah,F,100,22,0,22
Taite,M,68,7,15,22
Tajai,M,55,10,12,22
Takiesha,F,100,22,0,22
Tamanna,F,100,22,0,22
Tamberly,F,100,22,0,22
Tammatha,F,100,22,0,22
Tanzie,F,100,22,0,22
Tarini,F,100,22,0,22
Tarisha,F,100,22,0,22
Tasheba,F,100,22,0,22
Tashianna,F,100,22,0,22
Tavyn,M,100,0,22,22
Taysean,M,100,0,22,22
Teion,M,100,0,22,22
Tekesha,F,100,22,0,22
Temisha,F,100,22,0,22
Teniyah,F,100,22,0,22
Terralyn,F,100,22,0,22
Terrez,M,100,0,22,22
Terriyah,F,100,22,0,22
Thales,M,100,0,22,22
Therron,M,100,0,22,22
Tiawana,F,100,22,0,22
Tibor,M,100,0,22,22
Tiffannie,F,100,22,0,22
Tiffony,F,100,22,0,22
Tiphani,F,100,22,0,22
Tobechukwu,M,100,0,22,22
Tonee,F,100,22,0,22
Tonianne,F,100,22,0,22
Traquan,M,100,0,22,22
Traylen,M,100,0,22,22
Trayven,M,100,0,22,22
Treavon,M,100,0,22,22
Treniece,F,100,22,0,22
Trezure,F,100,22,0,22
Trinnity,F,100,22,0,22
Trulee,F,100,22,0,22
Trygg,M,100,0,22,22
Tujuana,F,100,22,0,22
Tyde,M,100,0,22,22
Tylerjames,M,100,0,22,22
Tyreka,F,100,22,0,22
Tyton,M,100,0,22,22
Uniqua,F,100,22,0,22
Urania,F,100,22,0,22
Velicia,F,100,22,0,22
Vencent,M,100,0,22,22
Viha,F,100,22,0,22
Voncille,F,100,22,0,22
Wiatt,M,100,0,22,22
Wilman,M,100,0,22,22
Wilmar,M,100,0,22,22
Wilver,M,100,0,22,22
Yamari,F,100,22,0,22
Yaritzy,F,100,22,0,22
Yaroslav,M,100,0,22,22
Yenny,F,100,22,0,22
Yoshiko,F,100,22,0,22
Yosiah,M,100,0,22,22
Yuriah,M,55,10,12,22
Yvana,F,100,22,0,22
Zaia,F,100,22,0,22
Zakariyah,M,100,0,22,22
Zakariye,M,100,0,22,22
Zani,F,64,14,8,22
Zarielle,F,100,22,0,22
Zavia,F,100,22,0,22
Zerick,M,100,0,22,22
Ziv,M,100,0,22,22
Ziyanna,F,100,22,0,22
Zyien,M,68,7,15,22
Zyrion,M,100,0,22,22
Aalaysia,F,100,21,0,21
Aanvi,F,100,21,0,21
Abbagale,F,100,21,0,21
Adiah,F,100,21,0,21
Adiba,F,100,21,0,21
Ahni,F,100,21,0,21
Aiyahna,F,100,21,0,21
Akanksha,F,100,21,0,21
Alanea,F,100,21,0,21
Aleaya,F,100,21,0,21
Alessandria,F,100,21,0,21
Alexza,F,100,21,0,21
Allah,M,100,0,21,21
Alline,F,100,21,0,21
Allon,M,100,0,21,21
Alyan,M,100,0,21,21
Amarilys,F,100,21,0,21
Amazing,F,100,21,0,21
Amiera,F,100,21,0,21
Amilio,M,100,0,21,21
Anaalicia,F,100,21,0,21
Anacaren,F,100,21,0,21
Anamari,F,100,21,0,21
Anayiah,F,100,21,0,21
Anaysia,F,100,21,0,21
Andersyn,F,100,21,0,21
Andreal,F,100,21,0,21
Andrell,M,100,0,21,21
Andris,M,100,0,21,21
Andyn,M,100,0,21,21
Annai,F,100,21,0,21
Annaliza,F,100,21,0,21
Annitta,F,100,21,0,21
Anquanette,F,100,21,0,21
Antia,F,100,21,0,21
Aranda,F,100,21,0,21
Areebah,F,100,21,0,21
Ariea,F,100,21,0,21
Artasia,F,100,21,0,21
Artrell,M,100,0,21,21
Ashawn,M,100,0,21,21
Aspin,F,100,21,0,21
Asyia,F,100,21,0,21
Atina,F,100,21,0,21
Attilio,M,100,0,21,21
Audianna,F,100,21,0,21
Aurorah,F,100,21,0,21
Ausar,M,100,0,21,21
Avea,F,100,21,0,21
Avianah,F,100,21,0,21
Aviendha,F,100,21,0,21
Aws,M,100,0,21,21
Axtyn,M,100,0,21,21
Ayano,F,100,21,0,21
Aydian,M,100,0,21,21
Ayeden,M,100,0,21,21
Ayeshia,F,100,21,0,21
Aysel,F,100,21,0,21
Azalie,F,100,21,0,21
Azula,F,100,21,0,21
Bawi,M,100,0,21,21
Bence,M,100,0,21,21
Beni,M,71,6,15,21
Berel,M,100,0,21,21
Bethanee,F,100,21,0,21
Betsie,F,100,21,0,21
Beyounce,F,100,21,0,21
Bilaal,M,100,0,21,21
Billijo,F,100,21,0,21
Bisma,F,100,21,0,21
Blanchie,F,100,21,0,21
Blyss,F,100,21,0,21
Braedin,M,100,0,21,21
Brandelyn,F,100,21,0,21
Brandonlee,M,100,0,21,21
Brayen,M,100,0,21,21
Breanda,F,100,21,0,21
Breniyah,F,100,21,0,21
Brigg,M,100,0,21,21
Brinklee,F,100,21,0,21
Britanya,F,100,21,0,21
Briyah,F,100,21,0,21
Bulah,F,100,21,0,21
Burns,M,100,0,21,21
Caedan,M,100,0,21,21
Cambridge,F,52,11,10,21
Candiss,F,100,21,0,21
Carleah,F,100,21,0,21
Carnetta,F,100,21,0,21
Carsin,M,100,0,21,21
Casin,M,100,0,21,21
Cecilya,F,100,21,0,21
Ceclia,F,100,21,0,21
Chaeli,F,100,21,0,21
Chales,M,100,0,21,21
Chandria,F,100,21,0,21
Chanley,F,100,21,0,21
Channin,M,52,10,11,21
Chantilly,F,100,21,0,21
Chelcey,F,100,21,0,21
Cheresa,F,100,21,0,21
Cheridan,F,100,21,0,21
Cherissa,F,100,21,0,21
Chivonne,F,100,21,0,21
Christmas,F,100,21,0,21
Cinch,M,100,0,21,21
Cionna,F,100,21,0,21
Colletta,F,100,21,0,21
Coreena,F,100,21,0,21
Costas,M,100,0,21,21
Cressida,F,100,21,0,21
Curlee,M,100,0,21,21
Cynthea,F,100,21,0,21
Dacian,M,100,0,21,21
Daemian,M,100,0,21,21
Dailee,F,100,21,0,21
Daltin,M,100,0,21,21
Damonta,M,100,0,21,21
Danikah,F,100,21,0,21
Danil,M,100,0,21,21
Danniela,F,100,21,0,21
Danyah,F,100,21,0,21
Danylah,F,100,21,0,21
Daquane,M,100,0,21,21
Daquann,M,100,0,21,21
Darly,F,71,15,6,21
Darnita,F,100,21,0,21
Dashana,F,100,21,0,21
Dashayla,F,100,21,0,21
Datron,M,100,0,21,21
Dawaun,M,100,0,21,21
Dawnell,F,100,21,0,21
Deeric,M,100,0,21,21
Delayza,F,100,21,0,21
Delcie,F,100,21,0,21
Deleah,F,100,21,0,21
Demarques,M,100,0,21,21
Demarrio,M,100,0,21,21
Denece,F,100,21,0,21
Dera,F,100,21,0,21
Deray,M,100,0,21,21
Deveron,M,100,0,21,21
Deysy,F,100,21,0,21
Dhanush,M,100,0,21,21
Diannah,F,100,21,0,21
Disney,F,100,21,0,21
Dodger,M,100,0,21,21
Donise,F,100,21,0,21
Dontrey,M,100,0,21,21
Doreene,F,100,21,0,21
Dorrine,F,100,21,0,21
Druscilla,F,100,21,0,21
Duante,M,100,0,21,21
Duru,F,100,21,0,21
Dwanda,F,100,21,0,21
Ekin,M,100,0,21,21
Elaisha,F,100,21,0,21
Elgie,M,100,0,21,21
Elisandra,F,100,21,0,21
Elizeo,M,100,0,21,21
Ellason,F,100,21,0,21
Elliet,F,100,21,0,21
Elorah,F,100,21,0,21
Elyna,F,100,21,0,21
Emilo,M,100,0,21,21
Emmerie,F,100,21,0,21
Epic,M,76,5,16,21
Erez,M,100,0,21,21
Erling,M,100,0,21,21
Evaleen,F,100,21,0,21
Evangela,F,100,21,0,21
Eylin,F,100,21,0,21
Ezariah,M,57,9,12,21
Faren,F,100,21,0,21
Farheen,F,100,21,0,21
Fedor,M,100,0,21,21
Felicha,F,100,21,0,21
Ferron,M,100,0,21,21
Franchelle,F,100,21,0,21
Garik,M,100,0,21,21
Gayathri,F,100,21,0,21
Geanine,F,100,21,0,21
Gedalya,M,100,0,21,21
Genecis,F,100,21,0,21
Genifer,F,100,21,0,21
Gennavieve,F,100,21,0,21
Georgana,F,100,21,0,21
Giovanne,M,100,0,21,21
Givanni,M,100,0,21,21
Glorianne,F,100,21,0,21
Gorman,M,100,0,21,21
Griff,M,100,0,21,21
Hadli,F,100,21,0,21
Haelee,F,100,21,0,21
Halil,M,100,0,21,21
Hameed,M,100,0,21,21
Hanifah,F,100,21,0,21
Hannaley,F,100,21,0,21
Harison,M,100,0,21,21
Harsimran,F,71,15,6,21
Haynes,M,100,0,21,21
Hever,M,100,0,21,21
Hinton,M,100,0,21,21
Hopelynn,F,100,21,0,21
Huntyr,F,62,13,8,21
Icesis,F,100,21,0,21
Ilee,F,100,21,0,21
Iley,F,100,21,0,21
Ingris,F,100,21,0,21
Ioan,M,100,0,21,21
Irisa,F,100,21,0,21
Isack,M,100,0,21,21
Isaic,M,100,0,21,21
Isaiyah,M,100,0,21,21
Ison,M,100,0,21,21
Izadora,F,100,21,0,21
Izella,F,100,21,0,21
Izzie,F,100,21,0,21
Jaanai,F,100,21,0,21
Jabori,M,100,0,21,21
Jabron,M,100,0,21,21
Jadeline,F,100,21,0,21
Jaekwon,M,100,0,21,21
Jahaad,M,100,0,21,21
Jahleah,F,100,21,0,21
Jahmarion,M,100,0,21,21
Jaidev,M,100,0,21,21
Jakki,F,100,21,0,21
Jakorian,M,100,0,21,21
Jaleiah,F,100,21,0,21
Jaliel,M,100,0,21,21
Jamareon,M,100,0,21,21
Jamelyn,F,100,21,0,21
Jamilee,F,100,21,0,21
Janaia,F,100,21,0,21
Janayia,F,100,21,0,21
Jandi,F,100,21,0,21
Janmarie,F,100,21,0,21
Jareb,M,100,0,21,21
Jarielys,F,100,21,0,21
Jarious,M,100,0,21,21
Jaris,M,100,0,21,21
Jariya,F,100,21,0,21
Jashayla,F,100,21,0,21
Javares,M,100,0,21,21
Jayanth,M,100,0,21,21
Jaydalynn,F,100,21,0,21
Jayliah,F,100,21,0,21
Jaymir,M,100,0,21,21
Jaysion,M,100,0,21,21
Jazari,F,71,15,6,21
Jazzy,F,100,21,0,21
Jeaninne,F,100,21,0,21
Jedi,M,100,0,21,21
Jedrick,M,100,0,21,21
Jefte,M,100,0,21,21
Jeiden,M,100,0,21,21
Jennilee,F,100,21,0,21
Jerrol,M,100,0,21,21
Jezlyn,F,100,21,0,21
Jhade,F,100,21,0,21
Jirah,F,100,21,0,21
Jnae,F,100,21,0,21
Jodiann,F,100,21,0,21
Joeli,F,100,21,0,21
Johany,F,71,15,6,21
Johneisha,F,100,21,0,21
Johnwilliam,M,100,0,21,21
Joleene,F,100,21,0,21
Joriel,M,100,0,21,21
Joseth,M,100,0,21,21
Jovann,M,100,0,21,21
Juandavid,M,100,0,21,21
Jumar,M,100,0,21,21
Junell,F,100,21,0,21
Juvon,M,100,0,21,21
Kadeja,F,100,21,0,21
Kadien,M,100,0,21,21
Kairy,F,71,15,6,21
Kais,M,100,0,21,21
Kaleeah,F,100,21,0,21
Kalim,M,100,0,21,21
Kalix,M,100,0,21,21
Kallin,M,100,0,21,21
Kamoria,F,100,21,0,21
Kamyrah,F,100,21,0,21
Kanav,M,100,0,21,21
Kanda,F,100,21,0,21
Kang,M,57,9,12,21
Kanita,F,100,21,0,21
Karlea,F,100,21,0,21
Karolyna,F,100,21,0,21
Kasheena,F,100,21,0,21
Kassadee,F,100,21,0,21
Kataya,F,100,21,0,21
Katoya,F,100,21,0,21
Kaylenn,F,100,21,0,21
Kaymen,M,100,0,21,21
Kaysia,F,100,21,0,21
Keil,M,100,0,21,21
Keilynn,F,100,21,0,21
Kelty,F,100,21,0,21
Kelynn,F,71,15,6,21
Kemonie,F,100,21,0,21
Kenston,M,100,0,21,21
Kenzel,M,100,0,21,21
Keondria,F,100,21,0,21
Kerie,F,100,21,0,21
Ketzaly,F,100,21,0,21
Kewanda,F,100,21,0,21
Khael,M,100,0,21,21
Khameron,M,100,0,21,21
Khristin,F,100,21,0,21
Kin,M,100,0,21,21
Kino,M,100,0,21,21
Kinsie,F,100,21,0,21
Kitara,F,100,21,0,21
Klover,F,100,21,0,21
Koben,M,100,0,21,21
Koli,M,62,8,13,21
Kollyns,F,100,21,0,21
Kosisochukwu,F,76,16,5,21
Kreig,M,100,0,21,21
Krithika,F,100,21,0,21
Kru,M,100,0,21,21
Kuper,M,100,0,21,21
Kyeisha,F,100,21,0,21
Kylieann,F,100,21,0,21
Kyreese,M,100,0,21,21
Labib,M,100,0,21,21
Lache,F,100,21,0,21
Ladan,F,100,21,0,21
Lakenzie,F,100,21,0,21
Lamis,F,100,21,0,21
Lamone,M,100,0,21,21
Laporsche,F,100,21,0,21
Lashawndra,F,100,21,0,21
Lason,M,100,0,21,21
Latanga,F,100,21,0,21
Laterrica,F,100,21,0,21
Lauryl,F,100,21,0,21
Lavale,M,100,0,21,21
Lavaya,F,100,21,0,21
Lavert,M,100,0,21,21
Lavida,F,100,21,0,21
Lawsen,M,100,0,21,21
Laydon,M,100,0,21,21
Lazariah,F,100,21,0,21
Lealand,M,100,0,21,21
Leeloo,F,100,21,0,21
Leelynd,M,100,0,21,21
Leiani,F,100,21,0,21
Lennyx,F,71,15,6,21
Lenzy,M,62,8,13,21
Leomar,M,100,0,21,21
Letica,F,100,21,0,21
Levelle,M,100,0,21,21
Levette,F,100,21,0,21
Lexey,F,100,21,0,21
Leylany,F,100,21,0,21
Linc,M,100,0,21,21
Locklan,M,100,0,21,21
Lolly,F,100,21,0,21
Lonney,M,100,0,21,21
Lorenna,F,100,21,0,21
Lugenia,F,100,21,0,21
Lyberti,F,100,21,0,21
Lylie,F,100,21,0,21
Lynee,F,100,21,0,21
Machael,M,76,5,16,21
Mackay,M,100,0,21,21
Mackenzey,F,100,21,0,21
Madailein,F,100,21,0,21
Madason,F,100,21,0,21
Maddoxx,M,100,0,21,21
Madisan,F,100,21,0,21
Maela,F,100,21,0,21
Magalene,F,100,21,0,21
Magic,M,100,0,21,21
Magon,F,100,21,0,21
Mahaila,F,100,21,0,21
Majesta,F,100,21,0,21
Makelle,F,100,21,0,21
Malan,F,100,21,0,21
Maleeka,F,100,21,0,21
Malike,M,100,0,21,21
Malkia,F,100,21,0,21
Marcellino,M,100,0,21,21
Margaretann,F,100,21,0,21
Margart,F,100,21,0,21
Margeret,F,100,21,0,21
Mariabella,F,100,21,0,21
Markevius,M,100,0,21,21
Marqueze,M,100,0,21,21
Marshia,F,100,21,0,21
Martavia,F,100,21,0,21
Marvelous,M,71,6,15,21
Mashawn,M,67,7,14,21
Maudine,F,100,21,0,21
Mavric,M,100,0,21,21
Maxamilian,M,100,0,21,21
Maybel,F,100,21,0,21
Maye,F,100,21,0,21
Mayerly,F,100,21,0,21
Mayola,F,100,21,0,21
Maytte,F,100,21,0,21
Mccrae,M,100,0,21,21
Medford,M,100,0,21,21
Meital,F,100,21,0,21
Melonee,F,100,21,0,21
Merelyn,F,100,21,0,21
Miaisabella,F,100,21,0,21
Micco,M,100,0,21,21
Michaelann,F,100,21,0,21
Mico,M,100,0,21,21
Mikaele,M,100,0,21,21
Mikeria,F,100,21,0,21
Mikya,F,100,21,0,21
Milanya,F,100,21,0,21
Milea,F,100,21,0,21
Moet,F,100,21,0,21
Mohamedamin,M,100,0,21,21
Mohid,M,100,0,21,21
Montzerrat,F,100,21,0,21
Moon,F,71,15,6,21
Mordche,M,100,0,21,21
Myrle,F,62,13,8,21
Myrtha,F,100,21,0,21
Nahun,M,100,0,21,21
Najat,F,100,21,0,21
Naleigh,F,100,21,0,21
Namiah,F,100,21,0,21
Nashia,F,100,21,0,21
Naureen,F,100,21,0,21
Navdeep,M,57,9,12,21
Nayara,F,100,21,0,21
Neka,F,100,21,0,21
Neomia,F,100,21,0,21
Nesiah,F,100,21,0,21
Nesreen,F,100,21,0,21
Nethaniel,M,100,0,21,21
Nhung,F,100,21,0,21
Niajah,F,100,21,0,21
Nickola,F,100,21,0,21
Nikai,M,100,0,21,21
Nikea,F,100,21,0,21
Nikyah,F,100,21,0,21
Nimo,F,100,21,0,21
Noeh,M,100,0,21,21
Nyari,F,100,21,0,21
Nyiesha,F,100,21,0,21
Nykira,F,100,21,0,21
Oletha,F,100,21,0,21
Omni,F,100,21,0,21
Orlene,F,100,21,0,21
Osha,F,100,21,0,21
Owin,M,100,0,21,21
Oyuki,F,100,21,0,21
Paelyn,F,100,21,0,21
Pastor,M,100,0,21,21
Paytan,F,100,21,0,21
Per,M,100,0,21,21
Periann,F,100,21,0,21
Preslei,F,100,21,0,21
Prim,F,100,21,0,21
Priyal,F,100,21,0,21
Prophet,M,100,0,21,21
Puneet,F,67,14,7,21
Quasim,M,100,0,21,21
Quintavis,M,100,0,21,21
Quirino,M,100,0,21,21
Raad,M,100,0,21,21
Raileigh,F,100,21,0,21
Rainen,M,100,0,21,21
Ralf,M,100,0,21,21
Ralynn,F,100,21,0,21
Ranjit,M,100,0,21,21
Rayme,F,100,21,0,21
Raymie,F,62,13,8,21
Raynie,F,100,21,0,21
Rease,M,62,8,13,21
Rehema,F,100,21,0,21
Reisha,F,100,21,0,21
Renly,M,76,5,16,21
Retina,F,100,21,0,21
Reyana,F,100,21,0,21
Rhaya,F,100,21,0,21
Rhiannan,F,100,21,0,21
Rilynne,F,100,21,0,21
Rishawn,M,100,0,21,21
Rithwik,M,100,0,21,21
Rockell,F,100,21,0,21
Rocklyn,F,100,21,0,21
Rocquel,F,100,21,0,21
Rodrigues,M,100,0,21,21
Rohini,F,100,21,0,21
Rondey,M,100,0,21,21
Ronnae,F,100,21,0,21
Rorey,F,71,15,6,21
Roschelle,F,100,21,0,21
Rozena,F,100,21,0,21
Rukia,F,100,21,0,21
Rydan,M,100,0,21,21
Saarah,F,100,21,0,21
Saesha,F,100,21,0,21
Salimata,F,100,21,0,21
Samik,M,100,0,21,21
Samuele,M,100,0,21,21
Samuella,F,100,21,0,21
Sanari,F,100,21,0,21
Sande,F,100,21,0,21
Sanita,F,100,21,0,21
Sanjit,M,100,0,21,21
Sanjuan,M,100,0,21,21
Sanyla,F,100,21,0,21
Saqib,M,100,0,21,21
Sartaj,M,100,0,21,21
Savir,M,100,0,21,21
Saw,M,100,0,21,21
Sederick,M,100,0,21,21
Semaja,F,76,16,5,21
Serigne,M,100,0,21,21
Shacoria,F,100,21,0,21
Shadeed,M,100,0,21,21
Shakenya,F,100,21,0,21
Shanicka,F,100,21,0,21
Shannette,F,100,21,0,21
Sharel,F,100,21,0,21
Shateria,F,100,21,0,21
Shatyra,F,100,21,0,21
Shawntavia,F,100,21,0,21
Shelise,F,100,21,0,21
Sheritta,F,100,21,0,21
Shinita,F,100,21,0,21
Shion,M,76,5,16,21
Shirell,F,100,21,0,21
Shivon,F,100,21,0,21
Shuree,F,100,21,0,21
Silka,F,100,21,0,21
Sissi,F,100,21,0,21
Skyanne,F,100,21,0,21
Soffia,F,100,21,0,21
Sophiarose,F,100,21,0,21
Sriyan,M,100,0,21,21
Steen,M,100,0,21,21
Stelios,M,100,0,21,21
Stran,M,100,0,21,21
Sufian,M,100,0,21,21
Sufiyan,M,100,0,21,21
Syann,F,100,21,0,21
Sylina,F,100,21,0,21
Sylver,F,100,21,0,21
Taeshaun,M,100,0,21,21
Tahsin,M,100,0,21,21
Taiki,M,100,0,21,21
Takeyah,F,100,21,0,21
Taliana,F,100,21,0,21
Tamee,F,100,21,0,21
Tanecia,F,100,21,0,21
Taneil,F,100,21,0,21
Tangala,F,100,21,0,21
Tanica,F,100,21,0,21
Tarl,M,100,0,21,21
Tauheedah,F,100,21,0,21
Tayia,F,100,21,0,21
Teancum,M,100,0,21,21
Tecia,F,100,21,0,21
Teeya,F,100,21,0,21
Telitha,F,100,21,0,21
Tenesia,F,100,21,0,21
Terea,F,100,21,0,21
Terion,M,100,0,21,21
Terisha,F,100,21,0,21
Terriah,F,100,21,0,21
Terrilee,F,100,21,0,21
Theoren,M,100,0,21,21
Thomes,M,100,0,21,21
Tianni,F,100,21,0,21
Timea,F,100,21,0,21
Timiyah,F,100,21,0,21
Tineka,F,100,21,0,21
Toa,M,100,0,21,21
Toluwanimi,F,76,16,5,21
Tomislav,M,100,0,21,21
Tondalaya,F,100,21,0,21
Traxton,M,100,0,21,21
Treazure,F,100,21,0,21
Trevino,M,100,0,21,21
Treylan,M,100,0,21,21
Treysean,M,100,0,21,21
Trine,F,100,21,0,21
Trude,F,100,21,0,21
Trusten,M,100,0,21,21
Turhan,M,100,0,21,21
Tuyet,F,100,21,0,21
Twain,M,100,0,21,21
Tyiana,F,100,21,0,21
Tykeisha,F,100,21,0,21
Tyner,M,100,0,21,21
Tynleigh,F,100,21,0,21
Tyquavious,M,100,0,21,21
Ugochukwu,M,100,0,21,21
Valeda,F,100,21,0,21
Valera,F,100,21,0,21
Vannia,F,100,21,0,21
Varnika,F,100,21,0,21
Vasti,F,100,21,0,21
Veronia,F,100,21,0,21
Virna,F,100,21,0,21
Vitali,M,100,0,21,21
Voula,F,100,21,0,21
Wadell,M,100,0,21,21
Wagner,M,100,0,21,21
Weslynn,F,100,21,0,21
Whitt,M,100,0,21,21
Wilhemenia,F,100,21,0,21
Wille,M,100,0,21,21
Xoie,F,100,21,0,21
Yaacov,M,100,0,21,21
Yanci,F,100,21,0,21
Yandell,M,100,0,21,21
Yanick,M,57,9,12,21
Yaphet,M,100,0,21,21
Yareliz,F,100,21,0,21
Yarlin,F,100,21,0,21
Yeila,F,100,21,0,21
Yetzali,F,100,21,0,21
Yoshi,M,100,0,21,21
Ysamar,F,100,21,0,21
Zaim,M,100,0,21,21
Zaleigh,F,100,21,0,21
Zamere,M,100,0,21,21
Zasha,F,100,21,0,21
Zayli,F,100,21,0,21
Zayvien,M,100,0,21,21
Zehava,F,100,21,0,21
Zhi,M,100,0,21,21
Zhoe,F,100,21,0,21
Zohair,M,100,0,21,21
Zylee,F,100,21,0,21
Aarionna,F,100,20,0,20
Aaryana,F,100,20,0,20
Abigial,F,100,20,0,20
Abiha,F,100,20,0,20
Acquanetta,F,100,20,0,20
Addilynne,F,100,20,0,20
Adynn,M,75,5,15,20
Afra,F,100,20,0,20
Aggie,F,100,20,0,20
Ahjanae,F,100,20,0,20
Ahleah,F,100,20,0,20
Ahmia,F,100,20,0,20
Aiana,F,100,20,0,20
Ailana,F,100,20,0,20
Aily,F,100,20,0,20
Alaria,F,100,20,0,20
Alayzha,F,100,20,0,20
Alben,M,100,0,20,20
Aldyn,M,60,8,12,20
Alexandrina,F,100,20,0,20
Alieu,M,100,0,20,20
Alisen,F,100,20,0,20
Aliyaah,F,100,20,0,20
Aliyyah,F,100,20,0,20
Aliz,F,100,20,0,20
Allahna,F,100,20,0,20
Allis,F,100,20,0,20
Alliya,F,100,20,0,20
Allye,F,100,20,0,20
Alvena,F,100,20,0,20
Alvia,F,100,20,0,20
Alylah,F,100,20,0,20
Alyssha,F,100,20,0,20
Alyxander,M,100,0,20,20
Amabel,F,100,20,0,20
Amarisa,F,100,20,0,20
Amayiah,F,100,20,0,20
Amiliana,F,100,20,0,20
Amiria,F,100,20,0,20
Ammi,F,100,20,0,20
Amrie,F,100,20,0,20
Amyriah,F,100,20,0,20
Anahli,F,100,20,0,20
Anaily,F,100,20,0,20
Analeise,F,100,20,0,20
Anastaisa,F,100,20,0,20
Aniello,M,100,0,20,20
Anisten,F,100,20,0,20
Anitha,F,100,20,0,20
Annalyce,F,100,20,0,20
Anshi,F,100,20,0,20
Antario,M,100,0,20,20
Antavia,F,100,20,0,20
Anwyn,F,100,20,0,20
Aqib,M,100,0,20,20
Aquanetta,F,100,20,0,20
Arabela,F,100,20,0,20
Aracelie,F,100,20,0,20
Aradhana,F,100,20,0,20
Arafat,M,100,0,20,20
Ardelle,F,100,20,0,20
Arienna,F,100,20,0,20
Arihaan,M,100,0,20,20
Arihant,M,100,0,20,20
Arnetha,F,100,20,0,20
Arryana,F,100,20,0,20
Arshiya,F,100,20,0,20
Arta,F,100,20,0,20
Artina,F,100,20,0,20
Arty,M,100,0,20,20
Aryav,M,100,0,20,20
Asmar,M,100,0,20,20
Asmi,F,100,20,0,20
Asuncion,F,50,10,10,20
Atanacio,M,100,0,20,20
Atasha,F,100,20,0,20
Atiba,M,100,0,20,20
Audrena,F,100,20,0,20
Avaiah,F,100,20,0,20
Avrielle,F,100,20,0,20
Ayde,F,100,20,0,20
Azavier,M,100,0,20,20
Babbie,F,100,20,0,20
Bartlomiej,M,100,0,20,20
Basir,M,100,0,20,20
Batu,M,100,0,20,20
Bellagrace,F,100,20,0,20
Bemnet,M,75,5,15,20
Benjimen,M,100,0,20,20
Bentlei,F,60,12,8,20
Bernadett,F,100,20,0,20
Beyla,F,100,20,0,20
Biannca,F,100,20,0,20
Bijal,F,100,20,0,20
Billee,F,100,20,0,20
Bindi,F,100,20,0,20
Bladyn,M,100,0,20,20
Boby,M,100,0,20,20
Boss,M,100,0,20,20
Branon,M,100,0,20,20
Braxden,M,100,0,20,20
Braxdon,M,100,0,20,20
Braylea,F,100,20,0,20
Brayli,F,100,20,0,20
Breylen,M,100,0,20,20
Brinae,F,100,20,0,20
Brix,M,100,0,20,20
Bronda,F,100,20,0,20
Bryor,M,100,0,20,20
Bryttany,F,100,20,0,20
Burhan,M,100,0,20,20
Cabela,F,100,20,0,20
Caliann,F,100,20,0,20
Caliber,M,100,0,20,20
Callaghan,M,100,0,20,20
Calub,M,100,0,20,20
Camey,F,100,20,0,20
Camira,F,100,20,0,20
Candus,F,100,20,0,20
Cantrice,F,100,20,0,20
Caprisha,F,100,20,0,20
Cariann,F,100,20,0,20
Cashlyn,F,100,20,0,20
Casilda,F,100,20,0,20
Casten,M,100,0,20,20
Caty,F,100,20,0,20
Cervando,M,100,0,20,20
Chamberlain,M,100,0,20,20
Chameka,F,100,20,0,20
Chantavia,F,100,20,0,20
Chantia,F,100,20,0,20
Chesnie,F,100,20,0,20
Chibuikem,M,100,0,20,20
Chistian,M,100,0,20,20
Chon,M,100,0,20,20
Chondra,F,100,20,0,20
Chrishon,M,100,0,20,20
Chrisma,F,100,20,0,20
Christphor,M,100,0,20,20
Clyda,F,100,20,0,20
Coe,M,100,0,20,20
Corday,M,100,0,20,20
Corgan,M,100,0,20,20
Cougar,M,100,0,20,20
Courteny,F,100,20,0,20
Crystalann,F,100,20,0,20
Curtisha,F,100,20,0,20
Cyndal,F,100,20,0,20
Cyrene,F,100,20,0,20
Daizee,F,100,20,0,20
Dalissa,F,100,20,0,20
Damarri,M,100,0,20,20
Danila,F,75,15,5,20
Darianny,F,100,20,0,20
Darionna,F,100,20,0,20
Darus,M,100,0,20,20
Daryon,M,100,0,20,20
Davidjames,M,100,0,20,20
Daxtin,M,100,0,20,20
Daysen,M,100,0,20,20
Dayzee,F,100,20,0,20
Deanndra,F,100,20,0,20
Deano,M,100,0,20,20
Debraann,F,100,20,0,20
Decari,M,100,0,20,20
Declin,M,100,0,20,20
Deina,F,100,20,0,20
Delasia,F,100,20,0,20
Delorean,M,65,7,13,20
Demerius,M,100,0,20,20
Demika,F,100,20,0,20
Demitris,M,100,0,20,20
Demondre,M,100,0,20,20
Demyah,F,100,20,0,20
Denissa,F,100,20,0,20
Deondrea,F,70,14,6,20
Deontaye,M,100,0,20,20
Derryck,M,100,0,20,20
Destenie,F,100,20,0,20
Devita,F,100,20,0,20
Devontre,M,100,0,20,20
Deyonte,M,100,0,20,20
Dhanvin,M,100,0,20,20
Dianely,F,100,20,0,20
Dotti,F,100,20,0,20
Doylene,F,100,20,0,20
Dravon,M,100,0,20,20
Dutchess,F,100,20,0,20
Dyshon,M,100,0,20,20
Eeshan,M,100,0,20,20
Eilish,F,100,20,0,20
Eilyn,F,100,20,0,20
Eknoor,F,100,20,0,20
Elai,M,100,0,20,20
Elainah,F,100,20,0,20
Elayjah,F,100,20,0,20
Eleri,F,100,20,0,20
Elfego,M,100,0,20,20
Elfreda,F,100,20,0,20
Eliahs,M,100,0,20,20
Ellakate,F,100,20,0,20
Ellea,F,100,20,0,20
Ellenore,F,100,20,0,20
Elliona,F,100,20,0,20
Emeree,F,100,20,0,20
Emie,F,100,20,0,20
Emira,F,100,20,0,20
Emjay,F,70,14,6,20
Emmajo,F,100,20,0,20
Emmalou,F,100,20,0,20
Emmerich,M,100,0,20,20
Emonnie,F,100,20,0,20
English,F,100,20,0,20
Enma,F,100,20,0,20
Ephrem,M,100,0,20,20
Equilla,F,100,20,0,20
Errika,F,100,20,0,20
Esaiah,M,100,0,20,20
Evalette,F,100,20,0,20
Excell,M,100,0,20,20
Eyvette,F,100,20,0,20
Fahima,F,100,20,0,20
Falecia,F,100,20,0,20
Fauna,F,100,20,0,20
Faustine,F,100,20,0,20
Fawna,F,100,20,0,20
Federica,F,100,20,0,20
Fendi,F,100,20,0,20
Finbar,M,100,0,20,20
Foday,M,100,0,20,20
Fuquan,M,100,0,20,20
Gabrille,F,100,20,0,20
Gar,M,100,0,20,20
Gedalia,M,100,0,20,20
Geeta,F,100,20,0,20
Geisha,F,100,20,0,20
Geovonni,M,100,0,20,20
Geraldene,F,100,20,0,20
Gessica,F,100,20,0,20
Gevon,M,100,0,20,20
Grantley,M,100,0,20,20
Grayer,M,100,0,20,20
Greenly,F,100,20,0,20
Gretchyn,F,100,20,0,20
Grethel,F,100,20,0,20
Gurshan,M,100,0,20,20
Gustin,M,100,0,20,20
Gwynevere,F,100,20,0,20
Hadar,F,100,20,0,20
Halaina,F,100,20,0,20
Haliey,F,100,20,0,20
Hamida,F,100,20,0,20
Hamsa,M,100,0,20,20
Hamsini,F,100,20,0,20
Haniel,M,100,0,20,20
Happy,F,55,11,9,20
Harel,M,100,0,20,20
Harlea,F,100,20,0,20
Harmani,F,100,20,0,20
Harshitha,F,100,20,0,20
Hawwa,F,100,20,0,20
Hazely,F,100,20,0,20
Hazyl,F,100,20,0,20
Hildy,F,100,20,0,20
Huriel,M,100,0,20,20
Icker,M,100,0,20,20
Ignacia,F,100,20,0,20
Ikeisha,F,100,20,0,20
Ilham,F,100,20,0,20
Imaad,M,100,0,20,20
Imagine,F,100,20,0,20
Imre,M,100,0,20,20
Isahia,M,100,0,20,20
Isidra,F,100,20,0,20
Isobelle,F,100,20,0,20
Israella,F,100,20,0,20
Iyari,F,100,20,0,20
Izora,F,100,20,0,20
Jadaya,F,100,20,0,20
Jaely,F,100,20,0,20
Jahden,M,100,0,20,20
Jahkeem,M,100,0,20,20
Jahni,F,55,11,9,20
Jahshua,M,100,0,20,20
Jaicob,M,100,0,20,20
Jaisha,F,100,20,0,20
Jaizon,M,100,0,20,20
Jajaira,F,100,20,0,20
Jakera,F,100,20,0,20
Jakeya,F,100,20,0,20
Jakorey,M,100,0,20,20
Jalaina,F,100,20,0,20
Jalayia,F,100,20,0,20
Jalexia,F,100,20,0,20
Jamerion,M,100,0,20,20
Jamilynn,F,100,20,0,20
Janard,M,100,0,20,20
Jaquin,M,100,0,20,20
Jaretssi,F,100,20,0,20
Jarrette,M,100,0,20,20
Jasemine,F,100,20,0,20
Jasenia,F,100,20,0,20
Javanni,M,100,0,20,20
Jayjay,M,100,0,20,20
Jaymere,M,100,0,20,20
Jaysiah,M,100,0,20,20
Jazaya,F,100,20,0,20
Jazyiah,F,100,20,0,20
Jdyn,M,100,0,20,20
Jeilani,F,100,20,0,20
Jemaine,M,100,0,20,20
Jemina,F,100,20,0,20
Jenisis,F,100,20,0,20
Jeral,M,100,0,20,20
Jeramia,M,100,0,20,20
Jeramih,M,100,0,20,20
Jermeka,F,100,20,0,20
Jermond,M,100,0,20,20
Jerusalen,F,100,20,0,20
Jessaca,F,100,20,0,20
Jheri,F,100,20,0,20
Jiah,F,100,20,0,20
Jiro,M,100,0,20,20
Jmya,F,100,20,0,20
Joee,F,75,15,5,20
Joelly,F,100,20,0,20
Johanan,M,100,0,20,20
Johnay,F,100,20,0,20
Jolleen,F,100,20,0,20
Jonatha,M,100,0,20,20
Jordanny,M,100,0,20,20
Jorene,F,100,20,0,20
Joycelin,F,100,20,0,20
Jshaun,M,100,0,20,20
Juley,F,100,20,0,20
Juliahna,F,100,20,0,20
Juline,F,100,20,0,20
Juron,M,100,0,20,20
Kahleah,F,100,20,0,20
Kahleel,M,100,0,20,20
Kahmya,F,100,20,0,20
Kahron,M,100,0,20,20
Kailia,F,100,20,0,20
Kaiyla,F,100,20,0,20
Kaleiah,F,100,20,0,20
Kamarian,M,100,0,20,20
Kameo,F,100,20,0,20
Kaniel,M,100,0,20,20
Kapono,M,100,0,20,20
Karletta,F,100,20,0,20
Karynn,F,100,20,0,20
Kashay,F,100,20,0,20
Kashius,M,100,0,20,20
Kaspar,M,100,0,20,20
Kassity,F,100,20,0,20
Kataryna,F,100,20,0,20
Katesha,F,100,20,0,20
Katilin,F,100,20,0,20
Katonya,F,100,20,0,20
Kattaleya,F,100,20,0,20
Kaulana,M,100,0,20,20
Kayl,M,100,0,20,20
Keah,F,100,20,0,20
Keeana,F,100,20,0,20
Keelia,F,100,20,0,20
Keilon,M,100,0,20,20
Kelaiah,F,100,20,0,20
Keliah,F,100,20,0,20
Kellyjo,F,100,20,0,20
Kemaria,F,100,20,0,20
Kemaya,F,100,20,0,20
Kemiah,F,100,20,0,20
Kenndra,F,100,20,0,20
Kerria,F,100,20,0,20
Keshauna,F,100,20,0,20
Keyron,M,100,0,20,20
Keyshun,M,100,0,20,20
Khianna,F,100,20,0,20
Kieffer,M,100,0,20,20
Kieley,F,100,20,0,20
Kimarie,F,100,20,0,20
Kimyetta,F,100,20,0,20
Kindrick,M,100,0,20,20
Kinly,F,100,20,0,20
Kirstina,F,100,20,0,20
Kirstine,F,100,20,0,20
Kishaun,M,100,0,20,20
Kjersti,F,100,20,0,20
Kniyah,F,100,20,0,20
Kohner,M,100,0,20,20
Koleson,M,100,0,20,20
Koralynn,F,100,20,0,20
Kordae,M,100,0,20,20
Krisalyn,F,100,20,0,20
Krishav,M,100,0,20,20
Kristiann,F,100,20,0,20
Krithi,F,100,20,0,20
Kylena,F,100,20,0,20
Kyliyah,F,100,20,0,20
Kynlea,F,100,20,0,20
Kynsli,F,100,20,0,20
Lacora,F,100,20,0,20
Lacrystal,F,100,20,0,20
Laelia,F,100,20,0,20
Laikynn,F,100,20,0,20
Lamorris,M,100,0,20,20
Laneka,F,100,20,0,20
Lanyla,F,100,20,0,20
Laporche,F,100,20,0,20
Laquincy,M,100,0,20,20
Lashonne,F,100,20,0,20
Lavontay,M,100,0,20,20
Ledon,M,100,0,20,20
Leibish,M,100,0,20,20
Lejuan,M,100,0,20,20
Leor,M,100,0,20,20
Leroi,M,100,0,20,20
Lewin,M,100,0,20,20
Libbey,F,100,20,0,20
Light,M,70,6,14,20
Lilijana,F,100,20,0,20
Lilliane,F,100,20,0,20
Lilliauna,F,100,20,0,20
Lillieann,F,100,20,0,20
Lillymae,F,100,20,0,20
Lilybelle,F,100,20,0,20
Lively,F,100,20,0,20
Lj,M,100,0,20,20
Loletta,F,100,20,0,20
Lorell,F,100,20,0,20
Lourdez,F,100,20,0,20
Loveah,F,100,20,0,20
Lubertha,F,100,20,0,20
Luccas,M,100,0,20,20
Lunabella,F,100,20,0,20
Lundynn,F,100,20,0,20
Lyndsee,F,100,20,0,20
Lynnet,F,100,20,0,20
Maansi,F,100,20,0,20
Macaila,F,100,20,0,20
Macarius,M,100,0,20,20
Macguire,M,100,0,20,20
Maeley,F,100,20,0,20
Mahiya,F,100,20,0,20
Maiana,F,100,20,0,20
Maille,F,100,20,0,20
Makaiah,F,100,20,0,20
Makarios,M,100,0,20,20
Makeshia,F,100,20,0,20
Makynleigh,F,100,20,0,20
Maleiyah,F,100,20,0,20
Manjot,M,100,0,20,20
Marce,F,100,20,0,20
Mariadelaluz,F,100,20,0,20
Mariadelosang,F,100,20,0,20
Mariapaula,F,100,20,0,20
Marieme,F,100,20,0,20
Markise,M,100,0,20,20
Markiyah,F,100,20,0,20
Marlyce,F,100,20,0,20
Marquisa,F,100,20,0,20
Marquist,M,100,0,20,20
Marshayla,F,100,20,0,20
Marybella,F,100,20,0,20
Maryuri,F,100,20,0,20
Massa,F,100,20,0,20
Mateya,F,100,20,0,20
Mathan,M,100,0,20,20
Mathius,M,100,0,20,20
Matika,F,100,20,0,20
Mattalynn,F,100,20,0,20
Mauriana,F,100,20,0,20
Mckala,F,100,20,0,20
Meeghan,F,100,20,0,20
Meghen,F,100,20,0,20
Meilyn,F,100,20,0,20
Melesa,F,100,20,0,20
Melford,M,100,0,20,20
Meliton,M,100,0,20,20
Meliya,F,100,20,0,20
Miachel,M,100,0,20,20
Micaylah,F,100,20,0,20
Mikeila,F,100,20,0,20
Millee,F,100,20,0,20
Misbah,F,75,15,5,20
Mistee,F,100,20,0,20
Mohini,F,100,20,0,20
Mollyann,F,100,20,0,20
Monie,F,100,20,0,20
Monike,F,100,20,0,20
Montasia,F,100,20,0,20
Moyinoluwa,F,100,20,0,20
Myalynn,F,100,20,0,20
Mykeria,F,100,20,0,20
Mylasia,F,100,20,0,20
Nadalyn,F,100,20,0,20
Nahiem,M,100,0,20,20
Nahzir,M,100,0,20,20
Naijah,F,100,20,0,20
Nakari,M,65,7,13,20
Nakhia,F,100,20,0,20
Nakima,F,100,20,0,20
Nakul,M,100,0,20,20
Naliya,F,100,20,0,20
Navah,F,100,20,0,20
Nayib,M,100,0,20,20
Neelah,F,100,20,0,20
Neilani,F,100,20,0,20
Neiman,M,100,0,20,20
Nelma,F,100,20,0,20
Nelwyn,F,100,20,0,20
Netra,F,100,20,0,20
Nica,F,100,20,0,20
Nichlos,M,100,0,20,20
Nieve,F,100,20,0,20
Nikhita,F,100,20,0,20
Nikky,F,100,20,0,20
Nikyla,F,100,20,0,20
Nohlan,M,100,0,20,20
Nollie,F,100,20,0,20
Noretta,F,100,20,0,20
Norina,F,100,20,0,20
Nusrat,F,100,20,0,20
Nyela,F,100,20,0,20
Obi,M,100,0,20,20
Olsen,M,100,0,20,20
Oluwaferanmi,M,70,6,14,20
Omran,M,100,0,20,20
Opie,M,100,0,20,20
Oshen,M,75,5,15,20
Paarth,M,100,0,20,20
Pantelis,M,100,0,20,20
Pascha,F,100,20,0,20
Pate,M,100,0,20,20
Pegeen,F,100,20,0,20
Pema,F,100,20,0,20
Persis,F,100,20,0,20
Petula,F,100,20,0,20
Pradyun,M,100,0,20,20
Quanah,M,100,0,20,20
Quetzal,F,75,15,5,20
Quierra,F,100,20,0,20
Raechell,F,100,20,0,20
Raeshaun,M,100,0,20,20
Raisha,F,100,20,0,20
Rajendra,M,100,0,20,20
Ramar,M,100,0,20,20
Ramatoulaye,F,100,20,0,20
Ramyah,F,100,20,0,20
Randalyn,F,100,20,0,20
Randilyn,F,100,20,0,20
Ranen,M,100,0,20,20
Ranette,F,100,20,0,20
Rashauna,F,100,20,0,20
Rashied,M,100,0,20,20
Raychell,F,100,20,0,20
Raynetta,F,100,20,0,20
Raynor,M,100,0,20,20
Rayson,M,100,0,20,20
Reade,M,100,0,20,20
Redding,M,100,0,20,20
Redell,M,100,0,20,20
Refoel,M,100,0,20,20
Reilyn,F,100,20,0,20
Reneka,F,100,20,0,20
Reniah,F,100,20,0,20
Rennee,F,100,20,0,20
Reverie,F,100,20,0,20
Rhia,F,100,20,0,20
Rhiya,F,100,20,0,20
Rickell,F,100,20,0,20
Ridhima,F,100,20,0,20
Ritik,M,100,0,20,20
Roblyn,F,100,20,0,20
Roddie,M,100,0,20,20
Rolla,M,100,0,20,20
Ronada,F,100,20,0,20
Ronrico,M,100,0,20,20
Ronzell,M,100,0,20,20
Rozalia,F,100,20,0,20
Rubee,F,100,20,0,20
Rudene,F,100,20,0,20
Rydge,M,100,0,20,20
Rylend,M,100,0,20,20
Sabeen,F,100,20,0,20
Sabrea,F,100,20,0,20
Sadik,M,100,0,20,20
Saladin,M,100,0,20,20
Salia,F,100,20,0,20
Samael,M,100,0,20,20
Samarie,F,100,20,0,20
Sarahmarie,F,100,20,0,20
Satoria,F,100,20,0,20
Sebastiana,F,100,20,0,20
Sedra,F,100,20,0,20
Seger,M,100,0,20,20
Sehar,F,100,20,0,20
Selyna,F,100,20,0,20
Sem,M,100,0,20,20
Seri,F,100,20,0,20
Shabria,F,100,20,0,20
Shacara,F,100,20,0,20
Shadaya,F,100,20,0,20
Shadiamond,F,100,20,0,20
Shadie,F,100,20,0,20
Shaheim,M,100,0,20,20
Shaivi,F,100,20,0,20
Shalae,F,100,20,0,20
Shamecka,F,100,20,0,20
Shandel,F,100,20,0,20
Shaneequa,F,100,20,0,20
Shanigua,F,100,20,0,20
Shanikka,F,100,20,0,20
Shanikqua,F,100,20,0,20
Shanterria,F,100,20,0,20
Shanyce,F,100,20,0,20
Shaquinta,F,100,20,0,20
Shardai,F,100,20,0,20
Shareece,F,100,20,0,20
Sharifah,F,100,20,0,20
Sharniece,F,100,20,0,20
Shawntelle,F,100,20,0,20
Shelbe,F,100,20,0,20
Sheletha,F,100,20,0,20
Shemia,F,100,20,0,20
Shermeka,F,100,20,0,20
Shiniqua,F,100,20,0,20
Shir,F,100,20,0,20
Shoshanah,F,100,20,0,20
Shwanda,F,100,20,0,20
Shyna,F,100,20,0,20
Siddiq,M,100,0,20,20
Sidhant,M,100,0,20,20
Sierah,F,100,20,0,20
Silvino,M,100,0,20,20
Simmone,F,100,20,0,20
Simrin,F,100,20,0,20
Sindhu,F,100,20,0,20
Sircharles,M,100,0,20,20
Sireen,F,100,20,0,20
Skeeter,M,100,0,20,20
Sojourner,F,100,20,0,20
Solash,F,100,20,0,20
Solene,F,100,20,0,20
Soliyana,F,100,20,0,20
Somtochukwu,M,75,5,15,20
Sosie,F,100,20,0,20
Srihitha,F,100,20,0,20
Starleen,F,100,20,0,20
Stela,F,100,20,0,20
Subhaan,M,100,0,20,20
Subrena,F,100,20,0,20
Sufyaan,M,100,0,20,20
Suzzane,F,100,20,0,20
Syair,M,100,0,20,20
Sylvanna,F,100,20,0,20
Talayia,F,100,20,0,20
Talyia,F,100,20,0,20
Tamu,F,100,20,0,20
Tanaja,F,100,20,0,20
Tanith,F,100,20,0,20
Tank,M,100,0,20,20
Tannya,F,100,20,0,20
Tanysha,F,100,20,0,20
Taquita,F,100,20,0,20
Taraneh,F,100,20,0,20
Taraya,F,100,20,0,20
Tariya,F,100,20,0,20
Tascha,F,100,20,0,20
Tauriel,F,100,20,0,20
Taygan,F,70,14,6,20
Taysen,M,100,0,20,20
Taytem,F,100,20,0,20
Teale,F,100,20,0,20
Teejay,M,100,0,20,20
Terel,M,100,0,20,20
Teriann,F,100,20,0,20
Terius,M,100,0,20,20
Thoma,M,100,0,20,20
Thomasa,F,100,20,0,20
Thorn,M,100,0,20,20
Timothee,M,100,0,20,20
Tinzley,F,100,20,0,20
Toneka,F,100,20,0,20
Tonga,F,100,20,0,20
Tra,M,100,0,20,20
Tramain,M,100,0,20,20
Trelyn,M,100,0,20,20
Tryson,M,100,0,20,20
Tryton,M,100,0,20,20
Tyaira,F,100,20,0,20
Tyeesha,F,100,20,0,20
Tyrail,M,100,0,20,20
Tyronn,M,100,0,20,20
Tyronza,F,100,20,0,20
Tyshia,F,100,20,0,20
Tysin,M,100,0,20,20
Vahan,M,100,0,20,20
Valerian,M,100,0,20,20
Vanecia,F,100,20,0,20
Vannah,F,100,20,0,20
Verneda,F,100,20,0,20
Verta,F,100,20,0,20
Vickye,F,100,20,0,20
Vonzella,F,100,20,0,20
Wai,M,65,7,13,20
Wanette,F,100,20,0,20
Welles,M,100,0,20,20
Westlee,M,100,0,20,20
Whitleigh,F,100,20,0,20
Whittaker,M,100,0,20,20
Wilfrid,M,100,0,20,20
Witt,M,100,0,20,20
Wonder,F,100,20,0,20
Xara,F,100,20,0,20
Xavious,M,100,0,20,20
Xavy,M,100,0,20,20
Xylah,F,100,20,0,20
Yanett,F,100,20,0,20
Yaniris,F,100,20,0,20
Yarexi,F,100,20,0,20
Yekaterina,F,100,20,0,20
Yemaya,F,100,20,0,20
Yetunde,F,100,20,0,20
Yuchen,M,70,6,14,20
Yuji,M,100,0,20,20
Yunique,F,100,20,0,20
Yunis,M,100,0,20,20
Yuvonne,F,100,20,0,20
Yvonnie,F,100,20,0,20
Zacory,M,100,0,20,20
Zaharah,F,100,20,0,20
Zakarie,M,100,0,20,20
Zarahi,F,100,20,0,20
Zarai,F,100,20,0,20
Zendayah,F,100,20,0,20
Zhariah,F,100,20,0,20
Zniyah,F,100,20,0,20
Zuhayr,M,100,0,20,20
Aadan,M,100,0,19,19
Aamirah,F,100,19,0,19
Aarvi,F,100,19,0,19
Aashrith,M,100,0,19,19
Abdulhadi,M,100,0,19,19
Abrea,F,100,19,0,19
Acasia,F,100,19,0,19
Adalai,F,100,19,0,19
Adalei,F,100,19,0,19
Adante,M,100,0,19,19
Addisson,F,100,19,0,19
Addysin,F,100,19,0,19
Addysyn,F,100,19,0,19
Adhira,F,100,19,0,19
Adis,M,100,0,19,19
Adreena,F,100,19,0,19
Adwoa,F,100,19,0,19
Aerion,M,100,0,19,19
Ahlani,F,100,19,0,19
Ahmadou,M,100,0,19,19
Aison,M,100,0,19,19
Akshith,M,100,0,19,19
Akyah,F,100,19,0,19
Alamin,M,100,0,19,19
Alaycia,F,100,19,0,19
Alazar,M,100,0,19,19
Albeiro,M,100,0,19,19
Aldona,F,100,19,0,19
Aleanna,F,100,19,0,19
Aleni,F,100,19,0,19
Alizzon,F,100,19,0,19
Altariq,M,100,0,19,19
Amadea,F,100,19,0,19
Ambert,F,100,19,0,19
Amiyrah,F,100,19,0,19
Amman,M,100,0,19,19
Amrom,M,100,0,19,19
Amyr,M,100,0,19,19
Amyre,F,100,19,0,19
Anaika,F,100,19,0,19
Analei,F,100,19,0,19
Analiza,F,100,19,0,19
Analleli,F,100,19,0,19
Ananth,M,100,0,19,19
Anaysha,F,100,19,0,19
Andilyn,F,100,19,0,19
Andranik,M,100,0,19,19
Andras,M,100,0,19,19
Andrius,M,100,0,19,19
Annelie,F,100,19,0,19
Annlee,F,100,19,0,19
Antonieta,F,100,19,0,19
Antoninette,F,100,19,0,19
Anyelina,F,100,19,0,19
Aoki,F,100,19,0,19
Archit,M,100,0,19,19
Ardian,M,100,0,19,19
Areona,F,100,19,0,19
Ariyel,F,100,19,0,19
Arleny,F,100,19,0,19
Arrick,M,100,0,19,19
Arsal,M,100,0,19,19
Arshdeep,M,100,0,19,19
Artrice,F,100,19,0,19
Aruna,F,100,19,0,19
Ashtan,F,100,19,0,19
Ashyla,F,100,19,0,19
Ashyr,M,100,0,19,19
Asyah,F,100,19,0,19
Athaliah,F,100,19,0,19
Attikus,M,100,0,19,19
Atul,M,100,0,19,19
Aubriauna,F,100,19,0,19
Aubriegh,F,100,19,0,19
Aubrina,F,100,19,0,19
Aubrynn,F,100,19,0,19
Audley,M,100,0,19,19
Avabella,F,100,19,0,19
Averil,F,100,19,0,19
Aviyon,M,68,6,13,19
Awanda,F,100,19,0,19
Axten,M,100,0,19,19
Ayaansh,M,100,0,19,19
Aydden,M,100,0,19,19
Aysen,M,100,0,19,19
Ayuub,M,100,0,19,19
Ayzia,F,100,19,0,19
Azarian,M,100,0,19,19
Azharia,F,100,19,0,19
Baraka,M,74,5,14,19
Barbarann,F,100,19,0,19
Beecher,M,100,0,19,19
Belanna,F,100,19,0,19
Benedetta,F,100,19,0,19
Benno,M,100,0,19,19
Bensyn,M,100,0,19,19
Bereket,M,100,0,19,19
Bertrum,M,100,0,19,19
Bethzaida,F,100,19,0,19
Bhavana,F,100,19,0,19
Biviana,F,100,19,0,19
Blia,F,100,19,0,19
Brason,M,100,0,19,19
Brayah,F,100,19,0,19
Brazen,M,100,0,19,19
Breeona,F,100,19,0,19
Breeonna,F,100,19,0,19
Brei,F,100,19,0,19
Brenetta,F,100,19,0,19
Bristyn,F,100,19,0,19
Brittanni,F,100,19,0,19
Broghan,M,68,6,13,19
Brytney,F,100,19,0,19
Buffi,F,100,19,0,19
Caily,F,100,19,0,19
Calaya,F,100,19,0,19
Calvary,F,74,14,5,19
Cambren,M,100,0,19,19
Camelle,F,100,19,0,19
Candence,F,100,19,0,19
Caoilainn,F,100,19,0,19
Carliyah,F,100,19,0,19
Carnita,F,100,19,0,19
Carols,M,100,0,19,19
Carrina,F,100,19,0,19
Catalia,F,100,19,0,19
Cathan,M,100,0,19,19
Cedrik,M,100,0,19,19
Chadwin,M,100,0,19,19
Chakira,F,100,19,0,19
Chananya,M,100,0,19,19
Chancie,F,100,19,0,19
Chantry,M,100,0,19,19
Chapel,F,74,14,5,19
Charan,M,100,0,19,19
Charlissa,F,100,19,0,19
Chassie,F,100,19,0,19
Chenille,F,100,19,0,19
Christasia,F,100,19,0,19
Chukwuma,M,100,0,19,19
Chung,M,100,0,19,19
Ciearra,F,100,19,0,19
Cimone,F,100,19,0,19
Clide,M,100,0,19,19
Clydia,F,100,19,0,19
Cordarious,M,100,0,19,19
Costella,F,100,19,0,19
Crickett,F,100,19,0,19
Cylinda,F,100,19,0,19
Cyndra,F,100,19,0,19
Dahiana,F,100,19,0,19
Daimien,M,100,0,19,19
Daken,M,100,0,19,19
Dali,F,63,12,7,19
Damyiah,F,100,19,0,19
Danali,F,100,19,0,19
Danarius,M,100,0,19,19
Danford,M,100,0,19,19
Dannae,F,100,19,0,19
Darinda,F,100,19,0,19
Darrelyn,F,100,19,0,19
Dashonda,F,100,19,0,19
Davinia,F,100,19,0,19
Dayanne,F,100,19,0,19
Dayshia,F,100,19,0,19
Dayyan,M,100,0,19,19
Deakin,M,100,0,19,19
Debbe,F,100,19,0,19
Deepti,F,100,19,0,19
Deidrea,F,100,19,0,19
Dejane,F,100,19,0,19
Deke,M,100,0,19,19
Deloras,F,100,19,0,19
Demere,M,100,0,19,19
Demetrion,M,100,0,19,19
Denah,F,100,19,0,19
Denetta,F,100,19,0,19
Denorris,M,100,0,19,19
Deondrick,M,100,0,19,19
Derra,F,100,19,0,19
Deshayla,F,100,19,0,19
Dessiree,F,100,19,0,19
Desyre,F,100,19,0,19
Devarius,M,100,0,19,19
Deveney,F,100,19,0,19
Diala,F,100,19,0,19
Dianca,F,100,19,0,19
Dilcia,F,100,19,0,19
Dimetrius,M,100,0,19,19
Djimon,M,100,0,19,19
Dniya,F,100,19,0,19
Dolce,F,100,19,0,19
Dolph,M,100,0,19,19
Dondrell,M,100,0,19,19
Doy,M,100,0,19,19
Draken,M,100,0,19,19
Drako,M,100,0,19,19
Dreydon,M,100,0,19,19
Dynver,F,100,19,0,19
Earma,F,100,19,0,19
Ebbie,F,53,10,9,19
Edeline,F,100,19,0,19
Edmar,M,100,0,19,19
Edye,F,100,19,0,19
Elaura,F,100,19,0,19
Elaya,F,100,19,0,19
Elesa,F,100,19,0,19
Elester,M,100,0,19,19
Elijan,M,100,0,19,19
Ellyce,F,100,19,0,19
Elody,F,100,19,0,19
Elwanda,F,100,19,0,19
Elyon,M,100,0,19,19
Elyzah,F,100,19,0,19
Emanie,F,100,19,0,19
Emelynn,F,100,19,0,19
Emilliano,M,100,0,19,19
Emit,M,100,0,19,19
Emmaleah,F,100,19,0,19
Enyla,F,100,19,0,19
Erskin,M,100,0,19,19
Ervey,M,100,0,19,19
Eustacia,F,100,19,0,19
Evalin,F,100,19,0,19
Evelyna,F,100,19,0,19
Evvie,F,100,19,0,19
Eyoel,M,100,0,19,19
Faysal,M,100,0,19,19
Finnlee,M,53,9,10,19
Fionnuala,F,100,19,0,19
Florie,F,100,19,0,19
Franchot,M,100,0,19,19
Frankey,M,100,0,19,19
Fredrich,M,100,0,19,19
Frisco,M,100,0,19,19
Gamble,M,100,0,19,19
Geanie,F,100,19,0,19
Gelena,F,100,19,0,19
Genavie,F,100,19,0,19
Gerado,M,100,0,19,19
Gerardine,F,100,19,0,19
Gerrett,M,100,0,19,19
Gianlucas,M,100,0,19,19
Gilmar,M,100,0,19,19
Gordy,M,100,0,19,19
Graciemae,F,100,19,0,19
Guiselle,F,100,19,0,19
Guled,M,100,0,19,19
Gurney,M,100,0,19,19
Gyan,M,100,0,19,19
Haely,F,100,19,0,19
Haeven,F,74,14,5,19
Haevyn,F,100,19,0,19
Haliyah,F,100,19,0,19
Hamda,F,100,19,0,19
Harrington,M,100,0,19,19
Hassani,M,100,0,19,19
Hassel,M,100,0,19,19
Hassen,M,100,0,19,19
Hawthorne,M,100,0,19,19
Haylyn,F,100,19,0,19
Heloise,F,100,19,0,19
Henslee,F,100,19,0,19
Hiep,M,100,0,19,19
Hiromi,F,100,19,0,19
Hollace,F,100,19,0,19
Hydie,F,100,19,0,19
Hyla,F,100,19,0,19
Icelynn,F,100,19,0,19
Ilija,M,100,0,19,19
Ilina,F,100,19,0,19
Indalecio,M,100,0,19,19
Irine,F,100,19,0,19
Irl,M,100,0,19,19
Irven,M,100,0,19,19
Irys,F,100,19,0,19
Isaid,M,100,0,19,19
Isais,M,100,0,19,19
Isaul,M,100,0,19,19
Iseah,M,100,0,19,19
Isebella,F,100,19,0,19
Ithan,M,100,0,19,19
Itsel,F,100,19,0,19
Izaih,M,100,0,19,19
Jabri,M,100,0,19,19
Jacaden,M,100,0,19,19
Jackolyn,F,100,19,0,19
Jadesola,F,100,19,0,19
Jady,F,100,19,0,19
Jahbari,M,100,0,19,19
Jahmad,M,100,0,19,19
Jahnvi,F,100,19,0,19
Jahred,M,100,0,19,19
Jaielle,F,100,19,0,19
Jailani,F,100,19,0,19
Jakirah,F,100,19,0,19
Jakita,F,100,19,0,19
Jalayna,F,100,19,0,19
Jalyiah,F,100,19,0,19
Jalyric,F,100,19,0,19
Jamarien,M,100,0,19,19
Jamason,M,100,0,19,19
Jamekia,F,100,19,0,19
Jamesyn,F,58,11,8,19
Jamicah,M,100,0,19,19
Jamilett,F,100,19,0,19
Janace,F,100,19,0,19
Janaki,F,100,19,0,19
Janaysia,F,100,19,0,19
Janei,F,100,19,0,19
Janele,F,100,19,0,19
Janeshia,F,100,19,0,19
Jareli,F,100,19,0,19
Jasaun,M,100,0,19,19
Jasneet,F,100,19,0,19
Jasraj,M,100,0,19,19
Jathen,M,100,0,19,19
Jauan,M,100,0,19,19
Jawanda,F,100,19,0,19
Jaxxson,M,100,0,19,19
Jaylena,F,100,19,0,19
Jaysten,M,100,0,19,19
Jaystin,M,100,0,19,19
Jazayah,F,100,19,0,19
Jazzlene,F,100,19,0,19
Jazzman,F,100,19,0,19
Jehiel,M,100,0,19,19
Jenafer,F,100,19,0,19
Jenipher,F,100,19,0,19
Jennfer,F,100,19,0,19
Jep,M,100,0,19,19
Jermiya,F,100,19,0,19
Jerris,M,100,0,19,19
Jerryl,M,100,0,19,19
Jesselle,F,100,19,0,19
Jessenya,F,100,19,0,19
Jette,F,68,13,6,19
Jewelianna,F,100,19,0,19
Jhovanny,M,100,0,19,19
Jillianna,F,100,19,0,19
Jillyn,F,100,19,0,19
Jishnu,M,100,0,19,19
Jiwoo,F,74,14,5,19
Joaquina,F,100,19,0,19
Jocey,F,100,19,0,19
Johnella,F,100,19,0,19
Johntavious,M,100,0,19,19
Joliana,F,100,19,0,19
Jolynda,F,100,19,0,19
Jonay,F,100,19,0,19
Jonika,F,100,19,0,19
Jontel,M,58,8,11,19
Jordane,F,100,19,0,19
Jordis,F,100,19,0,19
Jorryn,F,63,12,7,19
Joscelynn,F,100,19,0,19
Josepha,F,100,19,0,19
Joshia,M,100,0,19,19
Jossette,F,100,19,0,19
Jovonte,M,100,0,19,19
Joylene,F,100,19,0,19
Jozey,F,100,19,0,19
Jozy,F,74,14,5,19
Judene,F,100,19,0,19
Juliya,F,100,19,0,19
Jyden,M,100,0,19,19
Kaelynne,F,100,19,0,19
Kahlee,F,74,14,5,19
Kaho,F,100,19,0,19
Kaikea,M,100,0,19,19
Kaiyden,M,100,0,19,19
Kajuana,F,100,19,0,19
Kalvyn,M,100,0,19,19
Kamee,F,100,19,0,19
Karle,M,74,5,14,19
Karmela,F,100,19,0,19
Kashae,F,100,19,0,19
Kassadie,F,100,19,0,19
Katalena,F,100,19,0,19
Katelee,F,100,19,0,19
Katheen,F,100,19,0,19
Katleen,F,100,19,0,19
Kaydra,F,100,19,0,19
Kaylem,M,100,0,19,19
Kayliee,F,100,19,0,19
Kaysey,F,100,19,0,19
Kayvan,M,100,0,19,19
Kayzlee,F,100,19,0,19
Kaziyah,F,100,19,0,19
Kebin,M,100,0,19,19
Keigo,M,100,0,19,19
Keimon,M,100,0,19,19
Keiston,M,100,0,19,19
Kema,F,100,19,0,19
Kemara,F,100,19,0,19
Kendryck,M,100,0,19,19
Kevia,F,100,19,0,19
Keyunna,F,100,19,0,19
Keziyah,F,100,19,0,19
Khady,F,100,19,0,19
Khaylee,F,100,19,0,19
Khyli,F,100,19,0,19
Khyron,M,100,0,19,19
Kielan,M,100,0,19,19
Kili,F,100,19,0,19
Kingdom,M,100,0,19,19
Kinze,F,100,19,0,19
Kirbie,F,100,19,0,19
Kiriana,F,100,19,0,19
Kista,F,100,19,0,19
Knolan,M,100,0,19,19
Kodah,M,100,0,19,19
Koden,M,100,0,19,19
Konor,M,100,0,19,19
Korby,M,100,0,19,19
Korea,F,100,19,0,19
Kraven,M,100,0,19,19
Krisna,F,63,12,7,19
Kron,M,100,0,19,19
Kumari,F,74,14,5,19
Kunj,M,100,0,19,19
Kyiesha,F,100,19,0,19
Labarron,M,100,0,19,19
Lacharles,M,100,0,19,19
Lacoya,F,100,19,0,19
Ladavion,M,100,0,19,19
Ladean,F,100,19,0,19
Laekyn,F,100,19,0,19
Lakaisha,F,100,19,0,19
Lakeithia,F,100,19,0,19
Lamara,F,100,19,0,19
Lamoni,F,63,12,7,19
Lanorris,M,100,0,19,19
Laprecious,F,100,19,0,19
Larin,F,58,11,8,19
Larose,F,100,19,0,19
Larz,M,100,0,19,19
Latayna,F,100,19,0,19
Laval,M,100,0,19,19
Laylamarie,F,100,19,0,19
Leahmarie,F,100,19,0,19
Leanah,F,100,19,0,19
Leba,F,100,19,0,19
Leiam,M,100,0,19,19
Lella,F,100,19,0,19
Letroy,M,100,0,19,19
Levetta,F,100,19,0,19
Lewie,M,100,0,19,19
Lexandra,F,100,19,0,19
Leyani,F,100,19,0,19
Liadan,F,100,19,0,19
Liala,F,100,19,0,19
Lianah,F,100,19,0,19
Liese,F,100,19,0,19
Life,M,68,6,13,19
Lige,M,100,0,19,19
Liliani,F,100,19,0,19
Lilliona,F,100,19,0,19
Linea,F,100,19,0,19
Lisia,F,100,19,0,19
Lizzett,F,100,19,0,19
Lochlin,M,100,0,19,19
Loney,M,100,0,19,19
Loranda,F,100,19,0,19
Lowery,M,100,0,19,19
Lui,M,100,0,19,19
Lunabelle,F,100,19,0,19
Luwanda,F,100,19,0,19
Lydian,F,100,19,0,19
Lynnmarie,F,100,19,0,19
Maahir,M,100,0,19,19
Macala,F,100,19,0,19
Macauley,M,100,0,19,19
Maddeline,F,100,19,0,19
Maddock,M,100,0,19,19
Madyx,M,100,0,19,19
Maebel,F,100,19,0,19
Magdelyn,F,100,19,0,19
Mahrosh,F,100,19,0,19
Mahsa,F,100,19,0,19
Maikol,M,100,0,19,19
Makaelah,F,100,19,0,19
Makail,M,100,0,19,19
Makella,F,100,19,0,19
Makenize,F,100,19,0,19
Malai,F,100,19,0,19
Malayjah,F,100,19,0,19
Maleiya,F,100,19,0,19
Mando,M,100,0,19,19
Manhattan,F,100,19,0,19
Marcelia,F,100,19,0,19
Margalit,F,100,19,0,19
Mariaha,F,100,19,0,19
Markice,M,100,0,19,19
Marqual,M,100,0,19,19
Marsalis,M,100,0,19,19
Marshella,F,100,19,0,19
Maxum,M,100,0,19,19
Mayana,F,100,19,0,19
Mayling,F,100,19,0,19
Maylon,M,100,0,19,19
Maziah,F,74,14,5,19
Mcguire,M,100,0,19,19
Medea,F,100,19,0,19
Meer,M,100,0,19,19
Meilah,F,100,19,0,19
Mekala,F,100,19,0,19
Meral,F,100,19,0,19
Meria,F,100,19,0,19
Merranda,F,100,19,0,19
Merryl,F,100,19,0,19
Michaeleen,F,100,19,0,19
Michalina,F,100,19,0,19
Mickell,M,100,0,19,19
Mieko,F,100,19,0,19
Mikiel,M,100,0,19,19
Milas,M,100,0,19,19
Millennium,F,100,19,0,19
Mireyah,F,100,19,0,19
Momoka,F,100,19,0,19
Montia,F,100,19,0,19
Montrey,M,100,0,19,19
Moorea,F,100,19,0,19
Morayo,F,100,19,0,19
Mori,F,74,14,5,19
Mortimer,M,100,0,19,19
Moss,M,100,0,19,19
Muzammil,M,100,0,19,19
Myya,F,100,19,0,19
Naasia,F,100,19,0,19
Nadelyn,F,100,19,0,19
Nailani,F,100,19,0,19
Nakaylah,F,100,19,0,19
Nakea,F,100,19,0,19
Naketa,F,100,19,0,19
Nashea,F,100,19,0,19
Nashton,M,100,0,19,19
Nastacia,F,100,19,0,19
Nataleah,F,100,19,0,19
Naydeen,F,100,19,0,19
Nayellie,F,100,19,0,19
Nayson,M,100,0,19,19
Nazli,F,100,19,0,19
Neaveh,F,100,19,0,19
Necola,F,100,19,0,19
Neira,F,100,19,0,19
Nelva,F,100,19,0,19
Nemesis,F,100,19,0,19
Niana,F,100,19,0,19
Nicholl,F,100,19,0,19
Nickia,F,100,19,0,19
Nieshia,F,100,19,0,19
Nikaya,F,100,19,0,19
Nilmar,M,100,0,19,19
Niza,F,100,19,0,19
Nonie,F,100,19,0,19
Nyima,F,100,19,0,19
Nyomie,F,100,19,0,19
Odai,M,100,0,19,19
Ohana,F,100,19,0,19
Oliviarose,F,100,19,0,19
Ollin,M,100,0,19,19
Omarie,M,100,0,19,19
Oneill,M,100,0,19,19
Otisha,F,100,19,0,19
Pachia,F,100,19,0,19
Paeyton,F,100,19,0,19
Paije,F,100,19,0,19
Paislea,F,100,19,0,19
Paticia,F,100,19,0,19
Pattiann,F,100,19,0,19
Peityn,F,100,19,0,19
Pelin,F,100,19,0,19
Pietra,F,100,19,0,19
Qianna,F,100,19,0,19
Quashaun,M,100,0,19,19
Quynh,F,100,19,0,19
Racquelle,F,100,19,0,19
Rafan,M,100,0,19,19
Raffael,M,100,0,19,19
Ragnar,M,100,0,19,19
Ramiz,M,100,0,19,19
Rankin,M,100,0,19,19
Raphel,M,100,0,19,19
Raquell,F,100,19,0,19
Rashada,F,100,19,0,19
Rashiya,F,100,19,0,19
Rayansh,M,100,0,19,19
Rayen,F,74,14,5,19
Raysa,F,100,19,0,19
Rayshell,F,100,19,0,19
Reah,F,100,19,0,19
Reeda,F,100,19,0,19
Reigna,F,100,19,0,19
Remiel,M,100,0,19,19
Remon,M,100,0,19,19
Rendon,M,100,0,19,19
Rhone,M,100,0,19,19
Rhyen,F,68,13,6,19
Riannon,F,100,19,0,19
Richar,M,100,0,19,19
Ricquel,F,100,19,0,19
Ritaj,F,100,19,0,19
Rodina,F,100,19,0,19
Ronata,F,100,19,0,19
Ronnel,M,100,0,19,19
Ronon,M,100,0,19,19
Ruxin,M,100,0,19,19
Ryce,M,100,0,19,19
Ryelynn,F,100,19,0,19
Ryoma,M,100,0,19,19
Ryzen,M,100,0,19,19
Sady,F,100,19,0,19
Sahvanna,F,100,19,0,19
Saim,M,100,0,19,19
Samaa,F,100,19,0,19
Sanaz,F,100,19,0,19
Sandon,M,100,0,19,19
Sarajean,F,100,19,0,19
Sareen,F,100,19,0,19
Saryiah,F,100,19,0,19
Savva,M,100,0,19,19
Sayyid,M,100,0,19,19
Schon,M,100,0,19,19
Seher,F,100,19,0,19
Seleen,F,100,19,0,19
Semisi,M,100,0,19,19
Seniya,F,100,19,0,19
Sequita,F,100,19,0,19
Sevag,M,100,0,19,19
Shadana,F,100,19,0,19
Shadee,F,53,10,9,19
Shafer,M,100,0,19,19
Shahidah,F,100,19,0,19
Shahin,M,100,0,19,19
Shajuana,F,100,19,0,19
Shakeitha,F,100,19,0,19
Shakirra,F,100,19,0,19
Shallon,F,100,19,0,19
Shanequia,F,100,19,0,19
Shanesha,F,100,19,0,19
Shantara,F,100,19,0,19
Sharea,F,100,19,0,19
Sharley,F,100,19,0,19
Sharren,F,100,19,0,19
Shatima,F,100,19,0,19
Shaunie,F,100,19,0,19
Shawnise,F,100,19,0,19
Shayanna,F,100,19,0,19
Sheanna,F,100,19,0,19
Shelvia,F,100,19,0,19
Shelvy,F,74,14,5,19
Sherolyn,F,100,19,0,19
Sherrelle,F,100,19,0,19
Sherrika,F,100,19,0,19
Sherrilynn,F,100,19,0,19
Shyheem,M,100,0,19,19
Shylia,F,100,19,0,19
Sidonie,F,100,19,0,19
Silvina,F,100,19,0,19
Siniyah,F,100,19,0,19
Sinthia,F,100,19,0,19
Sisira,F,100,19,0,19
Slaton,M,100,0,19,19
Slayden,M,100,0,19,19
Smitty,M,100,0,19,19
Sophiana,F,100,19,0,19
Sosha,F,100,19,0,19
Soundra,F,100,19,0,19
Stalin,M,100,0,19,19
Stepfon,M,100,0,19,19
Suleman,M,100,0,19,19
Syrina,F,100,19,0,19
Tabathia,F,100,19,0,19
Tabbetha,F,100,19,0,19
Tabius,M,100,0,19,19
Taeden,M,100,0,19,19
Tagen,M,63,7,12,19
Taiesha,F,100,19,0,19
Taisei,M,100,0,19,19
Takera,F,100,19,0,19
Taleisha,F,100,19,0,19
Talton,M,100,0,19,19
Tamaira,F,100,19,0,19
Tanesia,F,100,19,0,19
Tangelia,F,100,19,0,19
Taray,M,100,0,19,19
Tarick,M,100,0,19,19
Taseen,M,100,0,19,19
Tashiba,F,100,19,0,19
Taunia,F,100,19,0,19
Tavionna,F,100,19,0,19
Tayo,M,100,0,19,19
Teaya,F,100,19,0,19
Tehran,M,100,0,19,19
Tejay,M,100,0,19,19
Tell,M,100,0,19,19
Telma,F,100,19,0,19
Tenea,F,100,19,0,19
Tenicia,F,100,19,0,19
Tenishia,F,100,19,0,19
Thailan,M,100,0,19,19
Thalya,F,100,19,0,19
Theordore,M,100,0,19,19
Thienan,M,58,8,11,19
Timo,M,100,0,19,19
Tiwanda,F,100,19,0,19
Tonimarie,F,100,19,0,19
Tonyetta,F,100,19,0,19
Torrion,M,100,0,19,19
Travone,M,100,0,19,19
Travonne,M,100,0,19,19
Tremond,M,100,0,19,19
Trenee,F,100,19,0,19
Trestan,M,100,0,19,19
Trevonne,M,100,0,19,19
Treyven,M,100,0,19,19
Truxton,M,100,0,19,19
Trypp,M,100,0,19,19
Tuck,M,100,0,19,19
Tuwanna,F,100,19,0,19
Tyjah,F,100,19,0,19
Tyrhonda,F,100,19,0,19
Tyrina,F,100,19,0,19
Tyteanna,F,100,19,0,19
Tywaun,M,100,0,19,19
Tywone,M,100,0,19,19
Uchechukwu,M,68,6,13,19
Ugonna,M,100,0,19,19
Valeen,F,100,19,0,19
Vanden,M,100,0,19,19
Vasili,M,100,0,19,19
Verita,F,100,19,0,19
Verlena,F,100,19,0,19
Via,F,100,19,0,19
Vienne,F,100,19,0,19
Vishaal,M,100,0,19,19
Viyan,M,100,0,19,19
Wrangler,M,100,0,19,19
Xayvier,M,100,0,19,19
Xhaiden,M,100,0,19,19
Xyon,M,100,0,19,19
Yamato,M,100,0,19,19
Yaretsi,F,100,19,0,19
Yatzary,F,100,19,0,19
Yazmyn,F,100,19,0,19
Yesli,F,100,19,0,19
Yihan,F,68,13,6,19
Yiselle,F,100,19,0,19
Yita,F,100,19,0,19
Yoali,F,100,19,0,19
Yzabelle,F,100,19,0,19
Zackeriah,M,100,0,19,19
Zackrey,M,100,0,19,19
Zae,M,100,0,19,19
Zael,M,100,0,19,19
Zafar,M,100,0,19,19
Zahki,M,100,0,19,19
Zamani,F,68,13,6,19
Zaydrian,M,100,0,19,19
Zayven,M,100,0,19,19
Zelene,F,100,19,0,19
Zerina,F,100,19,0,19
Zoeann,F,100,19,0,19
Zyann,F,100,19,0,19
Zyrell,M,100,0,19,19
Aadin,M,100,0,18,18
Aala,F,100,18,0,18
Aalaya,F,100,18,0,18
Aara,F,100,18,0,18
Aarianna,F,100,18,0,18
Abdo,M,100,0,18,18
Adalay,F,100,18,0,18
Adalea,F,100,18,0,18
Addaline,F,100,18,0,18
Ademola,M,100,0,18,18
Adisson,F,100,18,0,18
Admir,M,100,0,18,18
Adonias,M,100,0,18,18
Adriell,M,100,0,18,18
Adriena,F,100,18,0,18
Aelyn,F,100,18,0,18
Aeric,M,100,0,18,18
Ahilyn,F,100,18,0,18
Ahmar,M,100,0,18,18
Ahnya,F,100,18,0,18
Aidah,F,100,18,0,18
Ailine,F,100,18,0,18
Ajahni,M,100,0,18,18
Akaylah,F,100,18,0,18
Akon,M,72,5,13,18
Akylah,F,100,18,0,18
Alazia,F,100,18,0,18
Albi,M,100,0,18,18
Aleayah,F,100,18,0,18
Aleria,F,100,18,0,18
Alezandra,F,100,18,0,18
Aliahna,F,100,18,0,18
Aliani,F,100,18,0,18
Alic,M,100,0,18,18
Alicya,F,100,18,0,18
Alizey,F,100,18,0,18
Allean,F,100,18,0,18
Alto,M,100,0,18,18
Alucard,M,100,0,18,18
Alyanah,F,100,18,0,18
Alyas,M,100,0,18,18
Alyze,F,100,18,0,18
Amand,F,100,18,0,18
Amandalynn,F,100,18,0,18
Amarien,M,100,0,18,18
Amariyana,F,100,18,0,18
Ambriella,F,100,18,0,18
Ameliyah,F,100,18,0,18
Ameri,F,100,18,0,18
Amoree,F,100,18,0,18
Amyrie,F,100,18,0,18
Anahit,F,100,18,0,18
Andri,M,100,0,18,18
Aneka,F,100,18,0,18
Anelisse,F,100,18,0,18
Anetta,F,100,18,0,18
Anice,F,100,18,0,18
Aniken,M,100,0,18,18
Anneth,F,100,18,0,18
Anola,F,100,18,0,18
Antavius,M,100,0,18,18
Anterrio,M,100,0,18,18
Apoorva,F,100,18,0,18
Arelie,F,100,18,0,18
Ariyannah,F,100,18,0,18
Armahni,F,67,12,6,18
Arshi,F,100,18,0,18
Artesia,F,100,18,0,18
Arthor,M,100,0,18,18
Asaf,M,100,0,18,18
Asjah,F,100,18,0,18
Aspasia,F,100,18,0,18
Atisha,F,100,18,0,18
Augusten,M,100,0,18,18
Avangelina,F,100,18,0,18
Avannah,F,100,18,0,18
Avianca,F,100,18,0,18
Avilyn,F,100,18,0,18
Aviraj,M,100,0,18,18
Avish,M,100,0,18,18
Ayaz,M,100,0,18,18
Aycen,M,100,0,18,18
Aydia,F,100,18,0,18
Aydn,M,100,0,18,18
Ayssa,F,100,18,0,18
Aythan,M,100,0,18,18
Azam,M,100,0,18,18
Azhane,F,100,18,0,18
Azir,M,100,0,18,18
Baelynn,F,100,18,0,18
Bailen,M,100,0,18,18
Bard,M,100,0,18,18
Bardia,M,100,0,18,18
Bayah,F,100,18,0,18
Baze,M,100,0,18,18
Bb,M,100,0,18,18
Bellatrix,F,100,18,0,18
Beniah,M,100,0,18,18
Beonca,F,100,18,0,18
Berklie,F,100,18,0,18
Berneta,F,100,18,0,18
Beverely,F,100,18,0,18
Bianna,F,100,18,0,18
Biff,M,100,0,18,18
Biruk,M,100,0,18,18
Bobbyjo,F,100,18,0,18
Bon,M,100,0,18,18
Braidan,M,100,0,18,18
Braileigh,F,100,18,0,18
Brasen,M,100,0,18,18
Braxxton,M,100,0,18,18
Braylei,F,100,18,0,18
Breawna,F,100,18,0,18
Brenasia,F,100,18,0,18
Brenya,F,100,18,0,18
Bresha,F,100,18,0,18
Bricelyn,F,100,18,0,18
Briea,F,100,18,0,18
Briggitte,F,100,18,0,18
Brightyn,F,100,18,0,18
Briselda,F,100,18,0,18
Britanee,F,100,18,0,18
Britian,M,72,5,13,18
Britnay,F,100,18,0,18
Brynnan,F,100,18,0,18
Brysten,M,100,0,18,18
Caci,F,100,18,0,18
Caffie,F,100,18,0,18
Cait,F,100,18,0,18
Camylle,F,100,18,0,18
Cannan,M,100,0,18,18
Carinna,F,100,18,0,18
Carlia,F,100,18,0,18
Carney,M,100,0,18,18
Cassadi,F,100,18,0,18
Castin,M,100,0,18,18
Catalyna,F,100,18,0,18
Cayleen,F,100,18,0,18
Caylei,F,100,18,0,18
Caz,M,100,0,18,18
Celenia,F,100,18,0,18
Chakia,F,100,18,0,18
Charlane,F,100,18,0,18
Charls,M,100,0,18,18
Charnay,F,100,18,0,18
Chaslyn,F,100,18,0,18
Chaylee,F,100,18,0,18
Chelsei,F,100,18,0,18
Cheralyn,F,100,18,0,18
Cherica,F,100,18,0,18
Cheryal,F,100,18,0,18
Chigozie,M,100,0,18,18
Chrishonda,F,100,18,0,18
Christiona,F,100,18,0,18
Christorpher,M,100,0,18,18
Christyl,F,100,18,0,18
Cierria,F,100,18,0,18
Clodagh,F,100,18,0,18
Con,M,100,0,18,18
Confesor,M,100,0,18,18
Connery,M,100,0,18,18
Corabelle,F,100,18,0,18
Coutney,F,100,18,0,18
Cybele,F,100,18,0,18
Daebreon,F,72,13,5,18
Daionna,F,100,18,0,18
Daishon,M,100,0,18,18
Daleyssa,F,100,18,0,18
Damyra,F,100,18,0,18
Danaisha,F,100,18,0,18
Danaysha,F,100,18,0,18
Danijah,F,100,18,0,18
Dariusz,M,100,0,18,18
Darrall,M,100,0,18,18
Darrik,M,100,0,18,18
Darryel,M,100,0,18,18
Dashanique,F,100,18,0,18
Davanna,F,100,18,0,18
Davidlee,M,100,0,18,18
Daymeon,M,100,0,18,18
Daysie,F,100,18,0,18
Dazaria,F,100,18,0,18
Deania,F,100,18,0,18
Deasiah,F,100,18,0,18
Deerica,F,100,18,0,18
Deia,F,100,18,0,18
Dejia,F,100,18,0,18
Delainee,F,100,18,0,18
Deleyza,F,100,18,0,18
Demeshia,F,100,18,0,18
Denica,F,100,18,0,18
Dervin,M,100,0,18,18
Deshae,F,100,18,0,18
Deshane,M,100,0,18,18
Desree,F,100,18,0,18
Deveny,F,100,18,0,18
Devony,F,100,18,0,18
Deyona,F,100,18,0,18
Dhaval,M,100,0,18,18
Dhruti,F,100,18,0,18
Dianey,F,100,18,0,18
Dicie,F,100,18,0,18
Dimitria,F,100,18,0,18
Dimitrious,M,100,0,18,18
Dmichael,M,100,0,18,18
Dnyla,F,100,18,0,18
Donnalynn,F,100,18,0,18
Dorann,F,100,18,0,18
Dorismar,F,100,18,0,18
Dorma,F,100,18,0,18
Dorri,F,100,18,0,18
Dorrien,M,100,0,18,18
Draylen,M,100,0,18,18
Durham,M,100,0,18,18
Duriel,M,100,0,18,18
Dyquan,M,100,0,18,18
Edana,F,100,18,0,18
Edynn,F,100,18,0,18
Eilam,M,100,0,18,18
Eilis,F,100,18,0,18
Ekansh,M,100,0,18,18
Elany,F,100,18,0,18
Elaria,F,100,18,0,18
Elber,M,100,0,18,18
Elbony,F,100,18,0,18
Eleisha,F,100,18,0,18
Elizibeth,F,100,18,0,18
Ellan,F,100,18,0,18
Ellene,F,100,18,0,18
Ellianne,F,100,18,0,18
Emilian,M,100,0,18,18
Emilina,F,100,18,0,18
Emmamarie,F,100,18,0,18
Emmer,F,100,18,0,18
Enrika,F,100,18,0,18
Erilyn,F,100,18,0,18
Eryca,F,100,18,0,18
Erza,F,72,13,5,18
Esaw,M,100,0,18,18
Estephani,F,100,18,0,18
Estevon,M,100,0,18,18
Esti,F,100,18,0,18
Evangelyne,F,100,18,0,18
Fabiano,M,100,0,18,18
Faelyn,F,100,18,0,18
Faelynn,F,100,18,0,18
Fallou,M,100,0,18,18
Farha,F,100,18,0,18
Faryal,F,100,18,0,18
Fatimazahra,F,100,18,0,18
Faven,F,100,18,0,18
Felecity,F,100,18,0,18
Folashade,F,100,18,0,18
Francetta,F,100,18,0,18
Francies,F,100,18,0,18
Franck,M,100,0,18,18
Fredderick,M,100,0,18,18
Fredick,M,100,0,18,18
Furious,M,100,0,18,18
Future,M,100,0,18,18
Gabreal,M,100,0,18,18
Gabrien,M,100,0,18,18
Gabryela,F,100,18,0,18
Gaelen,M,100,0,18,18
Gatha,F,100,18,0,18
Gaylin,M,72,5,13,18
Geniyah,F,100,18,0,18
Geraldina,F,100,18,0,18
Geran,M,100,0,18,18
Ghali,M,100,0,18,18
Glenis,F,72,13,5,18
Goerge,M,100,0,18,18
Gotti,M,100,0,18,18
Gracieann,F,100,18,0,18
Grayton,M,100,0,18,18
Grazia,F,100,18,0,18
Hadriel,M,100,0,18,18
Haeleigh,F,100,18,0,18
Harith,M,100,0,18,18
Haroun,M,100,0,18,18
Hasana,F,100,18,0,18
Hawkin,M,100,0,18,18
Haylo,F,100,18,0,18
Heavin,F,100,18,0,18
Heena,F,100,18,0,18
Helem,F,100,18,0,18
Hendel,F,100,18,0,18
Henok,M,100,0,18,18
Henryk,M,100,0,18,18
Hershal,M,100,0,18,18
Hill,M,100,0,18,18
Holleigh,F,100,18,0,18
Holmes,M,100,0,18,18
Hoyle,M,100,0,18,18
Huber,M,100,0,18,18
Iam,M,100,0,18,18
Ihan,M,100,0,18,18
Iktan,M,100,0,18,18
Ileene,F,100,18,0,18
Imanii,F,100,18,0,18
Imonie,F,100,18,0,18
Ingram,M,100,0,18,18
Insiya,F,100,18,0,18
Irissa,F,100,18,0,18
Ismar,F,61,11,7,18
Issaac,M,100,0,18,18
Iyanuoluwa,F,67,12,6,18
Iylah,F,100,18,0,18
Izea,M,100,0,18,18
Jacai,M,100,0,18,18
Jacub,M,100,0,18,18
Jadian,M,100,0,18,18
Jaecion,M,100,0,18,18
Jaecob,M,100,0,18,18
Jaeshaun,M,100,0,18,18
Jaeveon,M,100,0,18,18
Jahayra,F,100,18,0,18
Jahmani,M,100,0,18,18
Jahmia,F,100,18,0,18
Jahnai,F,72,13,5,18
Jahon,M,100,0,18,18
Jahvier,M,100,0,18,18
Jaidalyn,F,100,18,0,18
Jaimarie,F,100,18,0,18
Jaimere,M,100,0,18,18
Jaiyah,F,100,18,0,18
Jakaylee,F,100,18,0,18
Jakenzie,F,100,18,0,18
Jakeob,M,100,0,18,18
Jalasia,F,100,18,0,18
Jamarl,M,100,0,18,18
Jameal,M,100,0,18,18
Jamiesha,F,100,18,0,18
Jamontae,M,100,0,18,18
Janaisha,F,100,18,0,18
Janeann,F,100,18,0,18
Janes,M,100,0,18,18
Jannatul,F,100,18,0,18
Jaquala,F,100,18,0,18
Jaquese,M,67,6,12,18
Jarion,M,100,0,18,18
Jasaiah,M,100,0,18,18
Jasime,F,100,18,0,18
Jaskirat,F,50,9,9,18
Jasmia,F,100,18,0,18
Jasn,M,100,0,18,18
Jaszmine,F,100,18,0,18
Javaeh,F,100,18,0,18
Jaxzen,M,100,0,18,18
Jayveion,M,100,0,18,18
Jeannelle,F,100,18,0,18
Jebidiah,M,100,0,18,18
Jenaveve,F,100,18,0,18
Jennene,F,100,18,0,18
Jennise,F,100,18,0,18
Jeptha,M,100,0,18,18
Jerlisa,F,100,18,0,18
Jermarion,M,100,0,18,18
Jerney,F,100,18,0,18
Jerriyah,F,100,18,0,18
Jesenya,F,100,18,0,18
Jesper,M,100,0,18,18
Jetaun,F,100,18,0,18
Jhayla,F,100,18,0,18
Jillaine,F,100,18,0,18
Jinx,F,100,18,0,18
Jnya,F,100,18,0,18
Joden,M,100,0,18,18
Joffrey,M,100,0,18,18
Johnda,F,100,18,0,18
Johniya,F,100,18,0,18
Johnryan,M,100,0,18,18
Johntavius,M,100,0,18,18
Jojuan,M,100,0,18,18
Jolita,F,100,18,0,18
Jonahtan,M,100,0,18,18
Joneisha,F,100,18,0,18
Joselynne,F,100,18,0,18
Josenid,F,100,18,0,18
Josselyne,F,100,18,0,18
Jourdon,M,100,0,18,18
Jowan,M,100,0,18,18
Joycie,F,100,18,0,18
Julann,F,100,18,0,18
Juliauna,F,100,18,0,18
Juni,F,100,18,0,18
Justene,F,100,18,0,18
Jveon,M,100,0,18,18
Jwan,M,72,5,13,18
Jylan,M,100,0,18,18
Kabeer,M,100,0,18,18
Kahle,M,100,0,18,18
Kahlyn,F,100,18,0,18
Kaiana,F,100,18,0,18
Kaileena,F,100,18,0,18
Kairav,M,100,0,18,18
Kaisei,M,100,0,18,18
Kaitland,F,100,18,0,18
Kalana,F,100,18,0,18
Kaleeyah,F,100,18,0,18
Kallon,M,100,0,18,18
Kamarrion,M,100,0,18,18
Kambrey,F,100,18,0,18
Kameka,F,100,18,0,18
Kanae,F,100,18,0,18
Kanaya,F,100,18,0,18
Kanylah,F,100,18,0,18
Karielle,F,100,18,0,18
Karmine,M,100,0,18,18
Kashish,F,100,18,0,18
Kateline,F,100,18,0,18
Katrenia,F,100,18,0,18
Kattleya,F,100,18,0,18
Kaushik,M,100,0,18,18
Kawthar,F,100,18,0,18
Kayleana,F,100,18,0,18
Kayn,M,100,0,18,18
Kayo,M,100,0,18,18
Kayston,M,100,0,18,18
Kdyn,M,100,0,18,18
Keaden,M,100,0,18,18
Keandria,F,100,18,0,18
Keiandre,M,100,0,18,18
Keiji,M,100,0,18,18
Kelicia,F,100,18,0,18
Kelse,F,100,18,0,18
Kemia,F,100,18,0,18
Kenni,F,100,18,0,18
Keric,M,100,0,18,18
Kerrion,M,100,0,18,18
Kersti,F,100,18,0,18
Keshanna,F,100,18,0,18
Ketra,F,100,18,0,18
Kevork,M,100,0,18,18
Keyandra,F,100,18,0,18
Keyleen,F,100,18,0,18
Keyonda,F,100,18,0,18
Khaalid,M,100,0,18,18
Khalen,M,100,0,18,18
Khalidah,F,100,18,0,18
Khalin,M,100,0,18,18
Khush,M,100,0,18,18
Kiaeem,M,100,0,18,18
Kimie,F,100,18,0,18
Kindred,M,67,6,12,18
Kionte,M,100,0,18,18
Kiora,F,100,18,0,18
Konni,F,100,18,0,18
Kordai,M,100,0,18,18
Kourtlynn,F,100,18,0,18
Krishaun,M,67,6,12,18
Kristiane,F,100,18,0,18
Krys,F,100,18,0,18
Kryssa,F,100,18,0,18
Krystall,F,100,18,0,18
Kuzey,M,100,0,18,18
Kyleeann,F,100,18,0,18
Kyliana,F,100,18,0,18
Kynzi,F,100,18,0,18
Lachele,F,100,18,0,18
Lachrisha,F,100,18,0,18
Lada,F,100,18,0,18
Laelynn,F,100,18,0,18
Laira,F,100,18,0,18
Laketra,F,100,18,0,18
Lameshia,F,100,18,0,18
Lamonda,F,100,18,0,18
Lanaysia,F,100,18,0,18
Lanis,M,72,5,13,18
Laquentin,M,100,0,18,18
Laquinda,F,100,18,0,18
Larayne,F,100,18,0,18
Latalia,F,100,18,0,18
Latrail,M,100,0,18,18
Latriece,F,100,18,0,18
Latrisa,F,100,18,0,18
Latysha,F,100,18,0,18
Lavaris,M,100,0,18,18
Lavayah,F,100,18,0,18
Lavra,F,100,18,0,18
Lawsyn,M,67,6,12,18
Layali,F,100,18,0,18
Laylaa,F,100,18,0,18
Layney,F,100,18,0,18
Laytoya,F,100,18,0,18
Lazlo,M,100,0,18,18
Ledora,F,100,18,0,18
Leeta,F,100,18,0,18
Leilanee,F,100,18,0,18
Leilanny,F,100,18,0,18
Lekha,F,100,18,0,18
Lelania,F,100,18,0,18
Leonila,F,100,18,0,18
Leotha,F,61,11,7,18
Letcher,M,100,0,18,18
Letonya,F,100,18,0,18
Leysha,F,100,18,0,18
Liberti,F,100,18,0,18
Libra,F,100,18,0,18
Lilinoe,F,100,18,0,18
Lillyn,F,100,18,0,18
Linah,F,100,18,0,18
Livianna,F,100,18,0,18
Lorilynn,F,100,18,0,18
Loxley,F,100,18,0,18
Luane,F,100,18,0,18
Lucilia,F,100,18,0,18
Lucyann,F,100,18,0,18
Luiscarlos,M,100,0,18,18
Lundy,M,72,5,13,18
Lusia,F,100,18,0,18
Lycan,M,100,0,18,18
Lydiana,F,100,18,0,18
Lyne,F,100,18,0,18
Lynia,F,100,18,0,18
Lynniah,F,100,18,0,18
Madaleine,F,100,18,0,18
Madicyn,F,100,18,0,18
Madoc,M,100,0,18,18
Maeven,F,100,18,0,18
Makara,F,100,18,0,18
Mal,M,100,0,18,18
Malaijah,F,100,18,0,18
Malcomb,M,100,0,18,18
Maleni,F,100,18,0,18
Manoj,M,100,0,18,18
Manreet,F,100,18,0,18
Manveer,M,100,0,18,18
Marabelle,F,100,18,0,18
Mardee,F,100,18,0,18
Marianita,F,100,18,0,18
Marijke,F,100,18,0,18
Marikay,F,100,18,0,18
Markeia,F,100,18,0,18
Marliyah,F,100,18,0,18
Maronda,F,100,18,0,18
Marquize,M,100,0,18,18
Marteka,F,100,18,0,18
Marthe,F,100,18,0,18
Maryangel,F,100,18,0,18
Matej,M,100,0,18,18
Mathea,F,100,18,0,18
Maximum,M,100,0,18,18
Maycon,M,100,0,18,18
Maymuna,F,100,18,0,18
Mayzee,F,100,18,0,18
Mazal,F,100,18,0,18
Maze,M,100,0,18,18
Mcihael,M,100,0,18,18
Mehkai,M,100,0,18,18
Mehul,M,100,0,18,18
Meily,F,100,18,0,18
Meladie,F,100,18,0,18
Melessia,F,100,18,0,18
Mellony,F,100,18,0,18
Melvenia,F,100,18,0,18
Mercadies,F,100,18,0,18
Meredeth,F,100,18,0,18
Meshawn,F,100,18,0,18
Mian,M,100,0,18,18
Milina,F,100,18,0,18
Miloh,M,100,0,18,18
Mirage,F,72,13,5,18
Mirelle,F,100,18,0,18
Mirren,F,100,18,0,18
Mishti,F,100,18,0,18
Misk,F,100,18,0,18
Mitsy,F,100,18,0,18
Miyoko,F,100,18,0,18
Mohab,M,100,0,18,18
Mohsen,M,100,0,18,18
Montarius,M,100,0,18,18
Montrae,M,100,0,18,18
Moritz,M,100,0,18,18
Muadh,M,100,0,18,18
Muhannad,M,100,0,18,18
Murlene,F,100,18,0,18
Mycal,M,100,0,18,18
Myrick,M,100,0,18,18
Naelani,F,100,18,0,18
Najir,M,100,0,18,18
Nakhi,M,100,0,18,18
Naksh,M,100,0,18,18
Naleigha,F,100,18,0,18
Nalina,F,100,18,0,18
Nalla,F,100,18,0,18
Namari,M,72,5,13,18
Naol,M,100,0,18,18
Nas,M,100,0,18,18
Nasean,M,100,0,18,18
Nasiya,F,100,18,0,18
Nasro,F,100,18,0,18
Neave,F,100,18,0,18
Nechuma,F,100,18,0,18
Neilah,F,100,18,0,18
Nephtali,M,100,0,18,18
Neythan,M,100,0,18,18
Niala,F,100,18,0,18
Nickalous,M,100,0,18,18
Nihaal,M,100,0,18,18
Nimrat,F,100,18,0,18
Nimrit,F,100,18,0,18
Nishtha,F,100,18,0,18
Nitika,F,100,18,0,18
Nivaan,M,100,0,18,18
Nkechi,F,100,18,0,18
Nowell,M,100,0,18,18
Nyna,F,100,18,0,18
Oaklen,M,100,0,18,18
Oceane,F,100,18,0,18
Octivia,F,100,18,0,18
Odessia,F,100,18,0,18
Ohn,M,100,0,18,18
Omarian,M,100,0,18,18
Ondra,M,61,7,11,18
Onesty,F,100,18,0,18
Oneta,F,100,18,0,18
Orel,M,100,0,18,18
Oshay,M,100,0,18,18
Osher,M,100,0,18,18
Osric,M,100,0,18,18
Paisli,F,100,18,0,18
Paquita,F,100,18,0,18
Parthiv,M,100,0,18,18
Pasqual,M,100,0,18,18
Patches,F,100,18,0,18
Patrcia,F,100,18,0,18
Patsie,F,100,18,0,18
Paulmichael,M,100,0,18,18
Paytience,F,100,18,0,18
Pegge,F,100,18,0,18
Peni,F,100,18,0,18
Pennye,F,100,18,0,18
Persais,F,100,18,0,18
Persephonie,F,100,18,0,18
Petr,M,100,0,18,18
Pharell,M,100,0,18,18
Philopateer,M,100,0,18,18
Pina,F,100,18,0,18
Pj,M,100,0,18,18
Pleas,M,100,0,18,18
Ponciano,M,100,0,18,18
Prajwal,M,100,0,18,18
Quantisha,F,100,18,0,18
Quay,M,72,5,13,18
Quindell,M,100,0,18,18
Raahi,F,100,18,0,18
Raenah,F,100,18,0,18
Rakisha,F,100,18,0,18
Ramondo,M,100,0,18,18
Rashay,F,100,18,0,18
Rayane,M,100,0,18,18
Raydin,M,100,0,18,18
Rayley,F,100,18,0,18
Rebecah,F,100,18,0,18
Reeta,F,100,18,0,18
Rein,F,56,10,8,18
Renesme,F,100,18,0,18
Renu,F,100,18,0,18
Reubin,M,100,0,18,18
Reyaan,M,100,0,18,18
Reynalda,F,100,18,0,18
Reyne,F,100,18,0,18
Rhayne,F,100,18,0,18
Rhina,F,100,18,0,18
Ritchard,M,100,0,18,18
Ritesh,M,100,0,18,18
Roann,F,100,18,0,18
Robbye,F,100,18,0,18
Roda,F,100,18,0,18
Rodnesha,F,100,18,0,18
Rogen,M,100,0,18,18
Roiza,F,100,18,0,18
Rolene,F,100,18,0,18
Ronalee,F,100,18,0,18
Ronnita,F,100,18,0,18
Roosvelt,M,100,0,18,18
Royann,F,100,18,0,18
Ruqayya,F,100,18,0,18
Ruthvik,M,100,0,18,18
Saahir,M,100,0,18,18
Saamir,M,100,0,18,18
Sahily,F,100,18,0,18
Saide,F,100,18,0,18
Saije,F,100,18,0,18
Sair,M,100,0,18,18
Salik,M,100,0,18,18
Samary,F,100,18,0,18
Samier,M,100,0,18,18
Samuell,M,100,0,18,18
Saniyya,F,100,18,0,18
Sanoe,F,100,18,0,18
Sanye,F,100,18,0,18
Sarinity,F,100,18,0,18
Satcha,F,100,18,0,18
Sausha,F,100,18,0,18
Sedonia,F,100,18,0,18
Seleena,F,100,18,0,18
Selen,F,100,18,0,18
Seniyah,F,100,18,0,18
Sentoria,F,100,18,0,18
Serrena,F,100,18,0,18
Shadd,M,100,0,18,18
Shakeel,M,100,0,18,18
Shakeeta,F,100,18,0,18
Shakelia,F,100,18,0,18
Shakerria,F,100,18,0,18
Shakil,M,100,0,18,18
Shakti,F,100,18,0,18
Shamona,F,100,18,0,18
Shamond,M,100,0,18,18
Shanara,F,100,18,0,18
Shanard,M,100,0,18,18
Shanaye,F,100,18,0,18
Shandie,F,100,18,0,18
Shanekqua,F,100,18,0,18
Shanen,F,100,18,0,18
Shantea,F,100,18,0,18
Shantinique,F,100,18,0,18
Shaquandra,F,100,18,0,18
Shaqueta,F,100,18,0,18
Sharisa,F,100,18,0,18
Sharlena,F,100,18,0,18
Sharlon,F,100,18,0,18
Sharnay,F,100,18,0,18
Shaunn,M,100,0,18,18
Shauntavia,F,100,18,0,18
Shauntee,F,100,18,0,18
Shavette,F,100,18,0,18
Shelie,F,100,18,0,18
Shemuel,M,100,0,18,18
Shenay,F,100,18,0,18
Shenaya,F,100,18,0,18
Shereese,F,100,18,0,18
Sherhonda,F,100,18,0,18
Sheronica,F,100,18,0,18
Sherrian,F,100,18,0,18
Shilynn,F,100,18,0,18
Shineka,F,100,18,0,18
Shreshta,F,100,18,0,18
Shuntae,F,100,18,0,18
Siddalee,F,100,18,0,18
Sidni,F,100,18,0,18
Sigurd,M,100,0,18,18
Simrat,F,100,18,0,18
Sira,F,100,18,0,18
Skanda,M,100,0,18,18
Skyley,F,100,18,0,18
Skylinn,F,100,18,0,18
Smera,F,100,18,0,18
Sohana,F,100,18,0,18
Solae,F,100,18,0,18
Solomia,F,100,18,0,18
Sonique,F,100,18,0,18
Soriyah,F,100,18,0,18
Sota,M,100,0,18,18
Spero,M,100,0,18,18
Sreekar,M,100,0,18,18
Staley,F,100,18,0,18
Starlena,F,100,18,0,18
Steadman,M,100,0,18,18
Stepfanie,F,100,18,0,18
Steph,F,100,18,0,18
Sugar,F,100,18,0,18
Suhailah,F,100,18,0,18
Sunee,F,100,18,0,18
Suren,M,100,0,18,18
Swayzee,F,100,18,0,18
Syenna,F,100,18,0,18
Taedyn,M,72,5,13,18
Tagg,M,100,0,18,18
Takiah,F,100,18,0,18
Takila,F,100,18,0,18
Takya,F,100,18,0,18
Taleigh,F,100,18,0,18
Tamon,M,100,0,18,18
Tanaysha,F,100,18,0,18
Tarissa,F,100,18,0,18
Tarshia,F,100,18,0,18
Tasheema,F,100,18,0,18
Tavaria,F,100,18,0,18
Tavarious,M,100,0,18,18
Taziyah,F,100,18,0,18
Teagon,M,100,0,18,18
Telesia,F,100,18,0,18
Tenae,F,100,18,0,18
Teniya,F,100,18,0,18
Tequita,F,100,18,0,18
Terald,M,100,0,18,18
Terricka,F,100,18,0,18
Thandiwe,F,100,18,0,18
Therasa,F,100,18,0,18
Thessaly,F,100,18,0,18
Thomasene,F,100,18,0,18
Thoren,M,100,0,18,18
Tieasha,F,100,18,0,18
Tierany,F,100,18,0,18
Tierrah,F,100,18,0,18
Tiffine,F,100,18,0,18
Toiya,F,100,18,0,18
Torryn,F,100,18,0,18
Tosca,F,100,18,0,18
Toshua,F,72,13,5,18
Toua,M,100,0,18,18
Toula,F,100,18,0,18
Tracine,F,100,18,0,18
Trameka,F,100,18,0,18
Trek,M,100,0,18,18
Treydon,M,100,0,18,18
Treyten,M,100,0,18,18
Treyvin,M,100,0,18,18
Trimaine,M,100,0,18,18
Trinna,F,100,18,0,18
Trissa,F,100,18,0,18
Tristynn,F,100,18,0,18
Tritia,F,100,18,0,18
Tryone,M,100,0,18,18
Tulio,M,100,0,18,18
Tyera,F,100,18,0,18
Tyjanae,F,100,18,0,18
Tymeer,M,100,0,18,18
Ubah,F,100,18,0,18
Ulonda,F,100,18,0,18
Ulysees,M,100,0,18,18
Urie,M,100,0,18,18
Usama,M,100,0,18,18
Valicia,F,100,18,0,18
Valon,M,100,0,18,18
Varvara,F,100,18,0,18
Veleka,F,100,18,0,18
Veleta,F,100,18,0,18
Velta,F,100,18,0,18
Venissa,F,100,18,0,18
Vertie,F,100,18,0,18
Vitor,M,100,0,18,18
Vonceil,F,100,18,0,18
Voncia,F,100,18,0,18
Wahid,M,100,0,18,18
Wandy,F,100,18,0,18
Warnell,M,100,0,18,18
Wayden,M,100,0,18,18
Willisha,F,100,18,0,18
Wing,M,100,0,18,18
Witney,F,100,18,0,18
Wyona,F,100,18,0,18
Xaivier,M,100,0,18,18
Xan,M,56,8,10,18
Xareni,F,100,18,0,18
Xayla,F,100,18,0,18
Xitlally,F,100,18,0,18
Xylina,F,100,18,0,18
Yago,M,100,0,18,18
Yahmir,M,100,0,18,18
Yailen,F,100,18,0,18
Yamira,F,100,18,0,18
Yaniv,M,100,0,18,18
Yaslyn,F,100,18,0,18
Yehudit,F,100,18,0,18
Yeilyn,F,100,18,0,18
Yenty,F,100,18,0,18
Yuliet,F,100,18,0,18
Yvon,F,61,11,7,18
Zabdi,F,67,12,6,18
Zaeda,F,100,18,0,18
Zaidy,F,100,18,0,18
Zakhai,M,100,0,18,18
Zakhari,M,100,0,18,18
Zakyia,F,100,18,0,18
Zavery,M,100,0,18,18
Zaxton,M,100,0,18,18
Zayonna,F,100,18,0,18
Zeeva,F,100,18,0,18
Zelina,F,100,18,0,18
Zenaya,F,100,18,0,18
Zixuan,M,56,8,10,18
Zoa,F,100,18,0,18
Zoiey,F,100,18,0,18
Zonya,F,100,18,0,18
Aalivia,F,100,17,0,17
Aalliyah,F,100,17,0,17
Aareon,M,71,5,12,17
Aashir,M,100,0,17,17
Aasir,M,100,0,17,17
Abagael,F,100,17,0,17
Abdulah,M,100,0,17,17
Abdulahad,M,100,0,17,17
Abdulai,M,100,0,17,17
Abeeha,F,100,17,0,17
Abhijay,M,100,0,17,17
Abriela,F,100,17,0,17
Adaisha,F,100,17,0,17
Addalyne,F,100,17,0,17
Adden,M,100,0,17,17
Addley,F,100,17,0,17
Adie,F,100,17,0,17
Adisa,F,71,12,5,17
Adith,M,100,0,17,17
Adjoa,F,100,17,0,17
Adonte,M,100,0,17,17
Adriaan,M,100,0,17,17
Adrijana,F,100,17,0,17
Adryel,M,100,0,17,17
Afsana,F,100,17,0,17
Ahnyla,F,100,17,0,17
Ahriyah,F,100,17,0,17
Aikeem,M,100,0,17,17
Ailyne,F,100,17,0,17
Aivan,M,100,0,17,17
Aivy,F,100,17,0,17
Aiysha,F,100,17,0,17
Ajahnae,F,100,17,0,17
Ajna,F,100,17,0,17
Akeya,F,100,17,0,17
Alano,M,100,0,17,17
Aleka,F,100,17,0,17
Aleph,M,100,0,17,17
Aleynah,F,100,17,0,17
Alf,M,100,0,17,17
Aliviyah,F,100,17,0,17
Almarosa,F,100,17,0,17
Almer,M,100,0,17,17
Alnisa,F,100,17,0,17
Alonni,F,100,17,0,17
Altovise,F,100,17,0,17
Alyla,F,100,17,0,17
Alynah,F,100,17,0,17
Amaal,F,100,17,0,17
Amair,M,100,0,17,17
Amaka,F,100,17,0,17
Amanie,F,100,17,0,17
Amany,F,100,17,0,17
Amario,M,100,0,17,17
Amay,M,100,0,17,17
Amear,M,100,0,17,17
Ameia,F,100,17,0,17
Amillya,F,100,17,0,17
Amonda,F,100,17,0,17
Amoria,F,100,17,0,17
Anaaya,F,100,17,0,17
Anaeli,F,100,17,0,17
Andalyn,F,100,17,0,17
Ande,F,100,17,0,17
Andelyn,F,100,17,0,17
Andriy,M,100,0,17,17
Anevaeh,F,100,17,0,17
Angeliyah,F,100,17,0,17
Aniayah,F,100,17,0,17
Aniyha,F,100,17,0,17
Antavion,M,100,0,17,17
Ante,M,100,0,17,17
Anuja,F,100,17,0,17
Anush,M,100,0,17,17
Anvay,M,100,0,17,17
Anwen,F,100,17,0,17
Anwitha,F,100,17,0,17
Apollos,M,100,0,17,17
Aqua,F,100,17,0,17
Arad,M,100,0,17,17
Areyanna,F,100,17,0,17
Arianie,F,100,17,0,17
Ariba,F,100,17,0,17
Arlethia,F,100,17,0,17
Aronde,M,100,0,17,17
Arseniy,M,100,0,17,17
Artemisia,F,100,17,0,17
Asianae,F,100,17,0,17
Askari,M,100,0,17,17
Aspynn,F,100,17,0,17
Atalya,F,100,17,0,17
Atoya,F,100,17,0,17
Audrionna,F,100,17,0,17
Aunesti,F,100,17,0,17
Avaeh,F,100,17,0,17
Aveer,M,100,0,17,17
Aylan,M,100,0,17,17
Azalynn,F,100,17,0,17
Azana,F,100,17,0,17
Azania,F,100,17,0,17
Azazel,M,100,0,17,17
Bani,F,100,17,0,17
Bannon,M,100,0,17,17
Barba,F,100,17,0,17
Bates,M,100,0,17,17
Batina,F,100,17,0,17
Beauden,M,100,0,17,17
Belenda,F,100,17,0,17
Belisa,F,100,17,0,17
Belissa,F,100,17,0,17
Bergan,F,100,17,0,17
Besan,F,100,17,0,17
Betul,F,100,17,0,17
Bevelyn,F,100,17,0,17
Bhavin,M,100,0,17,17
Bhumi,F,100,17,0,17
Bixby,F,71,12,5,17
Blimi,F,100,17,0,17
Bomani,M,100,0,17,17
Bowe,M,100,0,17,17
Bradrick,M,100,0,17,17
Braeson,M,100,0,17,17
Braydee,F,71,12,5,17
Brean,F,100,17,0,17
Brecklynn,F,100,17,0,17
Breniya,F,100,17,0,17
Brenly,F,100,17,0,17
Brentton,M,100,0,17,17
Breunna,F,100,17,0,17
Briele,F,100,17,0,17
Brigitt,F,100,17,0,17
Brione,F,65,11,6,17
Bristyl,F,100,17,0,17
Bronco,M,100,0,17,17
Bryndle,F,100,17,0,17
Bryona,F,100,17,0,17
Brytni,F,100,17,0,17
Buel,M,100,0,17,17
Buell,M,100,0,17,17
Burr,M,100,0,17,17
Caisyn,F,53,9,8,17
Caitlain,F,100,17,0,17
Calahan,M,100,0,17,17
Calbert,M,100,0,17,17
Caliegh,F,100,17,0,17
Caliph,M,100,0,17,17
Calton,M,100,0,17,17
Cambre,F,100,17,0,17
Camiah,F,100,17,0,17
Caneshia,F,100,17,0,17
Caro,F,100,17,0,17
Carrolyn,F,100,17,0,17
Cartel,M,100,0,17,17
Carvell,M,100,0,17,17
Cashlynn,F,100,17,0,17
Casidee,F,100,17,0,17
Cavalli,M,100,0,17,17
Cecely,F,100,17,0,17
Celes,F,100,17,0,17
Celie,F,100,17,0,17
Cevin,M,100,0,17,17
Chaden,M,100,0,17,17
Chakita,F,100,17,0,17
Chala,F,100,17,0,17
Chandy,F,100,17,0,17
Chaos,M,100,0,17,17
Charistopher,M,100,0,17,17
Charlinda,F,100,17,0,17
Charlsey,F,100,17,0,17
Charrisse,F,100,17,0,17
Chenae,F,100,17,0,17
Cheris,F,100,17,0,17
Chermaine,F,100,17,0,17
Chevi,F,100,17,0,17
Chidi,M,100,0,17,17
Chinmay,M,100,0,17,17
Chrissette,F,100,17,0,17
Chyanna,F,100,17,0,17
Cielita,F,100,17,0,17
Clairessa,F,100,17,0,17
Clavin,M,100,0,17,17
Clearance,M,100,0,17,17
Cleda,F,100,17,0,17
Cleola,F,100,17,0,17
Clydie,F,100,17,0,17
Comer,M,100,0,17,17
Connee,F,100,17,0,17
Cope,M,100,0,17,17
Corneisha,F,100,17,0,17
Corretta,F,100,17,0,17
Courtez,M,100,0,17,17
Crystol,F,100,17,0,17
Daemion,M,100,0,17,17
Daiel,M,100,0,17,17
Daimian,M,100,0,17,17
Daisean,M,100,0,17,17
Daison,M,100,0,17,17
Daiva,F,100,17,0,17
Dalessandro,M,100,0,17,17
Dalexa,F,100,17,0,17
Daliana,F,100,17,0,17
Dallys,F,100,17,0,17
Damascus,M,100,0,17,17
Damontay,M,100,0,17,17
Damyen,M,100,0,17,17
Danaka,F,100,17,0,17
Dang,M,100,0,17,17
Danira,F,100,17,0,17
Dannel,M,100,0,17,17
Danylo,M,100,0,17,17
Dashton,M,100,0,17,17
Davarious,M,100,0,17,17
Dawnna,F,100,17,0,17
Daylani,F,100,17,0,17
Deannie,F,100,17,0,17
Debar,F,100,17,0,17
Debarah,F,100,17,0,17
Deejay,M,100,0,17,17
Deionte,M,100,0,17,17
Dejay,M,100,0,17,17
Delailah,F,100,17,0,17
Deland,M,100,0,17,17
Deliana,F,100,17,0,17
Delijah,M,71,5,12,17
Demaryius,M,100,0,17,17
Demetress,F,100,17,0,17
Demica,F,100,17,0,17
Denajah,F,100,17,0,17
Deneka,F,100,17,0,17
Dennice,F,100,17,0,17
Deondria,F,100,17,0,17
Derrious,M,100,0,17,17
Desarai,F,100,17,0,17
Desarie,F,100,17,0,17
Devaeh,F,100,17,0,17
Devanny,F,100,17,0,17
Devlynn,F,100,17,0,17
Deyna,F,100,17,0,17
Dio,M,100,0,17,17
Dionisia,F,100,17,0,17
Diyari,M,100,0,17,17
Donae,F,100,17,0,17
Doniesha,F,100,17,0,17
Donnae,F,100,17,0,17
Donney,M,100,0,17,17
Dontrail,M,100,0,17,17
Dorey,F,59,10,7,17
Dorit,F,100,17,0,17
Drace,M,100,0,17,17
Dreon,M,100,0,17,17
Drezden,M,100,0,17,17
Dymir,M,100,0,17,17
Ebraheem,M,100,0,17,17
Edge,M,100,0,17,17
Eeva,F,100,17,0,17
Efrata,F,100,17,0,17
Ejay,M,100,0,17,17
Elania,F,100,17,0,17
Elii,M,100,0,17,17
Elmin,M,100,0,17,17
Emmajane,F,100,17,0,17
Emmaus,M,100,0,17,17
Emonni,F,100,17,0,17
Eraclio,M,100,0,17,17
Erendida,F,100,17,0,17
Erisa,F,100,17,0,17
Ermalinda,F,100,17,0,17
Escarlet,F,100,17,0,17
Estanislao,M,100,0,17,17
Ettel,F,100,17,0,17
Evalie,F,100,17,0,17
Evanee,F,100,17,0,17
Eveny,F,100,17,0,17
Everlina,F,100,17,0,17
Ewen,M,100,0,17,17
Eydan,M,100,0,17,17
Eyla,F,100,17,0,17
Ezechiel,M,100,0,17,17
Ezekeil,M,100,0,17,17
Ezreal,M,100,0,17,17
Fantashia,F,100,17,0,17
Fatumata,F,100,17,0,17
Felesha,F,100,17,0,17
Fergie,F,100,17,0,17
Ferrah,F,100,17,0,17
Feven,F,100,17,0,17
Filbert,M,100,0,17,17
Finnleigh,F,100,17,0,17
Finola,F,100,17,0,17
Flecia,F,100,17,0,17
Fleurette,F,100,17,0,17
Florrie,F,100,17,0,17
Franchon,F,100,17,0,17
Franciscojavier,M,100,0,17,17
Frannie,F,100,17,0,17
Fritzi,F,100,17,0,17
Gabriellah,F,100,17,0,17
Gadge,M,100,0,17,17
Gagandeep,M,71,5,12,17
Gaither,M,100,0,17,17
Gaje,M,100,0,17,17
Gaspare,M,100,0,17,17
Gerda,F,100,17,0,17
Gesselle,F,100,17,0,17
Giordan,M,59,7,10,17
Gracielynn,F,100,17,0,17
Gracilyn,F,100,17,0,17
Graelyn,F,100,17,0,17
Graycin,F,71,12,5,17
Gurfateh,M,100,0,17,17
Gurkirat,M,65,6,11,17
Haadi,M,100,0,17,17
Hanaan,F,100,17,0,17
Hansini,F,100,17,0,17
Hanya,F,100,17,0,17
Hardeep,M,71,5,12,17
Harveer,M,100,0,17,17
Hasna,F,100,17,0,17
Helayne,F,100,17,0,17
Heliodoro,M,100,0,17,17
Helyn,F,100,17,0,17
Hendricks,M,100,0,17,17
Henessy,F,100,17,0,17
Hennesy,F,100,17,0,17
Henretta,F,100,17,0,17
Hermila,F,100,17,0,17
Hernandez,M,100,0,17,17
Hiliary,F,100,17,0,17
Hodaya,F,100,17,0,17
Hulda,F,100,17,0,17
Imri,M,65,6,11,17
Intisar,F,100,17,0,17
Iriel,F,100,17,0,17
Isam,M,100,0,17,17
Isamara,F,100,17,0,17
Issaih,M,100,0,17,17
Itzamar,F,100,17,0,17
Izekiel,M,100,0,17,17
Jachob,M,100,0,17,17
Jahaan,M,100,0,17,17
Jahnari,F,71,12,5,17
Jahnyla,F,100,17,0,17
Jahquez,M,100,0,17,17
Jaiannah,F,100,17,0,17
Jakerria,F,100,17,0,17
Jaking,M,100,0,17,17
Jakwon,M,100,0,17,17
Jakyri,M,100,0,17,17
Jakyron,M,100,0,17,17
Jalaiyah,F,100,17,0,17
Jalik,M,100,0,17,17
Jamaurion,M,100,0,17,17
Jameca,F,100,17,0,17
Janaiah,F,100,17,0,17
Janasha,F,100,17,0,17
Janiene,F,100,17,0,17
Jannelly,F,100,17,0,17
Janora,F,100,17,0,17
Jaquawn,M,100,0,17,17
Jarmel,M,100,0,17,17
Jasan,M,100,0,17,17
Jatoya,F,100,17,0,17
Javaya,F,100,17,0,17
Jawanna,F,100,17,0,17
Jawara,M,100,0,17,17
Jaydalyn,F,100,17,0,17
Jaylise,F,100,17,0,17
Jaylun,M,100,0,17,17
Jaymari,M,100,0,17,17
Jazlen,F,100,17,0,17
Jazyah,F,100,17,0,17
Jazzie,F,100,17,0,17
Jeanean,F,100,17,0,17
Jeannean,F,100,17,0,17
Jecenia,F,100,17,0,17
Jef,M,100,0,17,17
Jeffre,M,100,0,17,17
Jeffri,M,100,0,17,17
Jehieli,F,100,17,0,17
Jelan,M,100,0,17,17
Jemell,M,100,0,17,17
Jenesys,F,100,17,0,17
Jennavie,F,100,17,0,17
Jeralynn,F,100,17,0,17
Jeremaine,M,100,0,17,17
Jernie,F,100,17,0,17
Jery,M,100,0,17,17
Jeslin,F,100,17,0,17
Jessicamarie,F,100,17,0,17
Jessly,F,100,17,0,17
Jevaeh,F,100,17,0,17
Jeydi,F,100,17,0,17
Jeymi,F,100,17,0,17
Jezel,F,100,17,0,17
Jhan,M,100,0,17,17
Jhane,F,100,17,0,17
Jhovani,M,100,0,17,17
Jiovanna,F,100,17,0,17
Jisele,F,100,17,0,17
Jisell,F,100,17,0,17
Jlon,M,100,0,17,17
Joanny,F,71,12,5,17
Johngabriel,M,100,0,17,17
Johnnae,F,100,17,0,17
Johonna,F,100,17,0,17
Jonta,M,65,6,11,17
Jordayn,F,100,17,0,17
Jorgina,F,100,17,0,17
Josep,M,100,0,17,17
Joshau,M,100,0,17,17
Joushua,M,100,0,17,17
Jovin,M,100,0,17,17
Joyous,F,100,17,0,17
Joziyah,M,100,0,17,17
Julez,M,100,0,17,17
Julianny,F,100,17,0,17
Kadasia,F,100,17,0,17
Kadey,F,100,17,0,17
Kaesha,F,100,17,0,17
Kahliya,F,100,17,0,17
Kahmani,M,71,5,12,17
Kaiesha,F,100,17,0,17
Kaislee,F,100,17,0,17
Kalae,F,71,12,5,17
Kalenna,F,100,17,0,17
Kalii,F,100,17,0,17
Kapil,M,100,0,17,17
Kariya,F,100,17,0,17
Karlisha,F,100,17,0,17
Kataleah,F,100,17,0,17
Katherinne,F,100,17,0,17
Kathyjo,F,100,17,0,17
Katriana,F,100,17,0,17
Katurah,F,100,17,0,17
Kaushal,M,100,0,17,17
Kaydynce,F,100,17,0,17
Kayode,M,100,0,17,17
Keaka,M,100,0,17,17
Keelon,M,100,0,17,17
Keidrick,M,100,0,17,17
Keiera,F,100,17,0,17
Keighley,F,100,17,0,17
Kein,M,100,0,17,17
Keisean,M,100,0,17,17
Kellar,M,100,0,17,17
Kelsen,M,100,0,17,17
Kelwin,M,100,0,17,17
Kemesha,F,100,17,0,17
Kensly,F,100,17,0,17
Kenyen,M,100,0,17,17
Keora,F,100,17,0,17
Kerington,F,100,17,0,17
Kert,M,100,0,17,17
Keundra,F,100,17,0,17
Keyante,M,100,0,17,17
Keyston,M,100,0,17,17
Khalessi,F,100,17,0,17
Khaniya,F,100,17,0,17
Khaniyah,F,100,17,0,17
Khristie,F,100,17,0,17
Khrystian,M,100,0,17,17
Kiasha,F,100,17,0,17
Kilani,F,100,17,0,17
Kilie,F,100,17,0,17
Kilo,M,100,0,17,17
Kimika,F,100,17,0,17
Kimmora,F,100,17,0,17
Kinte,M,100,0,17,17
Kiren,M,100,0,17,17
Kirrah,F,100,17,0,17
Kirtan,M,100,0,17,17
Kiyonna,F,100,17,0,17
Kmya,F,100,17,0,17
Korinn,F,100,17,0,17
Koven,M,100,0,17,17
Krishauna,F,100,17,0,17
Krishay,M,100,0,17,17
Kvion,M,100,0,17,17
Kyen,M,100,0,17,17
Kyion,M,100,0,17,17
Kyndahl,F,100,17,0,17
Kynsie,F,100,17,0,17
Kysa,F,100,17,0,17
Kyvon,M,100,0,17,17
Labradford,M,100,0,17,17
Labrina,F,100,17,0,17
Labrittany,F,100,17,0,17
Laconda,F,100,17,0,17
Lafreda,F,100,17,0,17
Laif,M,100,0,17,17
Laiklyn,F,100,17,0,17
Laily,F,100,17,0,17
Laiylah,F,100,17,0,17
Lajeune,F,100,17,0,17
Laker,M,100,0,17,17
Landi,F,100,17,0,17
Laneta,F,100,17,0,17
Laqueena,F,100,17,0,17
Laronica,F,100,17,0,17
Laruen,F,100,17,0,17
Laterria,F,100,17,0,17
Latessa,F,100,17,0,17
Latissa,F,100,17,0,17
Latoi,F,100,17,0,17
Latorria,F,100,17,0,17
Latravion,M,100,0,17,17
Laurabeth,F,100,17,0,17
Lauralei,F,100,17,0,17
Law,M,100,0,17,17
Layliana,F,100,17,0,17
Layson,M,100,0,17,17
Laythen,M,100,0,17,17
Legina,F,100,17,0,17
Leim,M,100,0,17,17
Lenward,M,100,0,17,17
Leny,M,65,6,11,17
Leshay,F,100,17,0,17
Lianette,F,100,17,0,17
Liany,F,100,17,0,17
Liliahna,F,100,17,0,17
Lillyanah,F,100,17,0,17
Lillyian,F,100,17,0,17
Lilyannah,F,100,17,0,17
Linetta,F,100,17,0,17
Liviya,F,100,17,0,17
Lonnel,M,100,0,17,17
Lonnetta,F,100,17,0,17
Lorann,F,100,17,0,17
Lorence,M,100,0,17,17
Lorenia,F,100,17,0,17
Luchiano,M,100,0,17,17
Lucifer,M,100,0,17,17
Luverne,M,65,6,11,17
Lylianna,F,100,17,0,17
Lynise,F,100,17,0,17
Lynnwood,M,100,0,17,17
Lyrah,F,100,17,0,17
Macdonald,M,100,0,17,17
Mackenzye,F,100,17,0,17
Madissen,F,100,17,0,17
Maeby,F,100,17,0,17
Maicol,M,100,0,17,17
Mak,M,100,0,17,17
Makayleigh,F,100,17,0,17
Makeisha,F,100,17,0,17
Makenleigh,F,100,17,0,17
Makenlie,F,100,17,0,17
Makiyla,F,100,17,0,17
Mako,F,59,10,7,17
Malahki,M,100,0,17,17
Marchella,F,100,17,0,17
Marcheta,F,100,17,0,17
Mariena,F,100,17,0,17
Marishka,F,100,17,0,17
Markeem,M,100,0,17,17
Marnette,F,100,17,0,17
Marquavion,M,100,0,17,17
Marquiz,M,100,0,17,17
Marrah,F,100,17,0,17
Masiel,F,100,17,0,17
Matelyn,F,100,17,0,17
Mathayus,M,100,0,17,17
Matheu,M,100,0,17,17
Matisha,F,100,17,0,17
Mattis,M,100,0,17,17
Maysam,F,100,17,0,17
Maysoon,F,100,17,0,17
Mayu,F,100,17,0,17
Mccayla,F,100,17,0,17
Mckaila,F,100,17,0,17
Mckale,M,100,0,17,17
Megon,F,100,17,0,17
Mekaila,F,100,17,0,17
Meleni,F,100,17,0,17
Melquisedec,M,100,0,17,17
Melysa,F,100,17,0,17
Merla,F,100,17,0,17
Merric,M,100,0,17,17
Mette,F,100,17,0,17
Mialani,F,100,17,0,17
Midajah,F,100,17,0,17
Miela,F,100,17,0,17
Mihran,M,100,0,17,17
Mikisha,F,100,17,0,17
Milianna,F,100,17,0,17
Milta,F,100,17,0,17
Mima,F,100,17,0,17
Miran,M,100,0,17,17
Miriana,F,100,17,0,17
Mirjana,F,100,17,0,17
Missouri,F,100,17,0,17
Mliss,F,100,17,0,17
Mohogany,F,100,17,0,17
Montina,F,100,17,0,17
Morganna,F,100,17,0,17
Muath,M,100,0,17,17
Munachimso,F,100,17,0,17
Myeesha,F,100,17,0,17
Mykira,F,100,17,0,17
Mystie,F,100,17,0,17
Naara,F,100,17,0,17
Nabria,F,100,17,0,17
Nadege,F,100,17,0,17
Nahia,F,100,17,0,17
Nahjae,F,100,17,0,17
Naiovy,F,100,17,0,17
Naomii,F,100,17,0,17
Narmeen,F,100,17,0,17
Natajah,F,100,17,0,17
Natelie,F,100,17,0,17
Nawaal,F,100,17,0,17
Nay,M,65,6,11,17
Naylee,F,100,17,0,17
Nazari,F,71,12,5,17
Nechemia,M,100,0,17,17
Neelesh,M,100,0,17,17
Neeta,F,100,17,0,17
Neilan,M,100,0,17,17
Nermeen,F,100,17,0,17
Nesa,F,100,17,0,17
Nevyn,M,100,0,17,17
Nickalos,M,100,0,17,17
Nilan,M,100,0,17,17
Nimsi,F,100,17,0,17
Ninamarie,F,100,17,0,17
Noal,M,100,0,17,17
Nocholas,M,100,0,17,17
Noraa,F,100,17,0,17
Norell,F,71,12,5,17
Nyeli,F,100,17,0,17
Nylaya,F,100,17,0,17
Odyn,M,100,0,17,17
Oluwateniola,F,100,17,0,17
Orhan,M,100,0,17,17
Orlan,M,100,0,17,17
Orvis,M,100,0,17,17
Osborn,M,100,0,17,17
Overton,M,100,0,17,17
Pammie,F,100,17,0,17
Paraskevi,F,100,17,0,17
Payslie,F,100,17,0,17
Petrice,F,100,17,0,17
Philander,M,100,0,17,17
Pilot,M,100,0,17,17
Porschea,F,100,17,0,17
Prabhav,M,100,0,17,17
Pratyush,M,100,0,17,17
Primus,M,100,0,17,17
Quantasia,F,100,17,0,17
Quantia,F,100,17,0,17
Quantina,F,100,17,0,17
Quincie,F,100,17,0,17
Quintell,M,100,0,17,17
Raea,F,100,17,0,17
Raelan,F,100,17,0,17
Ralene,F,100,17,0,17
Ramani,F,100,17,0,17
Ramere,M,100,0,17,17
Ramez,M,100,0,17,17
Raneshia,F,100,17,0,17
Ranyah,F,100,17,0,17
Rashanna,F,100,17,0,17
Rawson,M,100,0,17,17
Raylea,F,100,17,0,17
Raylynne,F,100,17,0,17
Raymar,M,100,0,17,17
Rechel,F,100,17,0,17
Reha,F,100,17,0,17
Reia,F,100,17,0,17
Reilynn,F,100,17,0,17
Rendi,F,100,17,0,17
Rhylei,F,100,17,0,17
Rhyley,M,71,5,12,17
Rien,M,71,5,12,17
Riko,F,59,10,7,17
Robecca,F,100,17,0,17
Rollo,M,100,0,17,17
Rolly,M,100,0,17,17
Romayne,F,100,17,0,17
Roniel,M,100,0,17,17
Rorik,M,100,0,17,17
Roslind,F,100,17,0,17
Rossibell,F,100,17,0,17
Royanne,F,100,17,0,17
Rozalie,F,100,17,0,17
Rubyann,F,100,17,0,17
Ryaan,M,100,0,17,17
Rykar,M,100,0,17,17
Ryleighann,F,100,17,0,17
Rylenn,F,100,17,0,17
Ryota,M,100,0,17,17
Saben,M,100,0,17,17
Sabena,F,100,17,0,17
Sabriah,F,100,17,0,17
Sadeen,F,100,17,0,17
Saher,F,100,17,0,17
Sakiyah,F,100,17,0,17
Salar,M,100,0,17,17
Salimatou,F,100,17,0,17
Samiksha,F,100,17,0,17
Samil,M,100,0,17,17
Sanskriti,F,100,17,0,17
Santoria,F,100,17,0,17
Sarahlynn,F,100,17,0,17
Saren,F,100,17,0,17
Sarie,F,100,17,0,17
Saryna,F,100,17,0,17
Satrina,F,100,17,0,17
Saveion,M,100,0,17,17
Savi,F,100,17,0,17
Sayeed,M,100,0,17,17
Seara,F,100,17,0,17
Seona,F,100,17,0,17
Serapio,M,100,0,17,17
Shadman,M,100,0,17,17
Shainna,F,100,17,0,17
Shakeela,F,100,17,0,17
Shakesha,F,100,17,0,17
Shalan,F,100,17,0,17
Shalayah,F,100,17,0,17
Shalinda,F,100,17,0,17
Shamell,M,71,5,12,17
Shanne,F,59,10,7,17
Shannelle,F,100,17,0,17
Sharece,F,100,17,0,17
Sharesa,F,100,17,0,17
Sharlett,F,100,17,0,17
Sharlynn,F,100,17,0,17
Shasha,F,100,17,0,17
Shavanna,F,100,17,0,17
Shavar,M,100,0,17,17
Shayle,F,100,17,0,17
Shaynna,F,100,17,0,17
Sheddrick,M,100,0,17,17
Shermika,F,100,17,0,17
Shernika,F,100,17,0,17
Shinika,F,100,17,0,17
Shonette,F,100,17,0,17
Shonya,F,100,17,0,17
Shown,M,65,6,11,17
Shray,M,100,0,17,17
Shynia,F,100,17,0,17
Siyana,F,100,17,0,17
Skyleen,F,100,17,0,17
Sladen,M,100,0,17,17
Solanch,F,100,17,0,17
Soliman,M,100,0,17,17
Sorina,F,100,17,0,17
Sreeja,F,100,17,0,17
Sreenidhi,F,100,17,0,17
Srihari,M,100,0,17,17
Starlee,F,100,17,0,17
Stephene,F,100,17,0,17
Stephie,F,100,17,0,17
Suheb,M,100,0,17,17
Suliman,M,100,0,17,17
Sumedh,M,100,0,17,17
Summerlynn,F,100,17,0,17
Sundai,F,100,17,0,17
Suprina,F,100,17,0,17
Sydelle,F,100,17,0,17
Sylva,F,100,17,0,17
Symphonie,F,100,17,0,17
Synai,F,100,17,0,17
Taichi,M,100,0,17,17
Tailer,F,100,17,0,17
Takiera,F,100,17,0,17
Tamelia,F,100,17,0,17
Tamirra,F,100,17,0,17
Taneasha,F,100,17,0,17
Tanielle,F,100,17,0,17
Tanise,F,100,17,0,17
Tannar,M,100,0,17,17
Tanylah,F,100,17,0,17
Tanza,F,100,17,0,17
Taris,M,100,0,17,17
Tashiya,F,100,17,0,17
Tasnia,F,100,17,0,17
Tassie,F,100,17,0,17
Taycee,F,100,17,0,17
Tayva,F,100,17,0,17
Teeghan,F,100,17,0,17
Tejasvi,F,100,17,0,17
Teliyah,F,100,17,0,17
Tellis,M,100,0,17,17
Temica,F,100,17,0,17
Teniqua,F,100,17,0,17
Tenita,F,100,17,0,17
Tereso,M,100,0,17,17
Terrea,F,100,17,0,17
Tersa,F,100,17,0,17
Thanya,F,100,17,0,17
Thijs,M,100,0,17,17
Thoms,M,100,0,17,17
Thuan,M,100,0,17,17
Tiamarie,F,100,17,0,17
Tida,F,100,17,0,17
Tiea,F,100,17,0,17
Tierah,F,100,17,0,17
Tilford,M,100,0,17,17
Tinzlee,F,100,17,0,17
Todrick,M,100,0,17,17
Tolulope,F,100,17,0,17
Toniesha,F,100,17,0,17
Torres,M,100,0,17,17
Trachelle,F,100,17,0,17
Traevion,M,100,0,17,17
Traivon,M,100,0,17,17
Tramar,M,100,0,17,17
Travarius,M,100,0,17,17
Travius,M,100,0,17,17
Travoris,M,100,0,17,17
Trenisha,F,100,17,0,17
Treylen,M,100,0,17,17
Treylin,M,100,0,17,17
Trischa,F,100,17,0,17
Trishelle,F,100,17,0,17
Trishna,F,100,17,0,17
Tudor,M,100,0,17,17
Tung,M,100,0,17,17
Tyannah,F,100,17,0,17
Tyauna,F,100,17,0,17
Tykee,M,100,0,17,17
Tykerria,F,100,17,0,17
Tylisa,F,100,17,0,17
Tymira,F,100,17,0,17
Tyreck,M,100,0,17,17
Ulis,M,100,0,17,17
Ulrick,M,100,0,17,17
Uthman,M,100,0,17,17
Vahe,M,100,0,17,17
Vaidehi,F,100,17,0,17
Valari,F,100,17,0,17
Valoree,F,100,17,0,17
Vanice,F,100,17,0,17
Vannie,F,71,12,5,17
Varina,F,100,17,0,17
Venicia,F,100,17,0,17
Vennie,F,100,17,0,17
Vidit,M,100,0,17,17
Vonzell,M,100,0,17,17
Waunita,F,100,17,0,17
Weylyn,M,100,0,17,17
Whitni,F,100,17,0,17
Whittany,F,100,17,0,17
Wilberth,M,100,0,17,17
Williard,M,100,0,17,17
Willim,M,100,0,17,17
Windle,M,100,0,17,17
Xariah,F,100,17,0,17
Xee,F,100,17,0,17
Xxavier,M,100,0,17,17
Yacine,M,65,6,11,17
Yarethzy,F,100,17,0,17
Yarieliz,F,100,17,0,17
Yazmyne,F,100,17,0,17
Yerlin,F,100,17,0,17
Ylianna,F,100,17,0,17
Yoandri,M,100,0,17,17
Yorley,F,100,17,0,17
Yovan,M,100,0,17,17
Yuette,F,100,17,0,17
Yussef,M,100,0,17,17
Zadia,F,100,17,0,17
Zaheer,M,100,0,17,17
Zaidin,M,100,0,17,17
Zaliah,F,100,17,0,17
Zamoria,F,100,17,0,17
Zandyr,M,100,0,17,17
Zannie,M,100,0,17,17
Zarif,M,100,0,17,17
Zaydn,M,100,0,17,17
Zayley,F,100,17,0,17
Zeanna,F,100,17,0,17
Zebulan,M,100,0,17,17
Zeniya,F,100,17,0,17
Zera,F,100,17,0,17
Zeynab,F,100,17,0,17
Zhaire,M,100,0,17,17
Zhamir,M,100,0,17,17
Zhion,M,100,0,17,17
Ziomara,F,100,17,0,17
Zoiee,F,100,17,0,17
Zuhair,M,100,0,17,17
Zurielle,F,100,17,0,17
Zyaria,F,100,17,0,17
Zyheir,M,100,0,17,17
Zykeriah,F,100,17,0,17
Zynique,F,100,17,0,17
Zyshonne,M,100,0,17,17
Abbagayle,F,100,16,0,16
Abdulkadir,M,100,0,16,16
Abdulraheem,M,100,0,16,16
Accalia,F,100,16,0,16
Acsa,F,100,16,0,16
Adalaya,F,100,16,0,16
Adar,M,69,5,11,16
Adesuwa,F,100,16,0,16
Adianez,F,100,16,0,16
Adilyne,F,100,16,0,16
Adorabella,F,100,16,0,16
Adyen,M,100,0,16,16
Ahaana,F,100,16,0,16
Ahlaya,F,100,16,0,16
Aidaly,F,100,16,0,16
Aidian,M,100,0,16,16
Airalyn,F,100,16,0,16
Airalynn,F,100,16,0,16
Airyn,F,69,11,5,16
Aishat,F,100,16,0,16
Ajwa,F,100,16,0,16
Akhilesh,M,100,0,16,16
Akoni,M,100,0,16,16
Alaisia,F,100,16,0,16
Alamea,F,100,16,0,16
Alberth,M,100,0,16,16
Albie,M,100,0,16,16
Aleicia,F,100,16,0,16
Alexsys,F,100,16,0,16
Aliea,F,100,16,0,16
Alimah,F,100,16,0,16
Alithia,F,100,16,0,16
Alleen,F,100,16,0,16
Almee,F,100,16,0,16
Alphonsa,M,100,0,16,16
Alvenia,F,100,16,0,16
Amanii,F,100,16,0,16
Amarrion,M,100,0,16,16
Amdrew,M,100,0,16,16
Amenah,F,100,16,0,16
Ammanda,F,100,16,0,16
Amritha,F,100,16,0,16
Amylynn,F,100,16,0,16
Anastasha,F,100,16,0,16
Andoni,M,100,0,16,16
Andriel,M,100,0,16,16
Anett,F,100,16,0,16
Anida,F,100,16,0,16
Aniella,F,100,16,0,16
Aniketh,M,100,0,16,16
Anothy,M,100,0,16,16
Antinette,F,100,16,0,16
Antonine,M,100,0,16,16
Antrone,M,100,0,16,16
Antwion,M,100,0,16,16
Anvith,M,100,0,16,16
Ardena,F,100,16,0,16
Areg,M,100,0,16,16
Arelyn,F,100,16,0,16
Aribelle,F,100,16,0,16
Ario,M,100,0,16,16
Arlecia,F,100,16,0,16
Arlester,M,100,0,16,16
Arra,F,100,16,0,16
Arriyah,F,100,16,0,16
Arthurine,F,100,16,0,16
Ashni,F,100,16,0,16
Aslin,F,100,16,0,16
Atianna,F,100,16,0,16
Aubrianne,F,100,16,0,16
Augustino,M,100,0,16,16
Aundreya,F,100,16,0,16
Aunya,F,100,16,0,16
Autumnrose,F,100,16,0,16
Avarae,F,100,16,0,16
Aveena,F,100,16,0,16
Avorie,F,100,16,0,16
Avyon,M,100,0,16,16
Awad,M,100,0,16,16
Axavier,M,100,0,16,16
Axzel,M,100,0,16,16
Ayaana,F,100,16,0,16
Ayad,M,100,0,16,16
Ayriel,F,100,16,0,16
Ayza,F,100,16,0,16
Azadeh,F,100,16,0,16
Azalya,F,100,16,0,16
Azalyn,F,100,16,0,16
Azariel,M,100,0,16,16
Azarriah,F,100,16,0,16
Azriella,F,100,16,0,16
Babs,F,100,16,0,16
Baeleigh,F,100,16,0,16
Baer,M,100,0,16,16
Bailea,F,100,16,0,16
Bartt,M,100,0,16,16
Bastion,M,100,0,16,16
Beckhem,M,100,0,16,16
Benjerman,M,100,0,16,16
Benjimin,M,100,0,16,16
Bernarda,F,100,16,0,16
Bernedette,F,100,16,0,16
Bertis,M,100,0,16,16
Bettyjean,F,100,16,0,16
Bharat,M,100,0,16,16
Birdia,F,100,16,0,16
Blaklee,F,100,16,0,16
Bland,M,100,0,16,16
Bobbe,F,100,16,0,16
Bocephus,M,100,0,16,16
Brack,M,100,0,16,16
Brandii,F,100,16,0,16
Breeya,F,100,16,0,16
Brevon,M,100,0,16,16
Briahnna,F,100,16,0,16
Bricyn,M,100,0,16,16
Bridgitt,F,100,16,0,16
Briela,F,100,16,0,16
Brieonna,F,100,16,0,16
Briggett,F,100,16,0,16
Brinden,M,100,0,16,16
Brinsley,F,100,16,0,16
Britanni,F,100,16,0,16
Britiney,F,100,16,0,16
Brode,M,100,0,16,16
Brolin,M,100,0,16,16
Brynlynn,F,100,16,0,16
Caelee,F,100,16,0,16
Cambrey,F,100,16,0,16
Candita,F,100,16,0,16
Caress,F,100,16,0,16
Carianna,F,100,16,0,16
Carlei,F,100,16,0,16
Carmeron,M,100,0,16,16
Carolan,F,100,16,0,16
Caroleen,F,100,16,0,16
Cassandria,F,100,16,0,16
Catalena,F,100,16,0,16
Cathalina,F,100,16,0,16
Cathye,F,100,16,0,16
Catlynn,F,100,16,0,16
Caylor,F,69,11,5,16
Cejay,M,100,0,16,16
Celida,F,100,16,0,16
Celise,F,100,16,0,16
Cesiah,F,100,16,0,16
Chais,M,100,0,16,16
Chalene,F,100,16,0,16
Champayne,F,100,16,0,16
Channie,F,100,16,0,16
Chareese,F,100,16,0,16
Charidy,F,100,16,0,16
Charlaine,F,100,16,0,16
Chatham,M,100,0,16,16
Chealsey,F,100,16,0,16
Chellsea,F,100,16,0,16
Chene,F,100,16,0,16
Cherisa,F,100,16,0,16
Cheronda,F,100,16,0,16
Cheyane,F,100,16,0,16
Chezney,F,100,16,0,16
Chioke,M,100,0,16,16
Christyanna,F,100,16,0,16
Ciria,F,100,16,0,16
Clayburn,M,100,0,16,16
Cleotis,M,100,0,16,16
Clif,M,100,0,16,16
Clinten,M,100,0,16,16
Clotilde,F,100,16,0,16
Cloyce,M,100,0,16,16
Cobain,M,100,0,16,16
Colbe,M,100,0,16,16
Colburn,M,100,0,16,16
Colee,F,100,16,0,16
Conception,F,100,16,0,16
Coralina,F,100,16,0,16
Corbet,M,100,0,16,16
Cordai,M,100,0,16,16
Cordon,M,100,0,16,16
Cornisha,F,100,16,0,16
Corona,F,100,16,0,16
Corydon,M,100,0,16,16
Cote,M,100,0,16,16
Couture,F,100,16,0,16
Cowan,M,100,0,16,16
Creg,M,100,0,16,16
Cung,M,100,0,16,16
Curissa,F,100,16,0,16
Cyara,F,100,16,0,16
Daegen,M,100,0,16,16
Daekwon,M,100,0,16,16
Daffney,F,100,16,0,16
Dahir,M,100,0,16,16
Daily,F,100,16,0,16
Daisuke,M,100,0,16,16
Daizha,F,100,16,0,16
Dajanay,F,100,16,0,16
Dajion,M,100,0,16,16
Dalayla,F,100,16,0,16
Dalaysia,F,100,16,0,16
Danashia,F,100,16,0,16
Danaysia,F,100,16,0,16
Daniqua,F,100,16,0,16
Daniyla,F,100,16,0,16
Danley,M,100,0,16,16
Dareion,M,100,0,16,16
Darrie,M,69,5,11,16
Dashae,F,100,16,0,16
Daveigh,F,100,16,0,16
Davius,M,100,0,16,16
Dayanni,F,100,16,0,16
Daziya,F,100,16,0,16
Deamber,F,100,16,0,16
Deavian,F,100,16,0,16
Debrina,F,100,16,0,16
Delrick,M,100,0,16,16
Demara,F,100,16,0,16
Demetries,M,100,0,16,16
Denai,F,100,16,0,16
Denecia,F,100,16,0,16
Deny,M,100,0,16,16
Dereonna,F,100,16,0,16
Deretha,F,100,16,0,16
Devanshi,F,100,16,0,16
Deveion,M,100,0,16,16
Dietrick,M,100,0,16,16
Dinesha,F,100,16,0,16
Diyana,F,100,16,0,16
Djuna,F,100,16,0,16
Dmiya,F,100,16,0,16
Dmoni,M,100,0,16,16
Donevan,M,100,0,16,16
Donquez,M,100,0,16,16
Dontavia,F,100,16,0,16
Dorcus,F,100,16,0,16
Doryan,M,100,0,16,16
Doua,M,62,6,10,16
Drayce,M,100,0,16,16
Drianna,F,100,16,0,16
Dyasia,F,100,16,0,16
Dylyn,M,100,0,16,16
Dylynn,F,100,16,0,16
Dynastee,F,100,16,0,16
Eddi,M,62,6,10,16
Ege,M,100,0,16,16
Eibhlin,F,100,16,0,16
Eilah,F,100,16,0,16
Eilley,F,100,16,0,16
Eiman,F,100,16,0,16
Elianie,F,100,16,0,16
Elisabella,F,100,16,0,16
Elmon,M,100,0,16,16
Elohim,M,100,0,16,16
Else,F,100,16,0,16
Emah,F,100,16,0,16
Emalea,F,100,16,0,16
Emerita,F,100,16,0,16
Emileah,F,100,16,0,16
Emilya,F,100,16,0,16
Emmaclaire,F,100,16,0,16
Emmilia,F,100,16,0,16
Emnet,F,100,16,0,16
Equan,M,100,0,16,16
Erine,F,100,16,0,16
Erricka,F,100,16,0,16
Esias,M,100,0,16,16
Esmay,F,100,16,0,16
Esveidy,F,100,16,0,16
Etha,F,100,16,0,16
Eufemia,F,100,16,0,16
Euriah,M,100,0,16,16
Evalisse,F,100,16,0,16
Evangelin,F,100,16,0,16
Everrett,M,100,0,16,16
Eward,M,100,0,16,16
Exavior,M,100,0,16,16
Eyva,F,100,16,0,16
Ezmerelda,F,100,16,0,16
Faizaan,M,100,0,16,16
Fareeha,F,100,16,0,16
Feng,M,100,0,16,16
Ferdinando,M,100,0,16,16
Fiana,F,100,16,0,16
Fitzpatrick,M,100,0,16,16
Fleeta,F,100,16,0,16
Forestine,F,100,16,0,16
Francee,F,100,16,0,16
Francelia,F,100,16,0,16
Fransheska,F,100,16,0,16
Fredrico,M,100,0,16,16
Furkan,M,100,0,16,16
Gardiner,M,100,0,16,16
Gaynel,F,100,16,0,16
Gedeon,M,100,0,16,16
Genavive,F,100,16,0,16
Gennette,F,100,16,0,16
Geraline,F,100,16,0,16
Gevork,M,100,0,16,16
Gianah,F,100,16,0,16
Gilma,F,100,16,0,16
Glady,F,100,16,0,16
Godson,M,100,0,16,16
Govind,M,100,0,16,16
Gracianna,F,100,16,0,16
Gradon,M,100,0,16,16
Graiden,M,100,0,16,16
Granite,M,100,0,16,16
Grisell,F,100,16,0,16
Gurtaj,M,100,0,16,16
Gwendloyn,F,100,16,0,16
Hadas,F,100,16,0,16
Hadlei,F,100,16,0,16
Haidynn,F,100,16,0,16
Hajrah,F,100,16,0,16
Halayna,F,100,16,0,16
Harkirat,M,62,6,10,16
Hartleigh,F,100,16,0,16
Harutyun,M,100,0,16,16
Harvy,M,100,0,16,16
Heaton,M,100,0,16,16
Heiley,F,100,16,0,16
Heraclio,M,100,0,16,16
Heran,F,100,16,0,16
Herny,M,100,0,16,16
Hikeem,M,100,0,16,16
Hiren,M,100,0,16,16
Houa,F,56,9,7,16
Hrithik,M,100,0,16,16
Huntlee,F,69,11,5,16
Idelle,F,100,16,0,16
Ilisa,F,100,16,0,16
Imya,F,100,16,0,16
Inetta,F,100,16,0,16
Innocence,F,100,16,0,16
Inocente,M,100,0,16,16
Ioane,M,100,0,16,16
Issai,M,100,0,16,16
Ivoree,F,100,16,0,16
Izebella,F,100,16,0,16
Izola,F,100,16,0,16
Izumi,F,100,16,0,16
Izzak,M,100,0,16,16
Jackye,F,100,16,0,16
Jacody,M,100,0,16,16
Jacquese,F,100,16,0,16
Jacquise,F,69,11,5,16
Jadarion,M,100,0,16,16
Jadda,F,100,16,0,16
Jaeleah,F,100,16,0,16
Jag,M,100,0,16,16
Jahaire,M,100,0,16,16
Jahid,M,100,0,16,16
Jahniah,F,100,16,0,16
Jahzarra,F,100,16,0,16
Jaidence,F,100,16,0,16
Jakell,M,100,0,16,16
Jakiyla,F,100,16,0,16
Jakory,M,100,0,16,16
Jalila,F,100,16,0,16
Jaline,F,100,16,0,16
Jameeka,F,100,16,0,16
Jameriah,F,100,16,0,16
Jamesen,M,100,0,16,16
Jamicia,F,100,16,0,16
Jamise,F,100,16,0,16
Janiaya,F,100,16,0,16
Janssen,M,100,0,16,16
Jarmarcus,M,100,0,16,16
Jarrius,M,100,0,16,16
Jaslen,F,100,16,0,16
Jatavian,M,100,0,16,16
Javani,M,100,0,16,16
Jaxden,M,100,0,16,16
Jaydalee,F,100,16,0,16
Jaydem,M,100,0,16,16
Jaydynn,F,69,11,5,16
Jayel,F,69,11,5,16
Jaylanni,F,100,16,0,16
Jayleon,M,100,0,16,16
Jaynell,F,100,16,0,16
Jaza,F,100,16,0,16
Jazmeen,F,100,16,0,16
Jazzalynn,F,100,16,0,16
Jearline,F,100,16,0,16
Jenavecia,F,100,16,0,16
Jenie,F,100,16,0,16
Jeniel,M,100,0,16,16
Jennay,F,100,16,0,16
Jenniah,F,100,16,0,16
Jerah,F,100,16,0,16
Jeremee,M,100,0,16,16
Jeronda,F,100,16,0,16
Jesseka,F,100,16,0,16
Jessicaann,F,100,16,0,16
Jhamari,M,100,0,16,16
Jiali,F,100,16,0,16
Jimma,F,100,16,0,16
Jizel,F,100,16,0,16
Jocilynn,F,100,16,0,16
Joclynn,F,100,16,0,16
Jode,F,100,16,0,16
Joen,M,69,5,11,16
Johncharles,M,100,0,16,16
Jolyne,F,100,16,0,16
Joniya,F,100,16,0,16
Joquan,M,100,0,16,16
Jordyan,F,100,16,0,16
Josealberto,M,100,0,16,16
Josejulian,M,100,0,16,16
Joshuan,M,100,0,16,16
Josselynn,F,100,16,0,16
Josslin,F,100,16,0,16
Josuel,M,100,0,16,16
Joury,F,100,16,0,16
Jowel,M,100,0,16,16
Jozelynn,F,100,16,0,16
Judaea,F,100,16,0,16
Julane,F,100,16,0,16
Juma,M,100,0,16,16
Jurnei,F,100,16,0,16
Jyll,F,100,16,0,16
Jyra,F,100,16,0,16
Kadince,F,100,16,0,16
Kadynn,F,100,16,0,16
Kahlin,M,69,5,11,16
Kaidynn,M,56,7,9,16
Kailena,F,100,16,0,16
Kainoah,M,100,0,16,16
Kaitlinn,F,100,16,0,16
Kalid,M,100,0,16,16
Kaliope,F,100,16,0,16
Kaliyan,F,100,16,0,16
Kalkidan,F,100,16,0,16
Kamarria,F,100,16,0,16
Kamaury,M,100,0,16,16
Kamuela,M,100,0,16,16
Karcyn,F,100,16,0,16
Karlisa,F,100,16,0,16
Karmynn,F,100,16,0,16
Kasean,M,100,0,16,16
Kashara,F,100,16,0,16
Kateleen,F,100,16,0,16
Katherne,F,100,16,0,16
Katoria,F,100,16,0,16
Katti,F,100,16,0,16
Kavari,M,100,0,16,16
Kayhan,M,100,0,16,16
Kaysea,F,100,16,0,16
Keashia,F,100,16,0,16
Keats,M,100,0,16,16
Keeon,M,100,0,16,16
Keevan,M,100,0,16,16
Keeyan,M,100,0,16,16
Keiarah,F,100,16,0,16
Keijuan,M,100,0,16,16
Keisuke,M,100,0,16,16
Keldan,M,100,0,16,16
Kellea,F,100,16,0,16
Kemisha,F,100,16,0,16
Kenedie,F,100,16,0,16
Kenichi,M,100,0,16,16
Kenidi,F,100,16,0,16
Kenlea,F,100,16,0,16
Kenneith,M,100,0,16,16
Kenry,M,100,0,16,16
Kerstie,F,100,16,0,16
Keshara,F,100,16,0,16
Ketsia,F,100,16,0,16
Khailee,F,100,16,0,16
Khailey,F,100,16,0,16
Khalise,F,100,16,0,16
Khamiyah,F,100,16,0,16
Khamora,F,100,16,0,16
Kharlie,F,100,16,0,16
Khian,M,100,0,16,16
Khristi,F,100,16,0,16
Khrystina,F,100,16,0,16
Khye,M,100,0,16,16
Kiam,M,100,0,16,16
Kijana,M,69,5,11,16
Kimba,F,100,16,0,16
Kimberlly,F,100,16,0,16
Kimetha,F,100,16,0,16
Kinesha,F,100,16,0,16
Kiondra,F,100,16,0,16
Kiowa,M,56,7,9,16
Kirbi,F,100,16,0,16
Kissie,F,100,16,0,16
Kissy,F,100,16,0,16
Klyde,M,100,0,16,16
Koray,M,100,0,16,16
Kordel,M,100,0,16,16
Koron,M,100,0,16,16
Kortny,F,100,16,0,16
Kosei,M,100,0,16,16
Kouper,M,100,0,16,16
Krisette,F,100,16,0,16
Krystyne,F,100,16,0,16
Kwanza,F,100,16,0,16
Kyleigha,F,100,16,0,16
Kyona,F,100,16,0,16
Kyzen,M,100,0,16,16
Ladarrious,M,100,0,16,16
Lakeyia,F,100,16,0,16
Lakiah,F,100,16,0,16
Lakoda,M,100,0,16,16
Lakyah,F,100,16,0,16
Lakyla,F,100,16,0,16
Lanaiya,F,100,16,0,16
Lariza,F,100,16,0,16
Laruth,F,100,16,0,16
Larysa,F,100,16,0,16
Lashai,F,100,16,0,16
Lasheika,F,100,16,0,16
Latajah,F,100,16,0,16
Latanja,F,100,16,0,16
Latyra,F,100,16,0,16
Laurenashley,F,100,16,0,16
Lavonn,F,62,10,6,16
Layaan,F,100,16,0,16
Laylia,F,100,16,0,16
Leanord,M,100,0,16,16
Leiden,M,100,0,16,16
Leili,F,100,16,0,16
Leman,M,100,0,16,16
Lennex,F,62,10,6,16
Lennin,M,100,0,16,16
Leonell,M,100,0,16,16
Lequisha,F,100,16,0,16
Lesieli,F,100,16,0,16
Lesle,F,100,16,0,16
Lessa,F,100,16,0,16
Lesta,F,100,16,0,16
Leto,M,100,0,16,16
Lexianna,F,100,16,0,16
Liahm,M,100,0,16,16
Lihanna,F,100,16,0,16
Lilliannah,F,100,16,0,16
Lillyauna,F,100,16,0,16
Lilygrace,F,100,16,0,16
Linlee,F,100,16,0,16
Linnell,M,69,5,11,16
Loden,M,100,0,16,16
Loise,F,100,16,0,16
Loredana,F,100,16,0,16
Lucillia,F,100,16,0,16
Lujean,F,100,16,0,16
Lyllie,F,100,16,0,16
Lynanne,F,100,16,0,16
Lynisha,F,100,16,0,16
Maan,M,100,0,16,16
Macall,F,100,16,0,16
Macelyn,F,100,16,0,16
Macio,M,100,0,16,16
Mackinsey,F,100,16,0,16
Madalee,F,100,16,0,16
Madia,F,100,16,0,16
Madysyn,F,100,16,0,16
Magaby,F,100,16,0,16
Mahasin,F,100,16,0,16
Maicee,F,100,16,0,16
Maicy,F,100,16,0,16
Mairely,F,100,16,0,16
Makahla,F,100,16,0,16
Makaylan,F,100,16,0,16
Makayle,F,100,16,0,16
Makenli,F,100,16,0,16
Makylie,F,100,16,0,16
Malacai,M,100,0,16,16
Malashia,F,100,16,0,16
Maliyani,F,100,16,0,16
Mang,M,69,5,11,16
Manvi,F,100,16,0,16
Marcayla,F,100,16,0,16
Marcellas,M,100,0,16,16
Maresha,F,100,16,0,16
Margrette,F,100,16,0,16
Mariaeduarda,F,100,16,0,16
Mariali,F,100,16,0,16
Mariamawit,F,100,16,0,16
Marieke,F,100,16,0,16
Marietou,F,100,16,0,16
Marigrace,F,100,16,0,16
Marisal,F,100,16,0,16
Maritta,F,100,16,0,16
Maron,M,100,0,16,16
Marquail,M,100,0,16,16
Marquarius,M,100,0,16,16
Marri,F,100,16,0,16
Maryonna,F,100,16,0,16
Masato,M,100,0,16,16
Matylda,F,100,16,0,16
Mayes,M,100,0,16,16
Mckynlie,F,100,16,0,16
Mckynna,F,100,16,0,16
Meaghen,F,100,16,0,16
Meerab,F,100,16,0,16
Mekhia,F,100,16,0,16
Melainie,F,100,16,0,16
Melane,F,100,16,0,16
Melaysia,F,100,16,0,16
Meric,M,100,0,16,16
Meridee,F,100,16,0,16
Micai,M,100,0,16,16
Mieshia,F,100,16,0,16
Miklos,M,100,0,16,16
Milano,M,100,0,16,16
Minal,F,100,16,0,16
Mishal,F,100,16,0,16
Mitesh,M,100,0,16,16
Mj,M,100,0,16,16
Moe,F,56,9,7,16
Moishy,M,100,0,16,16
Molina,F,100,16,0,16
Monai,F,100,16,0,16
Morenike,F,100,16,0,16
Mubashir,M,100,0,16,16
Muhammadali,M,100,0,16,16
Musiq,M,69,5,11,16
Mykeal,M,100,0,16,16
Mylove,F,100,16,0,16
Mylynn,F,100,16,0,16
Myreon,M,100,0,16,16
Naif,M,100,0,16,16
Naiyana,F,100,16,0,16
Nakeysha,F,100,16,0,16
Nakkia,F,100,16,0,16
Nansi,F,100,16,0,16
Nao,F,100,16,0,16
Naod,M,100,0,16,16
Nare,F,100,16,0,16
Natily,F,100,16,0,16
Naveena,F,100,16,0,16
Navina,F,100,16,0,16
Nayel,M,100,0,16,16
Nazyiah,F,100,16,0,16
Neiva,F,100,16,0,16
Neshia,F,100,16,0,16
Nevae,F,100,16,0,16
Neyah,F,100,16,0,16
Neylan,M,69,5,11,16
Nghi,F,69,11,5,16
Nickcole,F,100,16,0,16
Nikalas,M,100,0,16,16
Nikeshia,F,100,16,0,16
Ninoshka,F,100,16,0,16
Niralya,F,100,16,0,16
Nishat,F,100,16,0,16
Nishita,F,100,16,0,16
Nitzia,F,100,16,0,16
Niveen,F,100,16,0,16
Nohelani,F,100,16,0,16
Novalynn,F,100,16,0,16
Nury,F,100,16,0,16
Nusaiba,F,100,16,0,16
Nusayba,F,100,16,0,16
Nychelle,F,100,16,0,16
Nyriah,F,100,16,0,16
Odella,F,100,16,0,16
Oladimeji,M,100,0,16,16
Oliverio,M,100,0,16,16
Oluwatomiwa,M,100,0,16,16
Omauri,M,100,0,16,16
Oneyda,F,100,16,0,16
Orlandus,M,100,0,16,16
Oronde,M,100,0,16,16
Orvel,M,100,0,16,16
Osei,M,100,0,16,16
Otila,F,100,16,0,16
Ovid,M,100,0,16,16
Ozil,M,100,0,16,16
Paddy,F,69,11,5,16
Pahoua,F,100,16,0,16
Pamlea,F,100,16,0,16
Panhia,F,100,16,0,16
Parul,F,100,16,0,16
Pattrick,M,100,0,16,16
Pearse,M,100,0,16,16
Pepe,M,100,0,16,16
Philena,F,100,16,0,16
Phillipa,F,100,16,0,16
Phylisha,F,100,16,0,16
Piersen,M,100,0,16,16
Piya,F,100,16,0,16
Prakriti,F,100,16,0,16
Praneeth,M,100,0,16,16
Prapti,F,100,16,0,16
Prathik,M,100,0,16,16
Priyah,F,100,16,0,16
Quamel,M,100,0,16,16
Quanika,F,100,16,0,16
Quanta,M,69,5,11,16
Quantaya,F,100,16,0,16
Rabekah,F,100,16,0,16
Rachyl,F,100,16,0,16
Rafeef,F,100,16,0,16
Raiyah,F,100,16,0,16
Rajvir,M,100,0,16,16
Ran,M,69,5,11,16
Ranie,F,100,16,0,16
Rawleigh,M,100,0,16,16
Rayhaan,M,100,0,16,16
Raysha,F,100,16,0,16
Red,M,100,0,16,16
Reene,F,100,16,0,16
Regann,F,100,16,0,16
Relda,F,100,16,0,16
Renatha,F,100,16,0,16
Renella,F,100,16,0,16
Reshad,M,100,0,16,16
Rett,M,100,0,16,16
Rhyon,M,56,7,9,16
Riaz,M,100,0,16,16
Richetta,F,100,16,0,16
Rikishi,M,62,6,10,16
Rilen,M,100,0,16,16
Rin,F,100,16,0,16
Rini,F,100,16,0,16
Rinnah,F,100,16,0,16
Riti,F,100,16,0,16
Robson,M,100,0,16,16
Rocsi,F,100,16,0,16
Rodel,M,100,0,16,16
Rodgers,M,100,0,16,16
Rodneisha,F,100,16,0,16
Roena,F,100,16,0,16
Rolin,M,100,0,16,16
Romance,M,100,0,16,16
Romir,M,100,0,16,16
Romone,M,100,0,16,16
Rondrick,M,100,0,16,16
Roniah,F,100,16,0,16
Roniesha,F,100,16,0,16
Ronith,M,100,0,16,16
Ronnika,F,100,16,0,16
Ronte,M,100,0,16,16
Rosalene,F,100,16,0,16
Roselani,F,100,16,0,16
Rubens,M,100,0,16,16
Rupa,F,100,16,0,16
Rushton,M,100,0,16,16
Ryleeann,F,100,16,0,16
Ryliee,F,100,16,0,16
Ryllie,F,100,16,0,16
Sabriel,F,69,11,5,16
Sadae,F,100,16,0,16
Sae,F,69,11,5,16
Sahan,M,100,0,16,16
Samaad,M,100,0,16,16
Samauri,F,69,11,5,16
Sanjna,F,100,16,0,16
Saree,F,100,16,0,16
Saunya,F,100,16,0,16
Savannaha,F,100,16,0,16
Savyon,M,100,0,16,16
Saysha,F,100,16,0,16
Segundo,M,100,0,16,16
Selassie,M,100,0,16,16
Semaje,M,100,0,16,16
Semya,F,100,16,0,16
Senan,M,100,0,16,16
Senay,M,100,0,16,16
Sender,M,100,0,16,16
Senica,M,69,5,11,16
Serenah,F,100,16,0,16
Shadavia,F,100,16,0,16
Shaeli,F,100,16,0,16
Shahzain,M,100,0,16,16
Shail,M,100,0,16,16
Shakeera,F,100,16,0,16
Shakya,F,100,16,0,16
Shalicia,F,100,16,0,16
Shalie,F,100,16,0,16
Shametra,F,100,16,0,16
Shaneil,F,100,16,0,16
Shanicqua,F,100,16,0,16
Shankia,F,100,16,0,16
Shantai,F,100,16,0,16
Shantil,F,100,16,0,16
Shanty,F,100,16,0,16
Shaqueena,F,100,16,0,16
Sharine,F,100,16,0,16
Sharvi,F,100,16,0,16
Shatonia,F,100,16,0,16
Shawndrea,F,100,16,0,16
Shawnic,F,100,16,0,16
Shawnique,F,100,16,0,16
Shawnn,F,62,10,6,16
Shawntez,M,100,0,16,16
Shayon,M,100,0,16,16
Shehab,M,100,0,16,16
Shemiah,F,100,16,0,16
Shenese,F,100,16,0,16
Shequila,F,100,16,0,16
Shervin,M,100,0,16,16
Shevaun,F,100,16,0,16
Shevonda,F,100,16,0,16
Shiheem,M,100,0,16,16
Shikara,F,100,16,0,16
Shikira,F,100,16,0,16
Shirel,F,100,16,0,16
Shonia,F,100,16,0,16
Shuayb,M,100,0,16,16
Shweta,F,100,16,0,16
Shylin,F,100,16,0,16
Sidi,M,100,0,16,16
Simaya,F,100,16,0,16
Siria,F,100,16,0,16
Skila,F,100,16,0,16
Skyann,F,100,16,0,16
Skyrah,F,100,16,0,16
Smayan,M,100,0,16,16
Smyan,M,100,0,16,16
Sola,F,100,16,0,16
Solan,M,100,0,16,16
Soli,F,100,16,0,16
Sookie,F,100,16,0,16
Sophira,F,100,16,0,16
Sophonie,F,100,16,0,16
Soraiya,F,100,16,0,16
Sorayah,F,100,16,0,16
Spyros,M,100,0,16,16
Stacha,F,100,16,0,16
Stamatia,F,100,16,0,16
Staphany,F,100,16,0,16
Starkisha,F,100,16,0,16
Sten,M,100,0,16,16
Stephaie,F,100,16,0,16
Stesha,F,100,16,0,16
Sudiksha,F,100,16,0,16
Suheyb,M,100,0,16,16
Sukaina,F,100,16,0,16
Suleika,F,100,16,0,16
Sunaina,F,100,16,0,16
Susen,F,100,16,0,16
Symphoni,F,100,16,0,16
Taaliyah,F,100,16,0,16
Tabithia,F,100,16,0,16
Taci,F,100,16,0,16
Tahjai,M,69,5,11,16
Tahjay,M,100,0,16,16
Tahra,F,100,16,0,16
Taimane,F,100,16,0,16
Taiz,F,100,16,0,16
Tajha,F,100,16,0,16
Takelia,F,100,16,0,16
Takema,F,100,16,0,16
Talishia,F,100,16,0,16
Tallia,F,100,16,0,16
Tallula,F,100,16,0,16
Tammee,F,100,16,0,16
Tanaisha,F,100,16,0,16
Tanaiya,F,100,16,0,16
Tanashia,F,100,16,0,16
Tanee,F,100,16,0,16
Tasfia,F,100,16,0,16
Tashonna,F,100,16,0,16
Tavaras,M,100,0,16,16
Taviana,F,100,16,0,16
Tawonda,F,100,16,0,16
Taydem,F,100,16,0,16
Teauna,F,100,16,0,16
Temia,F,100,16,0,16
Tene,F,100,16,0,16
Tenessa,F,100,16,0,16
Teniola,F,100,16,0,16
Tenoch,M,100,0,16,16
Tephanie,F,100,16,0,16
Tequia,F,100,16,0,16
Tereka,F,100,16,0,16
Teshaun,M,100,0,16,16
Thamara,F,100,16,0,16
Thanvi,F,100,16,0,16
Theopolis,M,100,0,16,16
Thoams,M,100,0,16,16
Tiandre,M,100,0,16,16
Tifini,F,100,16,0,16
Tija,F,100,16,0,16
Tilia,F,100,16,0,16
Tinnie,F,100,16,0,16
Tirso,M,100,0,16,16
Tomeshia,F,100,16,0,16
Tomoko,F,100,16,0,16
Torion,M,100,0,16,16
Tovi,M,100,0,16,16
Tracer,M,100,0,16,16
Trai,M,100,0,16,16
Traycen,M,100,0,16,16
Trell,M,100,0,16,16
Tremeka,F,100,16,0,16
Treson,M,100,0,16,16
Trevione,M,100,0,16,16
Trieste,F,100,16,0,16
Triva,F,100,16,0,16
Trynitee,F,100,16,0,16
Tryphena,F,100,16,0,16
Twylla,F,100,16,0,16
Tyhesha,F,100,16,0,16
Tyland,M,100,0,16,16
Tymar,M,100,0,16,16
Tyshae,F,100,16,0,16
Tyshea,F,100,16,0,16
Utah,M,100,0,16,16
Vandana,F,100,16,0,16
Vandell,M,100,0,16,16
Vanette,F,100,16,0,16
Vaya,F,100,16,0,16
Veanna,F,100,16,0,16
Vedh,M,100,0,16,16
Velita,F,100,16,0,16
Verba,F,100,16,0,16
Vermell,F,100,16,0,16
Vernel,M,100,0,16,16
Vernesha,F,100,16,0,16
Victorine,F,100,16,0,16
Vitaly,M,100,0,16,16
Vivika,F,100,16,0,16
Volanda,F,100,16,0,16
Vona,F,100,16,0,16
Wen,F,50,8,8,16
Wilhelmena,F,100,16,0,16
Winta,F,100,16,0,16
Wyn,M,69,5,11,16
Wyndi,F,100,16,0,16
Xitllali,F,100,16,0,16
Yacoub,M,100,0,16,16
Yajahira,F,100,16,0,16
Yakub,M,100,0,16,16
Yalena,F,100,16,0,16
Yania,F,100,16,0,16
Yanky,M,100,0,16,16
Yarelin,F,100,16,0,16
Yarithza,F,100,16,0,16
Yasmyn,F,100,16,0,16
Yavin,M,100,0,16,16
Yeiden,M,100,0,16,16
Yisell,F,100,16,0,16
Yomara,F,100,16,0,16
Yomaris,F,100,16,0,16
Yosmar,M,100,0,16,16
Yukari,F,100,16,0,16
Yuniel,M,100,0,16,16
Zaccheaus,M,100,0,16,16
Zaequan,M,100,0,16,16
Zalyn,M,100,0,16,16
Zamariyah,F,100,16,0,16
Zanylah,F,100,16,0,16
Zarae,F,100,16,0,16
Zee,M,100,0,16,16
Zenith,M,100,0,16,16
Zhanae,F,100,16,0,16
Zhaniya,F,100,16,0,16
Zniya,F,100,16,0,16
Zollie,M,100,0,16,16
Zyden,M,100,0,16,16
Zyen,M,100,0,16,16
Zymira,F,100,16,0,16
Aaditri,F,100,15,0,15
Aaisha,F,100,15,0,15
Aaliyana,F,100,15,0,15
Aanshi,F,100,15,0,15
Aarib,M,100,0,15,15
Aarilyn,F,100,15,0,15
Aayana,F,100,15,0,15
Abad,M,100,0,15,15
Adarrius,M,100,0,15,15
Adasia,F,100,15,0,15
Addilyne,F,100,15,0,15
Addylin,F,100,15,0,15
Adelis,F,100,15,0,15
Adellyn,F,100,15,0,15
Adyline,F,100,15,0,15
Aeralyn,F,100,15,0,15
Aerie,F,100,15,0,15
Aerik,M,100,0,15,15
Afomia,F,100,15,0,15
Agape,F,100,15,0,15
Ahmira,F,100,15,0,15
Ahnyah,F,100,15,0,15
Aima,F,100,15,0,15
Airiel,F,100,15,0,15
Ajaya,F,100,15,0,15
Akaash,M,100,0,15,15
Aland,M,100,0,15,15
Alanny,F,100,15,0,15
Albaraa,M,100,0,15,15
Aldora,F,100,15,0,15
Alejah,F,100,15,0,15
Aleksi,F,67,10,5,15
Alencia,F,100,15,0,15
Aleric,M,100,0,15,15
Alessander,M,100,0,15,15
Alexader,M,100,0,15,15
Alexina,F,100,15,0,15
Alger,M,100,0,15,15
Alianys,F,100,15,0,15
Alila,F,100,15,0,15
Alleyna,F,100,15,0,15
Almedia,F,100,15,0,15
Almina,F,100,15,0,15
Alonnie,F,100,15,0,15
Amarrah,F,100,15,0,15
Ambreen,F,100,15,0,15
Ambrie,F,100,15,0,15
Amiayah,F,100,15,0,15
Amijah,F,100,15,0,15
Amiliano,M,100,0,15,15
Amiliya,F,100,15,0,15
Aminat,F,100,15,0,15
Amitiel,F,100,15,0,15
Ammara,F,100,15,0,15
Amod,M,100,0,15,15
Amoriah,F,100,15,0,15
Amry,F,100,15,0,15
Analaya,F,100,15,0,15
Analayah,F,100,15,0,15
Anareli,F,100,15,0,15
Anastasio,M,100,0,15,15
Anavey,F,100,15,0,15
Anayia,F,100,15,0,15
Andamo,M,100,0,15,15
Anelis,F,100,15,0,15
Anessia,F,100,15,0,15
Anikin,M,100,0,15,15
Aniyiah,F,100,15,0,15
Annalei,F,100,15,0,15
Annaston,F,100,15,0,15
Anntonette,F,100,15,0,15
Anthonymichael,M,100,0,15,15
Antoinett,F,100,15,0,15
Antoniodejesus,M,100,0,15,15
Anyela,F,100,15,0,15
Aonesty,F,100,15,0,15
Aracelys,F,100,15,0,15
Arayla,F,100,15,0,15
Arayna,F,100,15,0,15
Arby,M,100,0,15,15
Arfa,F,100,15,0,15
Arhum,M,100,0,15,15
Ariday,F,100,15,0,15
Ariv,M,100,0,15,15
Arri,F,67,10,5,15
Aryaa,F,100,15,0,15
Aryanne,F,100,15,0,15
Ashaun,M,100,0,15,15
Ashmi,F,100,15,0,15
Asir,M,100,0,15,15
Asmara,F,100,15,0,15
Aundraya,F,100,15,0,15
Aunica,F,100,15,0,15
Aurthur,M,100,0,15,15
Austina,F,100,15,0,15
Avacyn,F,100,15,0,15
Avelardo,M,100,0,15,15
Aveleen,F,100,15,0,15
Averill,M,100,0,15,15
Avina,F,100,15,0,15
Aydee,F,100,15,0,15
Aymara,F,100,15,0,15
Azarria,F,100,15,0,15
Azayah,F,60,9,6,15
Azya,F,100,15,0,15
Babby,F,100,15,0,15
Baldo,M,100,0,15,15
Barbee,F,100,15,0,15
Barnie,M,100,0,15,15
Basilia,F,100,15,0,15
Bassy,F,100,15,0,15
Baxton,M,100,0,15,15
Baylyn,F,100,15,0,15
Beautifull,F,100,15,0,15
Beena,F,100,15,0,15
Belvia,F,100,15,0,15
Benelli,F,100,15,0,15
Bengie,M,100,0,15,15
Berdie,F,100,15,0,15
Bernardette,F,100,15,0,15
Bernisha,F,100,15,0,15
Betsi,F,100,15,0,15
Bevely,F,100,15,0,15
Beverlie,F,100,15,0,15
Billiejean,F,100,15,0,15
Bishoy,M,100,0,15,15
Bolton,M,100,0,15,15
Bowyn,M,100,0,15,15
Brandace,F,100,15,0,15
Branna,F,100,15,0,15
Branston,M,100,0,15,15
Brantson,M,100,0,15,15
Bravery,M,67,5,10,15
Bravlio,M,100,0,15,15
Braxen,M,100,0,15,15
Breella,F,100,15,0,15
Brenee,F,100,15,0,15
Brentney,F,100,15,0,15
Breshawn,M,53,7,8,15
Brex,M,100,0,15,15
Brindle,F,100,15,0,15
Brithney,F,100,15,0,15
Brittley,F,100,15,0,15
Brodric,M,100,0,15,15
Bryah,F,100,15,0,15
Bryam,M,100,0,15,15
Bryker,M,100,0,15,15
Brynlyn,F,100,15,0,15
Bryttney,F,100,15,0,15
Burech,M,100,0,15,15
Cable,M,100,0,15,15
Cailah,F,100,15,0,15
Caitland,F,100,15,0,15
Caitriona,F,100,15,0,15
Calvyn,M,100,0,15,15
Cardale,M,100,0,15,15
Caretha,F,100,15,0,15
Caria,F,100,15,0,15
Carollee,F,100,15,0,15
Cashten,M,100,0,15,15
Cassell,M,100,0,15,15
Cataleyah,F,100,15,0,15
Caysin,M,100,0,15,15
Ceasia,F,100,15,0,15
Cedella,F,100,15,0,15
Celines,F,100,15,0,15
Celsey,F,100,15,0,15
Cereniti,F,100,15,0,15
Ceslie,F,100,15,0,15
Ceth,M,100,0,15,15
Ceyda,F,100,15,0,15
Chadric,M,100,0,15,15
Chalisa,F,100,15,0,15
Chandel,F,100,15,0,15
Chandlar,M,67,5,10,15
Chanon,F,100,15,0,15
Charlesa,F,100,15,0,15
Charlesia,F,100,15,0,15
Charliee,F,100,15,0,15
Chasady,F,100,15,0,15
Chauntae,F,100,15,0,15
Chavi,F,100,15,0,15
Chayna,F,100,15,0,15
Chelbie,F,100,15,0,15
Chele,F,100,15,0,15
Chena,F,100,15,0,15
Chenique,F,100,15,0,15
Chesnee,F,100,15,0,15
Cheylynn,F,100,15,0,15
Chibueze,M,100,0,15,15
Chief,M,100,0,15,15
Ching,M,60,6,9,15
Chinmayi,F,100,15,0,15
Chinwe,F,100,15,0,15
Chisum,M,100,0,15,15
Christee,F,100,15,0,15
Christopherjohn,M,100,0,15,15
Chun,M,100,0,15,15
Chyan,F,100,15,0,15
Ciella,F,100,15,0,15
Cielle,F,100,15,0,15
Clariza,F,100,15,0,15
Clemens,M,100,0,15,15
Climmie,F,67,10,5,15
Cloteal,F,100,15,0,15
Coben,M,100,0,15,15
Colandra,F,100,15,0,15
Colsten,M,100,0,15,15
Consepcion,F,100,15,0,15
Coraleigh,F,100,15,0,15
Corsica,F,100,15,0,15
Cosandra,F,100,15,0,15
Coulton,M,100,0,15,15
Cray,M,100,0,15,15
Cregg,M,100,0,15,15
Crewe,M,100,0,15,15
Crystallee,F,100,15,0,15
Crystiana,F,100,15,0,15
Cynethia,F,100,15,0,15
Cyrine,F,100,15,0,15
Dafina,F,100,15,0,15
Dahna,F,100,15,0,15
Dailin,F,100,15,0,15
Daissy,F,100,15,0,15
Daisymae,F,100,15,0,15
Daiton,M,100,0,15,15
Dajana,F,100,15,0,15
Dajanique,F,100,15,0,15
Damare,M,100,0,15,15
Daquawn,M,100,0,15,15
Dariyon,M,100,0,15,15
Darlah,F,100,15,0,15
Darlina,F,100,15,0,15
Darneisha,F,100,15,0,15
Darsi,F,100,15,0,15
Dartanion,M,100,0,15,15
Daryna,F,100,15,0,15
Daune,F,53,8,7,15
Daveah,F,100,15,0,15
Deamonte,M,100,0,15,15
Deanette,F,100,15,0,15
Debe,F,100,15,0,15
Declynn,F,100,15,0,15
Dejean,M,100,0,15,15
Delanny,F,100,15,0,15
Delawrence,M,100,0,15,15
Delberta,F,100,15,0,15
Delford,M,100,0,15,15
Delmi,F,100,15,0,15
Demarie,M,67,5,10,15
Demarquez,M,100,0,15,15
Demorio,M,100,0,15,15
Denaja,F,100,15,0,15
Denessa,F,100,15,0,15
Dennisse,F,100,15,0,15
Dequavious,M,100,0,15,15
Derriana,F,100,15,0,15
Devario,M,100,0,15,15
Devarious,M,100,0,15,15
Devvin,M,100,0,15,15
Dhyana,F,100,15,0,15
Dinara,F,100,15,0,15
Djon,M,100,0,15,15
Domonik,M,100,0,15,15
Donley,M,100,0,15,15
Donnal,M,100,0,15,15
Donovyn,M,100,0,15,15
Dorn,M,100,0,15,15
Dorna,F,100,15,0,15
Dorothe,F,100,15,0,15
Dossie,M,67,5,10,15
Drakkar,M,100,0,15,15
Draycen,M,100,0,15,15
Dub,M,100,0,15,15
Dvid,M,100,0,15,15
Ebany,F,100,15,0,15
Edelin,F,100,15,0,15
Edwards,M,100,0,15,15
Effrey,M,100,0,15,15
Eilee,F,100,15,0,15
Elain,F,100,15,0,15
Elaynah,F,100,15,0,15
Eliyohu,M,100,0,15,15
Ellinore,F,100,15,0,15
Elray,M,100,0,15,15
Emberlin,F,100,15,0,15
Emiliya,F,100,15,0,15
Emylie,F,100,15,0,15
Endi,M,100,0,15,15
Ennifer,F,100,15,0,15
Erasmus,M,100,0,15,15
Eryx,M,100,0,15,15
Eshani,F,100,15,0,15
Eshawn,M,100,0,15,15
Eulonda,F,100,15,0,15
Evamaria,F,100,15,0,15
Evens,M,100,0,15,15
Everlene,F,100,15,0,15
Evynne,F,100,15,0,15
Fadil,M,100,0,15,15
Falak,F,100,15,0,15
Falicity,F,100,15,0,15
Fardeen,M,100,0,15,15
Farzan,M,100,0,15,15
Feynman,M,100,0,15,15
Fidelia,F,100,15,0,15
Filimon,M,100,0,15,15
Finneus,M,100,0,15,15
Florette,F,100,15,0,15
Flynt,M,100,0,15,15
Franceen,F,100,15,0,15
Francenia,F,100,15,0,15
Franny,F,100,15,0,15
Freddi,F,60,9,6,15
Fredis,M,100,0,15,15
Fritzgerald,M,100,0,15,15
Fyodor,M,100,0,15,15
Gabreilla,F,100,15,0,15
Gaelan,M,100,0,15,15
Garlan,M,100,0,15,15
Gaylia,F,100,15,0,15
Geet,F,100,15,0,15
Genean,F,100,15,0,15
Geneve,F,100,15,0,15
Geniya,F,100,15,0,15
Gentri,F,100,15,0,15
Geramy,M,100,0,15,15
Ghazi,M,100,0,15,15
Ghislaine,F,100,15,0,15
Gibril,M,100,0,15,15
Gilles,M,100,0,15,15
Gilmore,M,100,0,15,15
Gissella,F,100,15,0,15
Grainger,M,100,0,15,15
Grayland,M,100,0,15,15
Greco,M,100,0,15,15
Gregrey,M,100,0,15,15
Greidis,F,100,15,0,15
Grettell,F,100,15,0,15
Gunnison,M,100,0,15,15
Gwenneth,F,100,15,0,15
Gyselle,F,100,15,0,15
Haadiya,F,100,15,0,15
Hadlea,F,100,15,0,15
Haidi,F,100,15,0,15
Halden,M,100,0,15,15
Hanin,F,100,15,0,15
Harim,M,100,0,15,15
Hasib,M,100,0,15,15
Hassaan,M,100,0,15,15
Hasti,F,100,15,0,15
Haston,M,100,0,15,15
Havoc,M,100,0,15,15
Hayde,F,100,15,0,15
Hayly,F,100,15,0,15
Hazley,F,100,15,0,15
Hedwig,F,100,15,0,15
Helane,F,100,15,0,15
Henli,F,100,15,0,15
Hephzibah,F,100,15,0,15
Herber,M,100,0,15,15
Heywood,M,100,0,15,15
Himmat,M,100,0,15,15
Hlee,F,100,15,0,15
Holdan,M,100,0,15,15
Hollister,M,67,5,10,15
Hollyanne,F,100,15,0,15
Hollynn,F,100,15,0,15
Holy,F,100,15,0,15
Honestie,F,100,15,0,15
Honestii,F,100,15,0,15
Hosey,M,100,0,15,15
Houda,F,100,15,0,15
Hrishikesh,M,100,0,15,15
Hyden,M,100,0,15,15
Hyland,M,100,0,15,15
Iasha,F,100,15,0,15
Icey,F,100,15,0,15
Ilai,M,100,0,15,15
Ilir,M,100,0,15,15
Illana,F,100,15,0,15
Illyria,F,100,15,0,15
Ingeborg,F,100,15,0,15
Inigo,M,100,0,15,15
Isaly,F,100,15,0,15
Isbella,F,100,15,0,15
Ishaaq,M,100,0,15,15
Ishia,F,100,15,0,15
Istvan,M,100,0,15,15
Itay,M,100,0,15,15
Itta,F,100,15,0,15
Itzanami,F,100,15,0,15
Ivianna,F,100,15,0,15
Ivry,F,100,15,0,15
Iyonnah,F,100,15,0,15
Izacc,M,100,0,15,15
Izach,M,100,0,15,15
Izsabella,F,100,15,0,15
Jabes,M,100,0,15,15
Jacayden,M,100,0,15,15
Jacks,M,100,0,15,15
Jaclynne,F,100,15,0,15
Jacora,F,100,15,0,15
Jadi,F,100,15,0,15
Jaece,M,100,0,15,15
Jaffet,M,100,0,15,15
Jaimen,M,100,0,15,15
Jaimes,M,100,0,15,15
Jaimin,M,100,0,15,15
Jakeia,F,100,15,0,15
Jakyiah,F,100,15,0,15
Jaleisa,F,100,15,0,15
Jalonda,F,100,15,0,15
Jameila,F,100,15,0,15
Jamus,M,100,0,15,15
Janetzy,F,100,15,0,15
Janielys,F,100,15,0,15
Janit,F,100,15,0,15
Jansel,M,100,0,15,15
Janus,F,67,10,5,15
Janyra,F,100,15,0,15
Jarelis,F,100,15,0,15
Jaryan,M,100,0,15,15
Jasher,M,100,0,15,15
Jasier,M,100,0,15,15
Jasion,M,100,0,15,15
Javarie,M,100,0,15,15
Javayah,F,100,15,0,15
Jawaan,M,100,0,15,15
Jaxan,M,100,0,15,15
Jaydian,M,100,0,15,15
Jayesh,M,100,0,15,15
Jayin,M,100,0,15,15
Jaykub,M,100,0,15,15
Jayleena,F,100,15,0,15
Jaymen,M,100,0,15,15
Jaymian,M,100,0,15,15
Jaysie,F,100,15,0,15
Jaze,M,100,0,15,15
Jcion,M,100,0,15,15
Jeanae,F,100,15,0,15
Jeanni,F,100,15,0,15
Jearldine,F,100,15,0,15
Jelicia,F,100,15,0,15
Jemery,M,100,0,15,15
Jemini,F,67,10,5,15
Jenyfer,F,100,15,0,15
Jerelle,M,100,0,15,15
Jeriko,M,100,0,15,15
Jerimie,M,100,0,15,15
Jermanie,M,67,5,10,15
Jermery,M,100,0,15,15
Jernard,M,100,0,15,15
Jeronica,F,100,15,0,15
Jesyka,F,100,15,0,15
Jewelle,F,100,15,0,15
Jhaniya,F,100,15,0,15
Jhostin,M,100,0,15,15
Jillienne,F,100,15,0,15
Jillisa,F,100,15,0,15
Jimeka,F,100,15,0,15
Jiovany,M,100,0,15,15
Jkayla,F,100,15,0,15
Jniyah,F,100,15,0,15
Jodey,M,100,0,15,15
Joelee,F,100,15,0,15
Johnathyn,M,100,0,15,15
Johnaton,M,100,0,15,15
Johndaniel,M,100,0,15,15
Johneric,M,100,0,15,15
Johnte,M,100,0,15,15
Jolyssa,F,100,15,0,15
Jonea,F,100,15,0,15
Joniah,F,100,15,0,15
Jonluke,M,100,0,15,15
Jorjia,F,100,15,0,15
Josel,M,100,0,15,15
Jowana,F,100,15,0,15
Joyia,F,100,15,0,15
Jozalyn,F,100,15,0,15
Jshon,M,100,0,15,15
Juanna,F,100,15,0,15
Judithann,F,100,15,0,15
Juiliana,F,100,15,0,15
Juliannah,F,100,15,0,15
Juliyah,F,100,15,0,15
Julya,F,100,15,0,15
Julyanna,F,100,15,0,15
Jumaane,M,100,0,15,15
Junko,F,100,15,0,15
Juquan,M,100,0,15,15
Kache,M,53,7,8,15
Kadden,M,100,0,15,15
Kadesha,F,100,15,0,15
Kaevion,M,100,0,15,15
Kaeya,F,100,15,0,15
Kahleb,M,100,0,15,15
Kaien,M,100,0,15,15
Kailoni,F,100,15,0,15
Kajal,F,100,15,0,15
Kalden,M,100,0,15,15
Kaliann,F,100,15,0,15
Kalita,F,100,15,0,15
Kalyb,M,100,0,15,15
Kamarah,F,100,15,0,15
Kamonie,F,100,15,0,15
Kaplan,M,100,0,15,15
Karalena,F,100,15,0,15
Karanveer,M,100,0,15,15
Karmel,F,100,15,0,15
Karn,F,100,15,0,15
Karthika,F,100,15,0,15
Karuna,F,100,15,0,15
Kashena,F,100,15,0,15
Kass,M,100,0,15,15
Kasten,M,100,0,15,15
Kathee,F,100,15,0,15
Kathlen,F,100,15,0,15
Kaula,F,100,15,0,15
Kavina,F,100,15,0,15
Kawanza,F,100,15,0,15
Kayani,F,100,15,0,15
Kayline,F,100,15,0,15
Kaysean,M,100,0,15,15
Keaundre,M,100,0,15,15
Keen,M,100,0,15,15
Kelso,M,100,0,15,15
Kenijah,F,100,15,0,15
Kensei,M,100,0,15,15
Kentravious,M,100,0,15,15
Kenzey,F,100,15,0,15
Keshana,F,100,15,0,15
Keyasha,F,100,15,0,15
Keyauna,F,100,15,0,15
Keyoni,F,100,15,0,15
Kha,M,100,0,15,15
Khamia,F,100,15,0,15
Khyran,M,100,0,15,15
Kiamesha,F,100,15,0,15
Kieana,F,100,15,0,15
Kierin,M,100,0,15,15
Kimbree,F,100,15,0,15
Kimori,F,100,15,0,15
Kinga,F,100,15,0,15
Kisean,M,100,0,15,15
Kiyona,F,100,15,0,15
Kmora,F,100,15,0,15
Kojo,M,100,0,15,15
Kolawole,M,100,0,15,15
Koriann,F,100,15,0,15
Krayton,M,100,0,15,15
Krisa,F,100,15,0,15
Kristjan,M,100,0,15,15
Kriya,F,100,15,0,15
Krystl,F,100,15,0,15
Kunta,M,100,0,15,15
Kyrstyn,F,100,15,0,15
Kysin,M,100,0,15,15
Lacye,F,100,15,0,15
Laden,M,100,0,15,15
Lailynn,F,100,15,0,15
Lakina,F,100,15,0,15
Lamarco,M,100,0,15,15
Laquiesha,F,100,15,0,15
Laraina,F,100,15,0,15
Lastacia,F,100,15,0,15
Latana,F,100,15,0,15
Latesa,F,100,15,0,15
Latima,F,100,15,0,15
Latonga,F,100,15,0,15
Latravious,M,100,0,15,15
Latreece,F,100,15,0,15
Laurey,F,100,15,0,15
Lauriann,F,100,15,0,15
Laveyah,F,100,15,0,15
Lavisha,F,100,15,0,15
Lawan,F,100,15,0,15
Lawrie,F,100,15,0,15
Lazara,F,100,15,0,15
Lazarius,M,100,0,15,15
Lekeith,M,100,0,15,15
Lemond,M,100,0,15,15
Lenya,F,100,15,0,15
Leonella,F,100,15,0,15
Leontyne,F,100,15,0,15
Levent,M,100,0,15,15
Libi,F,100,15,0,15
Lilienne,F,100,15,0,15
Lind,F,100,15,0,15
Linnet,F,100,15,0,15
Lis,F,100,15,0,15
Liyanna,F,100,15,0,15
Lochlynn,F,100,15,0,15
Loral,F,100,15,0,15
Lorcan,M,100,0,15,15
Loye,M,67,5,10,15
Lucelia,F,100,15,0,15
Lujayn,F,100,15,0,15
Lurene,F,100,15,0,15
Luxe,F,100,15,0,15
Lyliah,F,100,15,0,15
Lylliana,F,100,15,0,15
Lynkin,M,100,0,15,15
Lynnix,F,100,15,0,15
Maat,F,100,15,0,15
Mada,F,100,15,0,15
Madysun,F,100,15,0,15
Maeryn,F,100,15,0,15
Mahalie,F,100,15,0,15
Mahdiya,F,100,15,0,15
Maikel,M,100,0,15,15
Maisa,F,100,15,0,15
Makailey,F,100,15,0,15
Makar,M,100,0,15,15
Makinleigh,F,100,15,0,15
Malaisha,F,100,15,0,15
Malakiah,M,100,0,15,15
Malayzia,F,100,15,0,15
Mansa,M,100,0,15,15
Manuelito,M,100,0,15,15
Marcelis,M,100,0,15,15
Marguetta,F,100,15,0,15
Marialis,F,100,15,0,15
Marigny,F,100,15,0,15
Mariyanna,F,100,15,0,15
Markaila,F,100,15,0,15
Markcus,M,100,0,15,15
Markeda,F,100,15,0,15
Markelle,F,67,10,5,15
Marlet,F,100,15,0,15
Marquesa,F,100,15,0,15
Marquest,M,100,0,15,15
Marsh,M,100,0,15,15
Maryna,F,100,15,0,15
Marypat,F,100,15,0,15
Mashelle,F,100,15,0,15
Mattheo,M,100,0,15,15
Maxden,M,100,0,15,15
Mayukha,F,100,15,0,15
Media,F,100,15,0,15
Meeah,F,100,15,0,15
Megahn,F,100,15,0,15
Megean,F,100,15,0,15
Mehran,M,100,0,15,15
Meiya,F,100,15,0,15
Mekaylah,F,100,15,0,15
Mercedies,F,100,15,0,15
Merrin,F,100,15,0,15
Mersadez,F,100,15,0,15
Mersedes,F,100,15,0,15
Meryle,F,100,15,0,15
Micalah,F,100,15,0,15
Michiah,F,53,8,7,15
Miken,M,100,0,15,15
Milanie,F,100,15,0,15
Milanna,F,100,15,0,15
Milany,F,100,15,0,15
Milika,F,100,15,0,15
Mirissa,F,100,15,0,15
Mitchal,M,100,0,15,15
Mitul,M,100,0,15,15
Mlissa,F,100,15,0,15
Mohannad,M,100,0,15,15
Mohmmad,M,100,0,15,15
Montine,F,100,15,0,15
Moris,M,100,0,15,15
Moyses,M,100,0,15,15
Muntas,F,100,15,0,15
Murice,M,100,0,15,15
Mussie,M,100,0,15,15
Myran,M,67,5,10,15
Myrta,F,100,15,0,15
Nadalee,F,100,15,0,15
Nainika,F,100,15,0,15
Najiyah,F,100,15,0,15
Nakeesha,F,100,15,0,15
Namrata,F,100,15,0,15
Nanayaa,F,100,15,0,15
Nandika,F,100,15,0,15
Naomee,F,100,15,0,15
Naquisha,F,100,15,0,15
Nareh,F,100,15,0,15
Narely,F,100,15,0,15
Naryiah,F,100,15,0,15
Natahlia,F,100,15,0,15
Natiya,F,100,15,0,15
Nayab,F,100,15,0,15
Nayali,F,100,15,0,15
Naysha,F,100,15,0,15
Neamiah,M,100,0,15,15
Negin,F,100,15,0,15
Nejla,F,100,15,0,15
Nekhi,M,100,0,15,15
Nessiah,F,67,10,5,15
Neyva,F,100,15,0,15
Neziah,M,53,7,8,15
Nicholson,M,100,0,15,15
Nieka,F,100,15,0,15
Nielle,F,100,15,0,15
Niguel,M,100,0,15,15
Nikeria,F,100,15,0,15
Nikodem,M,100,0,15,15
Nikoletta,F,100,15,0,15
Nikoloz,M,100,0,15,15
Ninah,F,100,15,0,15
Nini,F,100,15,0,15
Nithila,F,100,15,0,15
Nixen,M,100,0,15,15
Noelie,F,100,15,0,15
Nohea,F,100,15,0,15
Noorah,F,100,15,0,15
Noralee,F,100,15,0,15
Norie,F,100,15,0,15
Nyaja,F,100,15,0,15
Nykayla,F,100,15,0,15
Omesha,F,100,15,0,15
Ory,M,100,0,15,15
Oslo,M,100,0,15,15
Ossiel,M,100,0,15,15
Owain,M,100,0,15,15
Oziah,M,100,0,15,15
Palyn,F,100,15,0,15
Palynn,F,100,15,0,15
Parneet,F,100,15,0,15
Paulla,F,100,15,0,15
Petina,F,100,15,0,15
Phelicia,F,100,15,0,15
Philo,M,100,0,15,15
Philopater,M,100,0,15,15
Phuoc,M,100,0,15,15
Pius,M,100,0,15,15
Pollie,F,100,15,0,15
Pragya,F,100,15,0,15
Presly,F,100,15,0,15
Preslynn,F,100,15,0,15
Punam,F,100,15,0,15
Quanetta,F,100,15,0,15
Quantavia,F,100,15,0,15
Quashon,M,100,0,15,15
Quentina,F,100,15,0,15
Quiera,F,100,15,0,15
Quinita,F,100,15,0,15
Quintana,F,100,15,0,15
Raaga,F,100,15,0,15
Racer,M,100,0,15,15
Rachelann,F,100,15,0,15
Rafeeq,M,100,0,15,15
Rahmere,M,100,0,15,15
Rally,M,100,0,15,15
Ramces,M,100,0,15,15
Rameses,M,100,0,15,15
Ramiel,M,100,0,15,15
Ramil,M,100,0,15,15
Ramyiah,F,100,15,0,15
Rashea,F,100,15,0,15
Rayelynn,F,100,15,0,15
Rayli,F,100,15,0,15
Raymonda,F,100,15,0,15
Raynesha,F,100,15,0,15
Reika,F,100,15,0,15
Reizy,F,100,15,0,15
Reka,F,100,15,0,15
Rekita,F,100,15,0,15
Renji,M,100,0,15,15
Renoda,F,100,15,0,15
Renuka,F,100,15,0,15
Reshanda,F,100,15,0,15
Reshunda,F,100,15,0,15
Reznor,M,100,0,15,15
Rhealynn,F,100,15,0,15
Rhemi,F,100,15,0,15
Rhilyn,F,100,15,0,15
Rickayla,F,100,15,0,15
Rihan,M,53,7,8,15
Rim,F,100,15,0,15
Rimas,M,53,7,8,15
Riniyah,F,100,15,0,15
Rishita,F,100,15,0,15
Rmoni,F,100,15,0,15
Robertha,F,100,15,0,15
Robley,M,100,0,15,15
Roderica,F,100,15,0,15
Rogenia,F,100,15,0,15
Rojean,F,100,15,0,15
Romonda,F,100,15,0,15
Ronae,F,100,15,0,15
Ronneisha,F,100,15,0,15
Roux,F,53,8,7,15
Royetta,F,100,15,0,15
Ruairi,M,100,0,15,15
Ryelan,M,100,0,15,15
Rykker,M,100,0,15,15
Saathvik,M,100,0,15,15
Saban,M,100,0,15,15
Saddam,M,100,0,15,15
Sadiemae,F,100,15,0,15
Sahian,F,100,15,0,15
Saia,F,100,15,0,15
Samani,F,100,15,0,15
Sanav,M,100,0,15,15
Sangeeta,F,100,15,0,15
Sanuel,M,100,0,15,15
Sanylah,F,100,15,0,15
Sarianna,F,100,15,0,15
Satina,F,100,15,0,15
Savaya,F,100,15,0,15
Sawsan,F,100,15,0,15
Sayf,M,100,0,15,15
Senita,F,100,15,0,15
Seraj,M,100,0,15,15
Sevilla,F,100,15,0,15
Shaaron,F,100,15,0,15
Shacola,F,100,15,0,15
Shakemia,F,100,15,0,15
Shaketha,F,100,15,0,15
Shalayna,F,100,15,0,15
Shalice,F,100,15,0,15
Shalika,F,100,15,0,15
Shamaka,F,100,15,0,15
Shamina,F,100,15,0,15
Shaneece,F,100,15,0,15
Shanik,F,100,15,0,15
Shannikia,F,100,15,0,15
Shantale,F,100,15,0,15
Shantese,F,100,15,0,15
Shantice,F,100,15,0,15
Shanyiah,F,100,15,0,15
Shaquira,F,100,15,0,15
Sharicka,F,100,15,0,15
Shatasha,F,100,15,0,15
Shateka,F,100,15,0,15
Shaterica,F,100,15,0,15
Shatisha,F,100,15,0,15
Shawnia,F,100,15,0,15
Shawniece,F,100,15,0,15
Shelbylynn,F,100,15,0,15
Shemica,F,100,15,0,15
Sherel,F,100,15,0,15
Sheriann,F,100,15,0,15
Sheriff,M,100,0,15,15
Sherma,F,100,15,0,15
Shernita,F,100,15,0,15
Sherran,F,100,15,0,15
Sherriann,F,100,15,0,15
Sherrick,M,100,0,15,15
Shirline,F,100,15,0,15
Shital,F,100,15,0,15
Shoaib,M,100,0,15,15
Shuntay,F,100,15,0,15
Sibylla,F,100,15,0,15
Sidda,F,100,15,0,15
Sieara,F,100,15,0,15
Simiyah,F,100,15,0,15
Skylarr,F,100,15,0,15
Skyli,F,100,15,0,15
Slyvester,M,100,0,15,15
Sobia,F,100,15,0,15
Solenne,F,100,15,0,15
Soley,F,100,15,0,15
Solia,F,100,15,0,15
Srihaas,M,100,0,15,15
Stacyann,F,100,15,0,15
Stein,M,100,0,15,15
Stephanos,M,100,0,15,15
Stina,F,100,15,0,15
Sumayo,F,100,15,0,15
Suresh,M,100,0,15,15
Suvi,F,100,15,0,15
Suyog,M,100,0,15,15
Svara,F,100,15,0,15
Sylvania,F,100,15,0,15
Symphani,F,100,15,0,15
Syrianna,F,100,15,0,15
Taavi,M,100,0,15,15
Tacoya,F,100,15,0,15
Taeja,F,100,15,0,15
Taelon,M,100,0,15,15
Taelyr,F,100,15,0,15
Tag,M,100,0,15,15
Tahirih,F,100,15,0,15
Takeem,M,100,0,15,15
Takeesha,F,100,15,0,15
Taleena,F,100,15,0,15
Taleeyah,F,100,15,0,15
Talene,F,100,15,0,15
Tamerra,F,100,15,0,15
Tamura,F,100,15,0,15
Tangina,F,100,15,0,15
Tanikka,F,100,15,0,15
Tanina,F,100,15,0,15
Tanishi,F,100,15,0,15
Tasheika,F,100,15,0,15
Tashica,F,100,15,0,15
Taylia,F,100,15,0,15
Tayra,F,100,15,0,15
Teiara,F,100,15,0,15
Tekela,F,100,15,0,15
Tekeshia,F,100,15,0,15
Tenee,F,100,15,0,15
Tericka,F,100,15,0,15
Terrall,M,100,0,15,15
Theora,F,100,15,0,15
Theresea,F,100,15,0,15
Thorsten,M,100,0,15,15
Timberlee,F,100,15,0,15
Timoth,M,100,0,15,15
Tjuana,F,100,15,0,15
Tonilynn,F,100,15,0,15
Tonnia,F,100,15,0,15
Topaz,F,100,15,0,15
Torionna,F,100,15,0,15
Tove,F,100,15,0,15
Trafton,M,100,0,15,15
Travares,M,100,0,15,15
Treacy,F,100,15,0,15
Trenika,F,100,15,0,15
Treonna,F,100,15,0,15
Trestin,M,100,0,15,15
Tris,M,67,5,10,15
Troyce,M,100,0,15,15
Tukker,M,100,0,15,15
Tuvia,M,100,0,15,15
Twala,F,100,15,0,15
Twan,M,100,0,15,15
Twanisha,F,100,15,0,15
Tyerra,F,100,15,0,15
Tyishia,F,100,15,0,15
Tykera,F,100,15,0,15
Tykeshia,F,100,15,0,15
Tylek,M,100,0,15,15
Tymier,M,100,0,15,15
Tymika,F,100,15,0,15
Tyneka,F,100,15,0,15
Tyquon,M,100,0,15,15
Tyrees,M,100,0,15,15
Tziah,M,53,7,8,15
Tzippy,F,100,15,0,15
Vaishnav,M,100,0,15,15
Vala,F,100,15,0,15
Valla,F,100,15,0,15
Vaneisha,F,100,15,0,15
Vedad,M,100,0,15,15
Venda,F,100,15,0,15
Veneta,F,100,15,0,15
Verdia,F,100,15,0,15
Verlean,F,100,15,0,15
Vernicia,F,100,15,0,15
Vielka,F,100,15,0,15
Vincient,M,100,0,15,15
Vincy,F,100,15,0,15
Vinisha,F,100,15,0,15
Vint,M,100,0,15,15
Virgene,F,100,15,0,15
Vitalia,F,100,15,0,15
Vitalina,F,100,15,0,15
Viviano,M,100,0,15,15
Vrishank,M,100,0,15,15
Vyncent,M,100,0,15,15
Walterine,F,100,15,0,15
Wanna,F,100,15,0,15
Whalen,M,100,0,15,15
Willean,F,100,15,0,15
Willodean,F,100,15,0,15
Wilmot,M,100,0,15,15
Windie,F,100,15,0,15
Worley,M,100,0,15,15
Wyllow,F,100,15,0,15
Xai,M,100,0,15,15
Xaniyah,F,100,15,0,15
Xaviana,F,100,15,0,15
Xavyer,M,100,0,15,15
Xzavia,F,100,15,0,15
Yaden,M,100,0,15,15
Yahayra,F,100,15,0,15
Yailene,F,100,15,0,15
Yakir,M,100,0,15,15
Yamille,F,100,15,0,15
Yaniah,F,100,15,0,15
Yassmin,F,100,15,0,15
Yavier,M,100,0,15,15
Yazlynn,F,100,15,0,15
Yehia,M,100,0,15,15
Yelina,F,100,15,0,15
Yendi,F,100,15,0,15
Yiannis,M,100,0,15,15
Yireh,F,100,15,0,15
Yoceline,F,100,15,0,15
Yon,M,100,0,15,15
Yorick,M,100,0,15,15
Yosgar,M,100,0,15,15
Yotam,M,100,0,15,15
Yuepheng,M,100,0,15,15
Zaedon,M,100,0,15,15
Zahaira,F,100,15,0,15
Zarrah,F,100,15,0,15
Zauria,F,100,15,0,15
Zayin,M,100,0,15,15
Zeal,M,100,0,15,15
Zeidy,F,100,15,0,15
Zeya,F,100,15,0,15
Zilah,F,100,15,0,15
Zipora,F,100,15,0,15
Ziza,F,100,15,0,15
Zoeigh,F,100,15,0,15
Zoeya,F,100,15,0,15
Zoriyah,F,100,15,0,15
Zsofia,F,100,15,0,15
Zuha,F,100,15,0,15
Zykeem,M,100,0,15,15
Zyree,M,100,0,15,15
Aalyssa,F,100,14,0,14
Aaris,F,50,7,7,14
Aarit,M,100,0,14,14
Aarnavi,F,100,14,0,14
Abas,M,100,0,14,14
Abbegale,F,100,14,0,14
Abrham,M,100,0,14,14
Acheron,M,100,0,14,14
Adalen,F,100,14,0,14
Adalyna,F,100,14,0,14
Adine,F,100,14,0,14
Admire,F,100,14,0,14
Adoniah,F,50,7,7,14
Adreonna,F,100,14,0,14
Adwin,M,100,0,14,14
Adwita,F,100,14,0,14
Adysson,F,100,14,0,14
Aeliana,F,100,14,0,14
Afifa,F,100,14,0,14
Agron,M,100,0,14,14
Ahlea,F,100,14,0,14
Aileana,F,100,14,0,14
Airanna,F,100,14,0,14
Airika,F,100,14,0,14
Aisea,M,100,0,14,14
Aizley,F,100,14,0,14
Ajmal,M,100,0,14,14
Akasia,F,100,14,0,14
Akhila,F,100,14,0,14
Akshitha,F,100,14,0,14
Alaeyah,F,100,14,0,14
Alanii,F,100,14,0,14
Aleighna,F,100,14,0,14
Alekxander,M,100,0,14,14
Aleshka,F,100,14,0,14
Alexias,F,100,14,0,14
Alexsandria,F,100,14,0,14
Alhasan,M,100,0,14,14
Alianis,F,100,14,0,14
Aliany,F,100,14,0,14
Alieah,F,100,14,0,14
Alishea,F,100,14,0,14
Allea,F,100,14,0,14
Allenmichael,M,100,0,14,14
Allexus,F,100,14,0,14
Alliannah,F,100,14,0,14
Allyssia,F,100,14,0,14
Allyzon,F,100,14,0,14
Almin,M,100,0,14,14
Altan,M,100,0,14,14
Aluna,F,100,14,0,14
Alveena,F,100,14,0,14
Alyannah,F,100,14,0,14
Alyus,M,100,0,14,14
Amalio,M,100,0,14,14
Amauria,F,100,14,0,14
Amberlea,F,100,14,0,14
Ameli,F,100,14,0,14
Ameshia,F,100,14,0,14
Anae,F,100,14,0,14
Anaih,F,100,14,0,14
Analisia,F,100,14,0,14
Anat,F,100,14,0,14
Anelle,F,100,14,0,14
Anelly,F,100,14,0,14
Aneyah,F,100,14,0,14
Angeleque,F,100,14,0,14
Aniesa,F,100,14,0,14
Aniruddh,M,100,0,14,14
Anjeli,F,100,14,0,14
Ankith,M,100,0,14,14
Annalin,F,100,14,0,14
Annalucia,F,100,14,0,14
Annay,F,100,14,0,14
Annella,F,100,14,0,14
Annibelle,F,100,14,0,14
Annjeanette,F,100,14,0,14
Antolin,M,100,0,14,14
Anyely,F,100,14,0,14
Anysha,F,100,14,0,14
Anzleigh,F,100,14,0,14
Apphia,F,100,14,0,14
Apurva,F,100,14,0,14
Aradia,F,100,14,0,14
Araiyah,F,100,14,0,14
Arbie,M,100,0,14,14
Arcenio,M,100,0,14,14
Ardra,F,100,14,0,14
Arelia,F,100,14,0,14
Ariahnna,F,100,14,0,14
Ariellah,F,100,14,0,14
Armony,F,100,14,0,14
Armstead,M,100,0,14,14
Armya,F,100,14,0,14
Aroldo,M,100,0,14,14
Arriella,F,100,14,0,14
Arville,M,100,0,14,14
Arwin,M,100,0,14,14
Ashwika,F,100,14,0,14
Ashyia,F,100,14,0,14
Assad,M,100,0,14,14
Astha,F,100,14,0,14
Astraea,F,100,14,0,14
Astryd,F,100,14,0,14
Atzin,M,100,0,14,14
Audyn,F,100,14,0,14
Auryn,M,100,0,14,14
Avereigh,F,100,14,0,14
Avey,F,100,14,0,14
Aviela,F,100,14,0,14
Avier,M,100,0,14,14
Aviyanna,F,100,14,0,14
Awais,M,100,0,14,14
Awesome,M,100,0,14,14
Axsel,M,100,0,14,14
Ayjah,F,100,14,0,14
Ayleigh,F,100,14,0,14
Ayomikun,F,50,7,7,14
Azaylea,F,100,14,0,14
Azelin,F,100,14,0,14
Azlaan,M,100,0,14,14
Baiden,M,100,0,14,14
Banita,F,100,14,0,14
Basem,M,100,0,14,14
Bayani,M,100,0,14,14
Bekki,F,100,14,0,14
Bellarae,F,100,14,0,14
Bellina,F,100,14,0,14
Benay,F,100,14,0,14
Bertin,M,100,0,14,14
Besty,F,100,14,0,14
Billyjo,F,50,7,7,14
Bionka,F,100,14,0,14
Birdena,F,100,14,0,14
Bita,F,100,14,0,14
Blandon,M,100,0,14,14
Blazen,M,100,0,14,14
Brach,M,100,0,14,14
Brandol,M,100,0,14,14
Brandun,M,100,0,14,14
Brandyce,F,100,14,0,14
Braylinn,F,100,14,0,14
Breaker,M,100,0,14,14
Breeley,F,100,14,0,14
Breklyn,F,100,14,0,14
Brelan,M,100,0,14,14
Breonia,F,100,14,0,14
Breyelle,F,100,14,0,14
Breyer,F,50,7,7,14
Bristen,M,64,5,9,14
Britainy,F,100,14,0,14
Brixon,M,100,0,14,14
Bryauna,F,100,14,0,14
Brycelynn,F,100,14,0,14
Brynlei,F,100,14,0,14
Brynnlie,F,100,14,0,14
Brysyn,M,100,0,14,14
Byrd,M,100,0,14,14
Caide,M,100,0,14,14
Calel,M,100,0,14,14
Calil,M,100,0,14,14
Caneisha,F,100,14,0,14
Carely,F,100,14,0,14
Carr,M,100,0,14,14
Cashmir,M,100,0,14,14
Cassadie,F,100,14,0,14
Caylob,M,100,0,14,14
Chablis,F,100,14,0,14
Chade,F,100,14,0,14
Chalsea,F,100,14,0,14
Chanea,F,100,14,0,14
Chardai,F,100,14,0,14
Chares,M,100,0,14,14
Chariah,F,100,14,0,14
Charitee,F,100,14,0,14
Charliene,F,100,14,0,14
Charlii,F,100,14,0,14
Charmion,F,100,14,0,14
Charnice,F,100,14,0,14
Chaselyn,F,100,14,0,14
Chavie,F,100,14,0,14
Chelsye,F,100,14,0,14
Chikamso,F,64,9,5,14
Chivas,M,100,0,14,14
Choyce,M,57,6,8,14
Chrisangel,M,100,0,14,14
Chrishana,F,100,14,0,14
Christerpher,M,100,0,14,14
Christna,F,100,14,0,14
Chrsitopher,M,100,0,14,14
Chyrl,F,100,14,0,14
Ciarrah,F,100,14,0,14
Circe,F,100,14,0,14
Clance,M,100,0,14,14
Cleaster,F,100,14,0,14
Clowie,F,100,14,0,14
Coalton,M,100,0,14,14
Colbin,M,100,0,14,14
Coleta,F,100,14,0,14
Collan,M,100,0,14,14
Colum,M,100,0,14,14
Conswella,F,100,14,0,14
Contina,F,100,14,0,14
Coopar,M,100,0,14,14
Cordarryl,M,100,0,14,14
Corneluis,M,100,0,14,14
Cortavius,M,100,0,14,14
Courtany,F,100,14,0,14
Crockett,M,100,0,14,14
Cyenna,F,100,14,0,14
Cylan,M,100,0,14,14
Cynithia,F,100,14,0,14
Daci,F,100,14,0,14
Dago,M,100,0,14,14
Daire,M,100,0,14,14
Dakhari,M,100,0,14,14
Dakodah,M,64,5,9,14
Dalasia,F,100,14,0,14
Daliza,F,100,14,0,14
Dalyce,F,100,14,0,14
Damato,M,100,0,14,14
Dameian,M,100,0,14,14
Damieon,M,100,0,14,14
Damoney,M,100,0,14,14
Damyon,M,100,0,14,14
Dandrew,M,100,0,14,14
Danelys,F,100,14,0,14
Daniesha,F,100,14,0,14
Danissa,F,100,14,0,14
Danixa,F,100,14,0,14
Danyle,F,100,14,0,14
Dao,F,50,7,7,14
Dardi,F,100,14,0,14
Darianne,F,100,14,0,14
Darlys,F,100,14,0,14
Darnette,F,100,14,0,14
Darnise,F,100,14,0,14
Dartanyon,M,100,0,14,14
Dary,M,100,0,14,14
Daryah,F,100,14,0,14
Davaun,M,100,0,14,14
Davinci,M,100,0,14,14
Daxen,M,100,0,14,14
Deantre,M,100,0,14,14
Dearies,M,100,0,14,14
Deavin,M,100,0,14,14
Deetra,F,100,14,0,14
Deforest,M,100,0,14,14
Deicy,F,100,14,0,14
Delayni,F,100,14,0,14
Delman,M,100,0,14,14
Demeka,F,100,14,0,14
Demilade,M,100,0,14,14
Denina,F,100,14,0,14
Denishia,F,100,14,0,14
Deontra,M,100,0,14,14
Deontrae,M,100,0,14,14
Derrich,M,100,0,14,14
Desera,F,100,14,0,14
Deshanda,F,100,14,0,14
Destina,F,100,14,0,14
Devri,F,100,14,0,14
Devvon,M,100,0,14,14
Dewaun,M,100,0,14,14
Deyani,F,100,14,0,14
Deylan,M,100,0,14,14
Deyra,F,100,14,0,14
Dezariah,F,100,14,0,14
Dianelys,F,100,14,0,14
Diasia,F,100,14,0,14
Dimetri,M,100,0,14,14
Dinisha,F,100,14,0,14
Dionysus,M,100,0,14,14
Djeneba,F,100,14,0,14
Domini,F,100,14,0,14
Domino,F,100,14,0,14
Doneen,F,100,14,0,14
Doniqua,F,100,14,0,14
Donterius,M,100,0,14,14
Donterrius,M,100,0,14,14
Dorsa,F,100,14,0,14
Drinda,F,100,14,0,14
Drishti,F,100,14,0,14
Duwane,M,100,0,14,14
Eavan,F,100,14,0,14
Ebelyn,F,100,14,0,14
Edgerrin,M,100,0,14,14
Edona,F,100,14,0,14
Edras,M,100,0,14,14
Edrees,M,100,0,14,14
Egor,M,100,0,14,14
Eimi,F,100,14,0,14
Eithen,M,100,0,14,14
Eland,M,100,0,14,14
Eliajah,M,100,0,14,14
Elicio,M,100,0,14,14
Eligha,M,100,0,14,14
Eline,F,100,14,0,14
Elisavet,F,100,14,0,14
Eliyanah,F,100,14,0,14
Elizer,M,100,0,14,14
Ellanie,F,100,14,0,14
Ellaree,F,100,14,0,14
Ellenie,F,100,14,0,14
Ellenor,F,100,14,0,14
Ellexis,F,100,14,0,14
Ellisen,F,100,14,0,14
Elyjiah,M,100,0,14,14
Embrey,F,100,14,0,14
Emileo,M,100,0,14,14
Emine,F,100,14,0,14
Emmamae,F,100,14,0,14
Emmilynn,F,100,14,0,14
Empriss,F,100,14,0,14
Enslee,F,100,14,0,14
Envi,F,100,14,0,14
Ephrata,F,100,14,0,14
Epifania,F,100,14,0,14
Epimenio,M,100,0,14,14
Eppie,M,57,6,8,14
Erdi,M,100,0,14,14
Ermias,M,100,0,14,14
Esmeraldo,F,100,14,0,14
Essance,F,100,14,0,14
Estefanny,F,100,14,0,14
Ethyl,F,100,14,0,14
Eulanda,F,100,14,0,14
Eutimio,M,100,0,14,14
Evalene,F,100,14,0,14
Evellyn,F,100,14,0,14
Ezaiah,M,100,0,14,14
Ezel,M,100,0,14,14
Farhiya,F,100,14,0,14
Farin,F,100,14,0,14
Faylynn,F,100,14,0,14
Feleshia,F,100,14,0,14
Felicie,F,100,14,0,14
Fernado,M,100,0,14,14
Filicia,F,100,14,0,14
Franciszek,M,100,0,14,14
Francy,F,100,14,0,14
Frenchie,F,100,14,0,14
Friddie,M,100,0,14,14
Frimy,F,100,14,0,14
Gabor,M,100,0,14,14
Gambit,M,100,0,14,14
Gannen,M,100,0,14,14
Garielle,F,100,14,0,14
Garrit,M,100,0,14,14
Gavriela,F,100,14,0,14
Geddy,M,100,0,14,14
Geraldy,F,100,14,0,14
Gianluigi,M,100,0,14,14
Gicelle,F,100,14,0,14
Giliana,F,100,14,0,14
Gilliana,F,100,14,0,14
Giulliana,F,100,14,0,14
Govanny,M,100,0,14,14
Gracynn,F,100,14,0,14
Graylee,F,100,14,0,14
Graylen,M,100,0,14,14
Graysin,M,100,0,14,14
Guilford,M,100,0,14,14
Guss,M,100,0,14,14
Haniyyah,F,100,14,0,14
Harloe,F,100,14,0,14
Harly,F,100,14,0,14
Harshan,M,100,0,14,14
Hartford,M,100,0,14,14
Haruma,M,100,0,14,14
Hatice,F,100,14,0,14
Hazell,F,100,14,0,14
Hazle,F,100,14,0,14
Hebe,F,100,14,0,14
Heidemarie,F,100,14,0,14
Henrie,M,100,0,14,14
Herald,M,100,0,14,14
Hermina,F,100,14,0,14
Hetal,F,100,14,0,14
Hilde,F,100,14,0,14
Hillis,M,100,0,14,14
Hubbard,M,100,0,14,14
Hutchinson,M,100,0,14,14
Ibet,F,100,14,0,14
Ibrahem,M,100,0,14,14
Icelyn,F,100,14,0,14
Ikeya,F,100,14,0,14
Ilaina,F,100,14,0,14
Ilian,M,100,0,14,14
Iliyana,F,100,14,0,14
Illias,M,100,0,14,14
Inaara,F,100,14,0,14
Inanna,F,100,14,0,14
Iolani,F,100,14,0,14
Ionna,F,100,14,0,14
Iori,M,100,0,14,14
Ishmail,M,100,0,14,14
Issam,M,100,0,14,14
Ithzel,F,100,14,0,14
Itxel,F,100,14,0,14
Itzelle,F,100,14,0,14
Ivonna,F,100,14,0,14
Iwalani,F,100,14,0,14
Izaah,M,100,0,14,14
Izyk,M,100,0,14,14
Jaan,M,100,0,14,14
Jacia,F,100,14,0,14
Jacqualynn,F,100,14,0,14
Jadaveon,M,100,0,14,14
Jaeshon,M,100,0,14,14
Jafari,M,100,0,14,14
Jahnessa,F,100,14,0,14
Jaikob,M,100,0,14,14
Jakaia,F,100,14,0,14
Jakylan,M,100,0,14,14
Jakyree,M,100,0,14,14
Jaleh,F,100,14,0,14
Jaleil,M,100,0,14,14
Jalesha,F,100,14,0,14
Jalyne,F,100,14,0,14
Jamaia,F,100,14,0,14
Jameek,M,100,0,14,14
Jamiyla,F,100,14,0,14
Jammi,F,100,14,0,14
Jamont,M,100,0,14,14
Jandy,F,100,14,0,14
Janye,F,100,14,0,14
Janziel,M,100,0,14,14
Jaquann,M,100,0,14,14
Jaquayla,F,100,14,0,14
Jaquia,F,100,14,0,14
Jaquira,F,100,14,0,14
Jarvaris,M,100,0,14,14
Jaryah,F,100,14,0,14
Jaryiah,F,100,14,0,14
Jas,M,100,0,14,14
Jaxi,F,100,14,0,14
Jaxsun,M,100,0,14,14
Jayanthony,M,100,0,14,14
Jayion,M,100,0,14,14
Jayliani,F,100,14,0,14
Jaylnn,F,100,14,0,14
Jaymarion,M,100,0,14,14
Jaymond,M,100,0,14,14
Jayten,M,100,0,14,14
Jazir,M,100,0,14,14
Jazmene,F,100,14,0,14
Jazmere,F,100,14,0,14
Jazzel,F,100,14,0,14
Jeanee,F,100,14,0,14
Jeannifer,F,100,14,0,14
Jeda,F,100,14,0,14
Jelisha,F,100,14,0,14
Jem,F,100,14,0,14
Jemia,F,100,14,0,14
Jenina,F,100,14,0,14
Jennifr,F,100,14,0,14
Jerimi,M,100,0,14,14
Jerric,M,100,0,14,14
Jersee,F,100,14,0,14
Jesiel,M,100,0,14,14
Jesua,M,100,0,14,14
Jeydan,M,100,0,14,14
Jhair,M,100,0,14,14
Jhana,F,100,14,0,14
Jhanae,F,100,14,0,14
Jiancarlo,M,100,0,14,14
Jigar,M,100,0,14,14
Jimenna,F,100,14,0,14
Jino,M,100,0,14,14
Jleigh,F,100,14,0,14
Johnnye,F,100,14,0,14
Johnothan,M,100,0,14,14
Joliyah,F,100,14,0,14
Jolyon,M,100,0,14,14
Jorah,F,50,7,7,14
Josalin,F,100,14,0,14
Josiephine,F,100,14,0,14
Josimar,M,100,0,14,14
Joycee,F,100,14,0,14
Joydan,F,100,14,0,14
Jozalynn,F,100,14,0,14
Junette,F,100,14,0,14
Jury,F,57,8,6,14
Justinian,M,100,0,14,14
Jyquan,M,100,0,14,14
Kahlani,F,100,14,0,14
Kailany,F,100,14,0,14
Kaitlee,F,100,14,0,14
Kaitlynd,F,100,14,0,14
Kaiyon,M,100,0,14,14
Kalasia,F,100,14,0,14
Kalayla,F,100,14,0,14
Kalisi,F,100,14,0,14
Kameah,F,100,14,0,14
Kannen,M,100,0,14,14
Kariem,M,100,0,14,14
Karita,F,100,14,0,14
Karlette,F,100,14,0,14
Karrina,F,100,14,0,14
Kartel,M,100,0,14,14
Kashya,F,100,14,0,14
Kasir,M,100,0,14,14
Kasiya,F,100,14,0,14
Kasson,M,100,0,14,14
Kastiel,M,100,0,14,14
Kasumi,F,100,14,0,14
Katheren,F,100,14,0,14
Kathleena,F,100,14,0,14
Katianne,F,100,14,0,14
Katora,F,100,14,0,14
Katye,F,100,14,0,14
Kaulin,M,100,0,14,14
Kaybrie,F,100,14,0,14
Kaylyne,F,100,14,0,14
Keanah,F,100,14,0,14
Keanon,M,100,0,14,14
Keiandra,F,100,14,0,14
Kelsha,F,100,14,0,14
Kelyse,F,100,14,0,14
Kemyah,F,100,14,0,14
Kenicia,F,100,14,0,14
Kenise,F,100,14,0,14
Kennita,F,100,14,0,14
Kentrail,M,100,0,14,14
Kenyatte,F,50,7,7,14
Kenyette,F,100,14,0,14
Kerolos,M,100,0,14,14
Kerrilynn,F,100,14,0,14
Kesa,F,100,14,0,14
Keshan,M,100,0,14,14
Keshona,F,100,14,0,14
Ketty,F,100,14,0,14
Kevionna,F,100,14,0,14
Keyanah,F,100,14,0,14
Keyatta,F,100,14,0,14
Khalaya,F,100,14,0,14
Kharizma,F,100,14,0,14
Khizar,M,100,0,14,14
Khodi,F,57,8,6,14
Khushbu,F,100,14,0,14
Khyson,M,100,0,14,14
Kiano,M,100,0,14,14
Kie,M,100,0,14,14
Kielyn,F,100,14,0,14
Kierce,M,100,0,14,14
Kiev,M,100,0,14,14
Kilan,M,100,0,14,14
Kinjal,F,100,14,0,14
Kinsly,F,100,14,0,14
Kirana,F,100,14,0,14
Kirat,F,100,14,0,14
Kitiara,F,100,14,0,14
Klayten,M,100,0,14,14
Klhoe,F,100,14,0,14
Klyn,F,100,14,0,14
Kmarion,M,100,0,14,14
Koleman,M,100,0,14,14
Konya,F,100,14,0,14
Koraima,F,100,14,0,14
Kordelia,F,100,14,0,14
Kortne,F,100,14,0,14
Kyier,M,100,0,14,14
Kyleena,F,100,14,0,14
Kylii,F,100,14,0,14
Kymiah,F,100,14,0,14
Kyo,M,100,0,14,14
Kyrel,M,100,0,14,14
Kyros,M,100,0,14,14
Ladaysha,F,100,14,0,14
Lagena,F,100,14,0,14
Laianna,F,100,14,0,14
Lailanie,F,100,14,0,14
Lailany,F,100,14,0,14
Lajeana,F,100,14,0,14
Lakeidra,F,100,14,0,14
Lamekia,F,100,14,0,14
Laneya,F,100,14,0,14
Lannis,M,57,6,8,14
Laporscha,F,100,14,0,14
Laquenta,F,100,14,0,14
Laquilla,F,100,14,0,14
Larayah,F,100,14,0,14
Larico,M,100,0,14,14
Larken,F,100,14,0,14
Lashaye,F,100,14,0,14
Latavious,M,100,0,14,14
Lateia,F,100,14,0,14
Lauretha,F,100,14,0,14
Lavalle,M,100,0,14,14
Lavoris,M,100,0,14,14
Lawrencia,F,100,14,0,14
Laylana,F,100,14,0,14
Layn,M,100,0,14,14
Leaf,M,100,0,14,14
Ledion,M,100,0,14,14
Leeum,M,100,0,14,14
Legrand,M,100,0,14,14
Leidi,F,100,14,0,14
Leilanii,F,100,14,0,14
Leiny,F,100,14,0,14
Lekendra,F,100,14,0,14
Lemya,F,100,14,0,14
Lender,F,100,14,0,14
Leniya,F,100,14,0,14
Lenzie,F,100,14,0,14
Levaeh,F,100,14,0,14
Levora,F,100,14,0,14
Lewanda,F,100,14,0,14
Liddie,F,100,14,0,14
Lidiya,F,100,14,0,14
Lille,F,100,14,0,14
Lilyah,F,100,14,0,14
Linville,M,100,0,14,14
Liona,F,100,14,0,14
Litsy,F,100,14,0,14
Lizabella,F,100,14,0,14
Loanne,F,100,14,0,14
Loel,M,100,0,14,14
Lolitha,F,100,14,0,14
Lollie,F,100,14,0,14
Loranzo,M,100,0,14,14
Loyde,M,100,0,14,14
Lucey,F,100,14,0,14
Ludie,F,64,9,5,14
Lutisha,F,100,14,0,14
Lylith,F,100,14,0,14
Machel,F,100,14,0,14
Macintyre,M,100,0,14,14
Madalen,F,100,14,0,14
Madelen,F,100,14,0,14
Madex,M,100,0,14,14
Madilee,F,100,14,0,14
Madylynn,F,100,14,0,14
Magaret,F,100,14,0,14
Mahamud,M,100,0,14,14
Mahonri,M,100,0,14,14
Mahreen,F,100,14,0,14
Maicey,F,100,14,0,14
Mais,F,100,14,0,14
Makaley,F,100,14,0,14
Makhari,M,100,0,14,14
Makhiya,F,100,14,0,14
Makih,M,100,0,14,14
Makylee,F,100,14,0,14
Malae,F,100,14,0,14
Malosi,M,100,0,14,14
Malyia,F,100,14,0,14
Manolito,M,100,0,14,14
Mardeen,F,100,14,0,14
Margaretmary,F,100,14,0,14
Marionette,F,100,14,0,14
Markela,F,100,14,0,14
Markies,M,100,0,14,14
Marqueta,F,100,14,0,14
Marriana,F,100,14,0,14
Marsden,M,100,0,14,14
Marshea,F,100,14,0,14
Martasia,F,100,14,0,14
Marv,M,100,0,14,14
Massai,M,100,0,14,14
Matigan,F,100,14,0,14
Maurion,M,100,0,14,14
Maxamillian,M,100,0,14,14
Mayara,F,100,14,0,14
Maycol,M,100,0,14,14
Mayia,F,100,14,0,14
Mazey,F,100,14,0,14
Mcgwire,M,100,0,14,14
Mckenly,F,100,14,0,14
Mckennon,M,100,0,14,14
Meckenzie,F,100,14,0,14
Meekah,F,100,14,0,14
Meet,M,100,0,14,14
Meline,F,100,14,0,14
Meoshia,F,100,14,0,14
Merrissa,F,100,14,0,14
Meziah,M,100,0,14,14
Miaa,F,100,14,0,14
Mihail,M,100,0,14,14
Mikaiah,F,100,14,0,14
Milady,F,100,14,0,14
Millen,M,100,0,14,14
Miosotis,F,100,14,0,14
Mirenda,F,100,14,0,14
Miski,F,100,14,0,14
Mizraim,M,100,0,14,14
Momoko,F,100,14,0,14
Moncerrath,F,100,14,0,14
Montaya,F,100,14,0,14
Montray,M,100,0,14,14
Moo,M,100,0,14,14
Moody,M,100,0,14,14
Moua,M,100,0,14,14
Muaad,M,100,0,14,14
Muhanad,M,100,0,14,14
Munachiso,F,64,9,5,14
Muranda,F,100,14,0,14
Muzamil,M,100,0,14,14
Nachmen,M,100,0,14,14
Naethan,M,100,0,14,14
Naiden,M,100,0,14,14
Najai,F,100,14,0,14
Nakota,F,100,14,0,14
Nalaysia,F,100,14,0,14
Nalu,M,100,0,14,14
Namish,M,100,0,14,14
Namiya,F,100,14,0,14
Nashya,F,100,14,0,14
Nataliyah,F,100,14,0,14
Navie,F,100,14,0,14
Naydine,F,100,14,0,14
Nazly,F,100,14,0,14
Neasia,F,100,14,0,14
Nefeli,F,100,14,0,14
Nekeshia,F,100,14,0,14
Nene,F,100,14,0,14
Neomiah,M,100,0,14,14
Nevea,F,100,14,0,14
Neveen,F,100,14,0,14
Nialah,F,100,14,0,14
Niambi,F,100,14,0,14
Nickholas,M,100,0,14,14
Nikoleta,F,100,14,0,14
Nimisha,F,100,14,0,14
Niranjan,M,100,0,14,14
Niyonna,F,100,14,0,14
Nobel,M,100,0,14,14
Nolita,F,100,14,0,14
Nooh,M,100,0,14,14
Norelle,F,100,14,0,14
Nyelah,F,100,14,0,14
Nyella,F,100,14,0,14
Nyheem,M,100,0,14,14
Nyheim,M,100,0,14,14
Nyimah,F,100,14,0,14
Nykeisha,F,100,14,0,14
Nyx,F,100,14,0,14
Oliviamarie,F,100,14,0,14
Omarri,M,100,0,14,14
Omie,F,100,14,0,14
Omolara,F,100,14,0,14
Omunique,F,100,14,0,14
Onya,F,100,14,0,14
Orlandria,F,100,14,0,14
Orlinda,F,100,14,0,14
Orlondo,M,100,0,14,14
Orvin,M,100,0,14,14
Ovadia,M,100,0,14,14
Oyindamola,F,100,14,0,14
Paiyton,F,100,14,0,14
Pamalee,F,100,14,0,14
Paolina,F,100,14,0,14
Peggyann,F,100,14,0,14
Pemberley,F,100,14,0,14
Poetry,F,100,14,0,14
Pookela,M,100,0,14,14
Porshea,F,100,14,0,14
Pranita,F,100,14,0,14
Preslyn,F,100,14,0,14
Pretty,F,100,14,0,14
Prezley,F,100,14,0,14
Prosperity,F,100,14,0,14
Quadre,M,100,0,14,14
Quaniyah,F,100,14,0,14
Quantarius,M,100,0,14,14
Quaron,M,100,0,14,14
Quavis,M,100,0,14,14
Quina,F,100,14,0,14
Quinnten,M,100,0,14,14
Quintara,F,100,14,0,14
Quinteria,F,100,14,0,14
Quita,F,100,14,0,14
Qusay,M,100,0,14,14
Raahim,M,100,0,14,14
Rachit,M,100,0,14,14
Rahshawn,M,100,0,14,14
Ramal,M,100,0,14,14
Raqual,F,100,14,0,14
Rashena,F,100,14,0,14
Rateel,F,100,14,0,14
Raydyn,M,100,0,14,14
Raymere,M,100,0,14,14
Reannah,F,100,14,0,14
Redford,M,100,0,14,14
Reesha,F,100,14,0,14
Reighlyn,F,100,14,0,14
Renauld,M,100,0,14,14
Renotta,F,100,14,0,14
Renton,M,100,0,14,14
Reola,F,100,14,0,14
Resean,M,100,0,14,14
Rhaelyn,F,100,14,0,14
Rhaniya,F,100,14,0,14
Rhenda,F,100,14,0,14
Riel,M,100,0,14,14
Rigley,M,100,0,14,14
Rivaan,M,100,0,14,14
Riviera,F,100,14,0,14
Roaa,F,100,14,0,14
Rocklin,M,100,0,14,14
Rohnan,M,100,0,14,14
Rolande,F,100,14,0,14
Romyn,M,100,0,14,14
Rondalyn,F,100,14,0,14
Rontavious,M,100,0,14,14
Rozann,F,100,14,0,14
Rudie,M,64,5,9,14
Rudransh,M,100,0,14,14
Ruwayda,F,100,14,0,14
Ryn,F,100,14,0,14
Rynlee,F,100,14,0,14
Sa,F,50,7,7,14
Saanya,F,100,14,0,14
Sadeel,F,100,14,0,14
Sagrario,F,100,14,0,14
Sahiti,F,100,14,0,14
Saidey,F,100,14,0,14
Saidie,F,100,14,0,14
Samai,F,100,14,0,14
Samyukta,F,100,14,0,14
Sanjith,M,100,0,14,14
Santhosh,M,100,0,14,14
Saphyre,F,100,14,0,14
Sarabi,F,100,14,0,14
Sarriah,F,100,14,0,14
Sashia,F,100,14,0,14
Satoya,F,100,14,0,14
Savahna,F,100,14,0,14
Savonna,F,100,14,0,14
Savoy,M,100,0,14,14
Seaborn,M,100,0,14,14
Sebastin,M,100,0,14,14
Secily,F,100,14,0,14
Sejla,F,100,14,0,14
Sekai,F,50,7,7,14
Semiyah,F,100,14,0,14
Sephira,F,100,14,0,14
Sevana,F,100,14,0,14
Seville,F,57,8,6,14
Seyed,M,100,0,14,14
Shabana,F,100,14,0,14
Shadara,F,100,14,0,14
Shaddix,M,100,0,14,14
Shahed,F,100,14,0,14
Shahmeer,M,100,0,14,14
Shaili,F,100,14,0,14
Shakeda,F,100,14,0,14
Shakedra,F,100,14,0,14
Shakeerah,F,100,14,0,14
Shakeisha,F,100,14,0,14
Shakevia,F,100,14,0,14
Sham,F,100,14,0,14
Shaneca,F,100,14,0,14
Shaneque,F,100,14,0,14
Shanquita,F,100,14,0,14
Shantella,F,100,14,0,14
Shanterrica,F,100,14,0,14
Shantika,F,100,14,0,14
Shaquera,F,100,14,0,14
Sharne,F,100,14,0,14
Sharnelle,F,100,14,0,14
Sharonna,F,100,14,0,14
Shatha,F,100,14,0,14
Shaundrea,F,100,14,0,14
Shavell,F,100,14,0,14
Shaydon,M,100,0,14,14
Shearon,F,100,14,0,14
Shemeca,F,100,14,0,14
Sheneika,F,100,14,0,14
Shenicka,F,100,14,0,14
Sheniece,F,100,14,0,14
Sherald,F,100,14,0,14
Sheritha,F,100,14,0,14
Shermon,M,100,0,14,14
Shifa,F,100,14,0,14
Shritha,F,100,14,0,14
Shyah,F,100,14,0,14
Shyrl,F,100,14,0,14
Shyron,M,100,0,14,14
Sianne,F,100,14,0,14
Sibel,F,100,14,0,14
Signa,F,100,14,0,14
Simpson,M,100,0,14,14
Simren,F,100,14,0,14
Sinay,F,100,14,0,14
Siobahn,F,100,14,0,14
Sirwilliam,M,100,0,14,14
Skarleth,F,100,14,0,14
Skyanna,F,100,14,0,14
Skylur,F,100,14,0,14
Sofhia,F,100,14,0,14
Sonakshi,F,100,14,0,14
Sparkles,F,100,14,0,14
Sreshta,F,100,14,0,14
Stony,M,100,0,14,14
Success,F,57,8,6,14
Sui,F,100,14,0,14
Sujan,M,100,0,14,14
Sulay,F,100,14,0,14
Sultana,F,100,14,0,14
Sumeka,F,100,14,0,14
Sunset,F,100,14,0,14
Surafel,M,100,0,14,14
Suvan,M,100,0,14,14
Suzen,F,100,14,0,14
Suzetta,F,100,14,0,14
Svanik,M,100,0,14,14
Syan,F,100,14,0,14
Syvanna,F,100,14,0,14
Tacora,F,100,14,0,14
Taesean,M,100,0,14,14
Tahje,M,100,0,14,14
Taijuan,M,100,0,14,14
Taisiya,F,100,14,0,14
Taiten,M,100,0,14,14
Takima,F,100,14,0,14
Takuya,M,100,0,14,14
Taleia,F,100,14,0,14
Taleiyah,F,100,14,0,14
Taleshia,F,100,14,0,14
Taliq,M,100,0,14,14
Talysha,F,100,14,0,14
Tameyah,F,100,14,0,14
Tamsyn,F,100,14,0,14
Tane,F,100,14,0,14
Tanequa,F,100,14,0,14
Taniaya,F,100,14,0,14
Tanicka,F,100,14,0,14
Tanieka,F,100,14,0,14
Tanny,F,100,14,0,14
Taos,M,100,0,14,14
Taquesha,F,100,14,0,14
Tarena,F,100,14,0,14
Tarhonda,F,100,14,0,14
Tarig,M,100,0,14,14
Tatayana,F,100,14,0,14
Tavarion,M,100,0,14,14
Tawsha,F,100,14,0,14
Tayem,M,100,0,14,14
Tayvien,M,100,0,14,14
Tazaria,F,100,14,0,14
Teera,F,100,14,0,14
Teila,F,100,14,0,14
Tekeisha,F,100,14,0,14
Tekla,F,100,14,0,14
Teleah,F,100,14,0,14
Tennile,F,100,14,0,14
Tenor,M,100,0,14,14
Teondre,M,100,0,14,14
Teren,M,100,0,14,14
Terianne,F,100,14,0,14
Tersia,F,100,14,0,14
Teyton,M,100,0,14,14
Thaddeaus,M,100,0,14,14
Thaily,F,100,14,0,14
Thara,F,100,14,0,14
Theoplis,M,100,0,14,14
Thiara,F,100,14,0,14
Thomasenia,F,100,14,0,14
Thyme,F,100,14,0,14
Tiffinee,F,100,14,0,14
Tishawna,F,100,14,0,14
Tita,F,100,14,0,14
Tiwan,M,100,0,14,14
Tizoc,M,100,0,14,14
Toluwani,M,64,5,9,14
Topeka,F,100,14,0,14
Traeson,M,100,0,14,14
Tranika,F,100,14,0,14
Travonna,F,100,14,0,14
Trejan,M,100,0,14,14
Trenden,M,100,0,14,14
Tresure,F,100,14,0,14
Trice,M,100,0,14,14
Trong,M,100,0,14,14
Trysta,F,100,14,0,14
Turi,F,64,9,5,14
Tyffani,F,100,14,0,14
Tylesha,F,100,14,0,14
Tymire,M,100,0,14,14
Tyonne,M,57,6,8,14
Tyquarius,M,100,0,14,14
Tyrihanna,F,100,14,0,14
Umaima,F,100,14,0,14
Ural,M,100,0,14,14
Valerye,F,100,14,0,14
Valita,F,100,14,0,14
Valyncia,F,100,14,0,14
Vandora,F,100,14,0,14
Vaniyah,F,100,14,0,14
Vedansh,M,100,0,14,14
Velecia,F,100,14,0,14
Venesia,F,100,14,0,14
Venna,F,100,14,0,14
Verdis,M,100,0,14,14
Veva,F,100,14,0,14
Vinaya,F,100,14,0,14
Vincen,M,100,0,14,14
Vira,F,100,14,0,14
Vong,M,100,0,14,14
Wake,M,100,0,14,14
Wakeelah,F,100,14,0,14
Wania,F,100,14,0,14
Wanika,F,100,14,0,14
Wasim,M,100,0,14,14
Wateen,F,100,14,0,14
Welby,M,100,0,14,14
Willey,M,100,0,14,14
Winferd,M,100,0,14,14
Winni,F,100,14,0,14
Xinyi,F,100,14,0,14
Xylie,F,100,14,0,14
Xzayden,M,100,0,14,14
Yaasir,M,100,0,14,14
Yader,M,100,0,14,14
Yahvi,F,100,14,0,14
Yandriel,M,100,0,14,14
Yanellie,F,100,14,0,14
Yanieliz,F,100,14,0,14
Yaniyah,F,100,14,0,14
Yarelie,F,100,14,0,14
Yarethzi,F,100,14,0,14
Yarimar,F,100,14,0,14
Yashar,M,100,0,14,14
Yassmine,F,100,14,0,14
Yavonne,F,100,14,0,14
Yeraldine,F,100,14,0,14
Yina,F,100,14,0,14
Yoniel,M,100,0,14,14
Yordan,M,100,0,14,14
Yosiel,M,100,0,14,14
Yun,F,100,14,0,14
Zaela,F,100,14,0,14
Zaelen,M,100,0,14,14
Zakiyya,F,100,14,0,14
Zalma,F,100,14,0,14
Zamyia,F,100,14,0,14
Zandon,M,100,0,14,14
Zarie,F,100,14,0,14
Zayion,M,100,0,14,14
Zayvon,M,100,0,14,14
Zeki,M,100,0,14,14
Zhana,F,100,14,0,14
Zohal,F,100,14,0,14
Zoii,F,100,14,0,14
Zoye,F,100,14,0,14
Zulekha,F,100,14,0,14
Zyia,F,100,14,0,14
Zykee,M,100,0,14,14
Zynae,F,100,14,0,14
Aadhira,F,100,13,0,13
Aalina,F,100,13,0,13
Abanoub,M,100,0,13,13
Abayomi,M,100,0,13,13
Abbigaile,F,100,13,0,13
Abhijot,M,100,0,13,13
Abimelec,M,100,0,13,13
Abrial,F,100,13,0,13
Abukar,M,100,0,13,13
Achaia,F,100,13,0,13
Adaia,F,100,13,0,13
Adaleah,F,100,13,0,13
Adalise,F,100,13,0,13
Adalynd,F,100,13,0,13
Adelind,F,100,13,0,13
Adelyna,F,100,13,0,13
Afraz,M,100,0,13,13
Ahja,F,100,13,0,13
Ahlias,M,100,0,13,13
Ahmeer,M,100,0,13,13
Ahmier,M,100,0,13,13
Ahnesti,F,100,13,0,13
Ahzaria,F,100,13,0,13
Aidenjames,M,100,0,13,13
Aileah,F,100,13,0,13
Aileene,F,100,13,0,13
Aimen,F,100,13,0,13
Airik,M,100,0,13,13
Airlie,F,100,13,0,13
Ajanay,F,100,13,0,13
Akeylah,F,100,13,0,13
Aksh,M,100,0,13,13
Alannie,F,100,13,0,13
Aldine,F,100,13,0,13
Aleijah,F,100,13,0,13
Aleja,F,100,13,0,13
Alexzia,F,100,13,0,13
Aleyana,F,100,13,0,13
Alhaji,M,100,0,13,13
Alhia,F,100,13,0,13
Alif,M,100,0,13,13
Alisah,F,100,13,0,13
Alisande,F,100,13,0,13
Alithea,F,100,13,0,13
Alixandrea,F,100,13,0,13
Alixzander,M,100,0,13,13
Alizaya,F,100,13,0,13
Alok,M,100,0,13,13
Aloria,F,100,13,0,13
Alrick,M,100,0,13,13
Altin,M,100,0,13,13
Alwaleed,M,100,0,13,13
Alysah,F,100,13,0,13
Amahia,F,100,13,0,13
Amaja,F,100,13,0,13
Amamda,F,100,13,0,13
Amandia,F,100,13,0,13
Amazin,F,100,13,0,13
Amelianna,F,100,13,0,13
Amiley,F,100,13,0,13
Ammarie,F,100,13,0,13
Amun,M,100,0,13,13
Anaija,F,100,13,0,13
Anapaola,F,100,13,0,13
Anariah,F,100,13,0,13
Anasha,F,100,13,0,13
Anavel,F,100,13,0,13
Anchor,M,100,0,13,13
Andalynn,F,100,13,0,13
Andreyah,F,100,13,0,13
Andrielle,F,100,13,0,13
Aneira,F,100,13,0,13
Aneita,F,100,13,0,13
Angee,F,100,13,0,13
Angeliah,F,100,13,0,13
Anira,F,100,13,0,13
Anjail,F,100,13,0,13
Anjenette,F,100,13,0,13
Annalize,F,100,13,0,13
Annalysse,F,100,13,0,13
Annina,F,100,13,0,13
Anthonyjames,M,100,0,13,13
Aravind,M,100,0,13,13
Ardit,M,100,0,13,13
Areal,F,100,13,0,13
Areta,F,100,13,0,13
Aretzy,F,100,13,0,13
Areyana,F,100,13,0,13
Arieliz,F,100,13,0,13
Arisbel,F,100,13,0,13
Aristea,F,100,13,0,13
Arliz,F,100,13,0,13
Armend,M,100,0,13,13
Armiya,F,100,13,0,13
Arneshia,F,100,13,0,13
Arrian,M,100,0,13,13
Ashawnti,F,100,13,0,13
Ashonte,F,100,13,0,13
Ashwini,F,100,13,0,13
Athanasius,M,100,0,13,13
Audris,F,100,13,0,13
Aukai,M,100,0,13,13
Austan,M,100,0,13,13
Avanish,M,100,0,13,13
Avynn,F,100,13,0,13
Awan,M,100,0,13,13
Ayako,F,100,13,0,13
Aydrianna,F,100,13,0,13
Aylla,F,100,13,0,13
Azizi,F,62,8,5,13
Azon,M,100,0,13,13
Azyriah,F,100,13,0,13
Baeli,F,100,13,0,13
Baiya,F,100,13,0,13
Bali,F,100,13,0,13
Balthazar,M,100,0,13,13
Barbarajean,F,100,13,0,13
Beka,M,100,0,13,13
Berenis,F,100,13,0,13
Berkli,F,100,13,0,13
Bernett,F,62,8,5,13
Berwyn,M,100,0,13,13
Betrice,F,100,13,0,13
Biak,F,54,7,6,13
Bianney,F,100,13,0,13
Bich,F,100,13,0,13
Binah,F,100,13,0,13
Bintu,F,100,13,0,13
Bitania,F,100,13,0,13
Blaiz,M,100,0,13,13
Blanchard,M,100,0,13,13
Blayre,F,100,13,0,13
Bonner,M,100,0,13,13
Braely,F,100,13,0,13
Brandell,M,100,0,13,13
Brandilee,F,100,13,0,13
Branisha,F,100,13,0,13
Brantleigh,F,100,13,0,13
Braxson,M,100,0,13,13
Breta,F,100,13,0,13
Breven,M,100,0,13,13
Briden,M,100,0,13,13
Briena,F,100,13,0,13
Brik,M,100,0,13,13
Brindy,F,100,13,0,13
Brisamar,F,100,13,0,13
Britlynn,F,100,13,0,13
Brittony,F,100,13,0,13
Bronc,M,100,0,13,13
Brookelle,F,100,13,0,13
Brookes,M,54,6,7,13
Brooksie,F,100,13,0,13
Browning,M,100,0,13,13
Burnard,M,100,0,13,13
Cadell,M,100,0,13,13
Cahlil,M,100,0,13,13
Caillou,M,100,0,13,13
Calinda,F,100,13,0,13
Calliegh,F,100,13,0,13
Camdan,M,100,0,13,13
Camp,M,100,0,13,13
Camyra,F,100,13,0,13
Candies,F,100,13,0,13
Carabella,F,100,13,0,13
Careen,F,100,13,0,13
Carizma,F,100,13,0,13
Carleisha,F,100,13,0,13
Carlesha,F,100,13,0,13
Carmellia,F,100,13,0,13
Carneisha,F,100,13,0,13
Caterra,F,100,13,0,13
Catheline,F,100,13,0,13
Cavani,M,100,0,13,13
Cavell,M,100,0,13,13
Caylum,M,100,0,13,13
Ceazia,F,100,13,0,13
Cedrica,F,100,13,0,13
Cedrie,M,100,0,13,13
Chailyn,F,100,13,0,13
Chanay,F,100,13,0,13
Chanele,F,100,13,0,13
Chanequa,F,100,13,0,13
Chanique,F,100,13,0,13
Chanteria,F,100,13,0,13
Chanti,F,100,13,0,13
Chantrice,F,100,13,0,13
Charday,F,100,13,0,13
Charl,F,100,13,0,13
Charmon,F,100,13,0,13
Charolotte,F,100,13,0,13
Chaynce,M,100,0,13,13
Chazlyn,F,100,13,0,13
Chelisa,F,100,13,0,13
Chelise,F,100,13,0,13
Chellsie,F,100,13,0,13
Chelly,F,100,13,0,13
Chenika,F,100,13,0,13
Cheryel,F,100,13,0,13
Child,M,62,5,8,13
Chino,M,100,0,13,13
Chloeanne,F,100,13,0,13
Chrisa,F,100,13,0,13
Chrisanna,F,100,13,0,13
Chrisean,M,100,0,13,13
Christinea,F,100,13,0,13
Ciaira,F,100,13,0,13
Cjay,M,100,0,13,13
Claudean,F,100,13,0,13
Cleatis,M,100,0,13,13
Clovia,F,100,13,0,13
Cobin,M,100,0,13,13
Colbee,F,100,13,0,13
Conroy,M,100,0,13,13
Copelyn,F,100,13,0,13
Cordarro,M,100,0,13,13
Corneshia,F,100,13,0,13
Corrinna,F,100,13,0,13
Cortina,F,100,13,0,13
Cortnei,F,100,13,0,13
Cotey,M,100,0,13,13
Cristofher,M,100,0,13,13
Culley,M,100,0,13,13
Curly,M,100,0,13,13
Curtistine,F,100,13,0,13
Cylah,F,100,13,0,13
Cylar,M,100,0,13,13
Cynthya,F,100,13,0,13
Cyree,M,100,0,13,13
Cythnia,F,100,13,0,13
Daaiyah,F,100,13,0,13
Dacen,M,100,0,13,13
Daeon,M,100,0,13,13
Daijanae,F,100,13,0,13
Daileen,F,100,13,0,13
Dajha,F,100,13,0,13
Dameir,M,100,0,13,13
Damichael,M,100,0,13,13
Damontez,M,100,0,13,13
Danaiya,F,100,13,0,13
Danalee,F,100,13,0,13
Danialle,F,100,13,0,13
Danicia,F,100,13,0,13
Danilah,F,100,13,0,13
Dannilynn,F,100,13,0,13
Danylle,F,100,13,0,13
Darenda,F,100,13,0,13
Darias,M,100,0,13,13
Darko,M,100,0,13,13
Darleene,F,100,13,0,13
Darrek,M,100,0,13,13
Darriona,F,100,13,0,13
Dartanyan,M,100,0,13,13
Davari,M,100,0,13,13
Davisha,F,100,13,0,13
Dawuan,M,100,0,13,13
Dayrin,F,100,13,0,13
Dayven,M,100,0,13,13
Dazhane,F,100,13,0,13
Deadrick,M,100,0,13,13
Deannah,F,100,13,0,13
Deari,F,100,13,0,13
Deasya,F,100,13,0,13
Deborahann,F,100,13,0,13
Deethya,F,100,13,0,13
Deigo,M,100,0,13,13
Dejion,M,100,0,13,13
Delmarie,F,100,13,0,13
Delsa,F,100,13,0,13
Delvonte,M,100,0,13,13
Demarr,M,100,0,13,13
Demeisha,F,100,13,0,13
Demetrous,M,100,0,13,13
Demontez,M,100,0,13,13
Denley,M,100,0,13,13
Denyla,F,100,13,0,13
Dequon,M,100,0,13,13
Derhonda,F,100,13,0,13
Deriana,F,100,13,0,13
Derotha,F,100,13,0,13
Derril,M,100,0,13,13
Desani,F,54,7,6,13
Deshonna,F,100,13,0,13
Devida,F,100,13,0,13
Deyanne,F,100,13,0,13
Deylin,M,62,5,8,13
Deyvon,M,100,0,13,13
Dhruvin,M,100,0,13,13
Dijuan,M,100,0,13,13
Diksha,F,100,13,0,13
Dimaggio,M,100,0,13,13
Diora,F,100,13,0,13
Diquan,M,100,0,13,13
Divit,M,100,0,13,13
Dlyla,F,100,13,0,13
Dola,F,100,13,0,13
Dominion,M,100,0,13,13
Donah,F,100,13,0,13
Doniven,M,100,0,13,13
Donnice,F,100,13,0,13
Dontia,M,62,5,8,13
Dorethia,F,100,13,0,13
Doristine,F,100,13,0,13
Dorlene,F,100,13,0,13
Dougals,M,100,0,13,13
Draysen,M,100,0,13,13
Dredan,M,100,0,13,13
Dreydan,M,100,0,13,13
Duquan,M,100,0,13,13
Durenda,F,100,13,0,13
Durene,F,100,13,0,13
Dwayn,M,100,0,13,13
Dyllin,M,100,0,13,13
Edger,M,100,0,13,13
Edrie,F,100,13,0,13
Eilan,M,100,0,13,13
Eivan,M,100,0,13,13
Eliakim,M,100,0,13,13
Elice,F,100,13,0,13
Elijahjames,M,100,0,13,13
Elisee,M,100,0,13,13
Elizabethanne,F,100,13,0,13
Elizet,F,100,13,0,13
Elizjah,M,100,0,13,13
Ellajane,F,100,13,0,13
Elmina,F,100,13,0,13
Emanuele,M,100,0,13,13
Emika,F,100,13,0,13
Emilianna,F,100,13,0,13
Emmabelle,F,100,13,0,13
Emmory,F,100,13,0,13
Emryn,F,100,13,0,13
Emslee,F,100,13,0,13
Emyah,F,100,13,0,13
Eriane,F,100,13,0,13
Erum,F,100,13,0,13
Esaul,M,100,0,13,13
Estiben,M,100,0,13,13
Eulene,F,100,13,0,13
Eural,M,100,0,13,13
Eurika,F,100,13,0,13
Evangelynn,F,100,13,0,13
Evannie,F,100,13,0,13
Everli,F,100,13,0,13
Evonda,F,100,13,0,13
Excel,F,54,7,6,13
Eyosias,M,100,0,13,13
Fallynn,F,100,13,0,13
Fareedah,F,100,13,0,13
Fayelynn,F,100,13,0,13
Faylene,F,100,13,0,13
Fe,F,100,13,0,13
Felesia,F,100,13,0,13
Florita,F,100,13,0,13
Floyde,M,100,0,13,13
Fredonia,F,100,13,0,13
Fryda,F,100,13,0,13
Gabrielly,F,100,13,0,13
Galya,F,100,13,0,13
Garhett,M,100,0,13,13
Gatsby,M,100,0,13,13
Geleah,F,100,13,0,13
Gemari,M,100,0,13,13
Gennell,F,100,13,0,13
Geovannie,M,100,0,13,13
Geraldean,F,100,13,0,13
Geraldyne,F,100,13,0,13
Gerldine,F,100,13,0,13
Gib,M,100,0,13,13
Giomar,M,100,0,13,13
Glenard,M,100,0,13,13
Glendia,F,100,13,0,13
Glennette,F,100,13,0,13
Glenroy,M,100,0,13,13
Graisyn,F,100,13,0,13
Grasyn,F,62,8,5,13
Gwenith,F,100,13,0,13
Habibah,F,100,13,0,13
Haigen,M,100,0,13,13
Haizlee,F,100,13,0,13
Halah,F,100,13,0,13
Hamnah,F,100,13,0,13
Hanadi,F,100,13,0,13
Haneefah,F,100,13,0,13
Haniah,F,100,13,0,13
Harbour,F,100,13,0,13
Harmanie,F,100,13,0,13
Harmone,F,100,13,0,13
Harshal,M,100,0,13,13
Hassie,F,100,13,0,13
Hastin,M,100,0,13,13
Hatley,F,100,13,0,13
Hazaiah,M,100,0,13,13
Helenna,F,100,13,0,13
Hendry,M,100,0,13,13
Henos,M,100,0,13,13
Herchel,M,100,0,13,13
Heylee,F,100,13,0,13
Heyli,F,100,13,0,13
Hezzie,M,100,0,13,13
Hidi,F,100,13,0,13
Hikari,F,100,13,0,13
Hildegarde,F,100,13,0,13
Hokulani,F,100,13,0,13
Hooper,M,100,0,13,13
Humna,F,100,13,0,13
Husein,M,100,0,13,13
Ia,F,100,13,0,13
Iaan,M,100,0,13,13
Icess,F,100,13,0,13
Ignazio,M,100,0,13,13
Ileigh,F,100,13,0,13
Ilisha,F,100,13,0,13
Indyah,F,100,13,0,13
Inika,F,100,13,0,13
Irania,F,100,13,0,13
Iridessa,F,100,13,0,13
Irini,F,100,13,0,13
Isaish,M,100,0,13,13
Iselle,F,100,13,0,13
Ishara,F,100,13,0,13
Islay,F,100,13,0,13
Issaic,M,100,0,13,13
Issamar,F,100,13,0,13
Ixel,F,100,13,0,13
Jaamal,M,100,0,13,13
Jabaree,M,100,0,13,13
Jacalynn,F,100,13,0,13
Jacarion,M,100,0,13,13
Jacayla,F,100,13,0,13
Jacoba,F,100,13,0,13
Jacobus,M,100,0,13,13
Jacorie,M,100,0,13,13
Jaemi,F,100,13,0,13
Jaevian,M,100,0,13,13
Jahking,M,100,0,13,13
Jahnasia,F,100,13,0,13
Jahron,M,100,0,13,13
Jahshawn,M,100,0,13,13
Jais,M,100,0,13,13
Jaislyn,F,100,13,0,13
Jaiyon,M,100,0,13,13
Jakeel,M,100,0,13,13
Jakeisha,F,100,13,0,13
Jakevia,F,100,13,0,13
Jakota,M,100,0,13,13
Jakyria,F,100,13,0,13
Jalaiah,F,100,13,0,13
Jalayiah,F,100,13,0,13
Jaleeya,F,100,13,0,13
Jaleiyah,F,100,13,0,13
Jalien,M,62,5,8,13
Jaliyiah,F,100,13,0,13
Jamaa,M,100,0,13,13
Jamarea,M,100,0,13,13
Jamarria,F,100,13,0,13
Jamelah,F,100,13,0,13
Jamice,F,100,13,0,13
Jamol,M,100,0,13,13
Jams,M,100,0,13,13
Jamyriah,F,100,13,0,13
Janaria,F,100,13,0,13
Janariah,F,100,13,0,13
Janautica,F,100,13,0,13
Janeese,F,100,13,0,13
Jaqualin,M,100,0,13,13
Jaquinton,M,100,0,13,13
Jaquise,M,54,6,7,13
Jarelly,F,100,13,0,13
Jashia,F,100,13,0,13
Jasmain,F,100,13,0,13
Javana,F,100,13,0,13
Jaydden,M,100,0,13,13
Jaydelyn,F,100,13,0,13
Jayz,M,100,0,13,13
Jazale,F,100,13,0,13
Jazminn,F,100,13,0,13
Jearlean,F,100,13,0,13
Jeeya,F,100,13,0,13
Jefferie,M,100,0,13,13
Jelesa,F,100,13,0,13
Jemya,F,100,13,0,13
Jenard,M,100,0,13,13
Jenasia,F,100,13,0,13
Jenavi,F,100,13,0,13
Jeneffer,F,100,13,0,13
Jenilyn,F,100,13,0,13
Jenness,F,100,13,0,13
Jermario,M,100,0,13,13
Jeromiah,M,100,0,13,13
Jerryn,M,100,0,13,13
Jervis,M,100,0,13,13
Jevante,M,100,0,13,13
Jevaun,M,100,0,13,13
Jezabell,F,100,13,0,13
Jezabella,F,100,13,0,13
Jhania,F,100,13,0,13
Jiaire,M,100,0,13,13
Jilene,F,100,13,0,13
Jilleen,F,100,13,0,13
Jimy,M,100,0,13,13
Jinelle,F,100,13,0,13
Jnai,F,100,13,0,13
Joaly,F,100,13,0,13
Joandy,M,100,0,13,13
Joanmarie,F,100,13,0,13
Joaovictor,M,100,0,13,13
Jobin,M,100,0,13,13
Jodel,F,100,13,0,13
Jodette,F,100,13,0,13
Joelisa,F,100,13,0,13
Johnnette,F,100,13,0,13
Johnta,M,100,0,13,13
Joleah,F,100,13,0,13
Joletta,F,100,13,0,13
Jonai,F,100,13,0,13
Jonathandavid,M,100,0,13,13
Jonnell,F,54,7,6,13
Jontez,M,100,0,13,13
Jordani,M,100,0,13,13
Joshiah,M,100,0,13,13
Joshoa,M,100,0,13,13
Josiane,F,100,13,0,13
Jossilyn,F,100,13,0,13
Josyiah,M,100,0,13,13
Journe,F,100,13,0,13
Jovoni,M,100,0,13,13
Jowanda,F,100,13,0,13
Jozsef,M,100,0,13,13
Juandalynn,F,100,13,0,13
Judiann,F,100,13,0,13
Judieth,F,100,13,0,13
Juliany,F,100,13,0,13
Julienna,F,100,13,0,13
Jushua,M,100,0,13,13
Justian,M,100,0,13,13
Justise,F,100,13,0,13
Jymir,M,100,0,13,13
Kabao,F,100,13,0,13
Kabel,M,100,0,13,13
Kadedra,F,100,13,0,13
Kadejah,F,100,13,0,13
Kadia,F,100,13,0,13
Kaetlin,F,100,13,0,13
Kahleesi,F,100,13,0,13
Kaigen,M,62,5,8,13
Kailene,F,100,13,0,13
Kaislyn,F,100,13,0,13
Kalliyan,F,100,13,0,13
Kaloyan,M,100,0,13,13
Kamella,F,100,13,0,13
Kamyron,M,100,0,13,13
Kanari,M,62,5,8,13
Kanyah,F,100,13,0,13
Kap,M,100,0,13,13
Karlita,F,100,13,0,13
Karnesha,F,100,13,0,13
Kasiyah,F,100,13,0,13
Katanna,F,100,13,0,13
Katanya,F,100,13,0,13
Kathlee,F,100,13,0,13
Kathrynne,F,100,13,0,13
Katianna,F,100,13,0,13
Katrielle,F,100,13,0,13
Katrinna,F,100,13,0,13
Kavitha,F,100,13,0,13
Kaycin,M,100,0,13,13
Kayelani,F,100,13,0,13
Kaylean,F,100,13,0,13
Kayshaun,M,100,0,13,13
Kazmir,M,100,0,13,13
Kazzandra,F,100,13,0,13
Keeler,M,100,0,13,13
Keimora,F,100,13,0,13
Keina,F,100,13,0,13
Keishawna,F,100,13,0,13
Kekai,M,100,0,13,13
Kellam,M,100,0,13,13
Kelvion,M,100,0,13,13
Kemorah,F,100,13,0,13
Kennedii,F,100,13,0,13
Kenneshia,F,100,13,0,13
Kennidee,F,100,13,0,13
Kenniel,M,100,0,13,13
Kenslei,F,100,13,0,13
Kenyona,F,100,13,0,13
Kenyotta,M,54,6,7,13
Keslee,F,100,13,0,13
Kester,M,100,0,13,13
Kevonta,M,100,0,13,13
Keyairra,F,100,13,0,13
Keylah,F,100,13,0,13
Keymiah,F,100,13,0,13
Keyry,F,100,13,0,13
Khadeja,F,100,13,0,13
Khalie,F,100,13,0,13
Khaliel,M,100,0,13,13
Khamir,M,100,0,13,13
Khayman,M,100,0,13,13
Khiyah,F,100,13,0,13
Khoen,M,100,0,13,13
Khyan,M,100,0,13,13
Khyre,M,100,0,13,13
Kialee,F,100,13,0,13
Kielee,F,100,13,0,13
Kihara,F,100,13,0,13
Kimario,M,100,0,13,13
Kimberla,F,100,13,0,13
Kimbria,F,100,13,0,13
Kimmberly,F,100,13,0,13
Kimyata,F,100,13,0,13
Kiralynn,F,100,13,0,13
Kirandeep,F,100,13,0,13
Kirpa,F,100,13,0,13
Kismet,F,100,13,0,13
Kita,F,100,13,0,13
Kiwanna,F,100,13,0,13
Kiyra,F,100,13,0,13
Kj,M,100,0,13,13
Klark,M,100,0,13,13
Klever,M,100,0,13,13
Kline,M,100,0,13,13
Kobain,M,100,0,13,13
Korde,M,100,0,13,13
Kortnei,F,100,13,0,13
Kristos,M,100,0,13,13
Kseniya,F,100,13,0,13
Kunga,M,62,5,8,13
Kuulei,F,100,13,0,13
Kwinton,M,100,0,13,13
Kymberlie,F,100,13,0,13
Kynzley,F,100,13,0,13
Kyreem,M,100,0,13,13
Kyriaki,F,100,13,0,13
Kyrstie,F,100,13,0,13
Lacarlos,M,100,0,13,13
Lacreshia,F,100,13,0,13
Lailanee,F,100,13,0,13
Lailie,F,100,13,0,13
Lajarvis,M,100,0,13,13
Laketta,F,100,13,0,13
Lakeyn,F,100,13,0,13
Lakysha,F,100,13,0,13
Lalitha,F,100,13,0,13
Lamira,F,100,13,0,13
Lanson,M,100,0,13,13
Laquon,M,100,0,13,13
Larren,M,100,0,13,13
Laryah,F,100,13,0,13
Lashawne,F,100,13,0,13
Lasheba,F,100,13,0,13
Lashia,F,100,13,0,13
Lataysha,F,100,13,0,13
Lathon,M,100,0,13,13
Latiya,F,100,13,0,13
Latrish,F,100,13,0,13
Laurajean,F,100,13,0,13
Laurrie,F,100,13,0,13
Lavante,M,100,0,13,13
Lavi,M,100,0,13,13
Lawryn,F,100,13,0,13
Laysa,F,100,13,0,13
Lebaron,M,100,0,13,13
Lechia,F,100,13,0,13
Ledonna,F,100,13,0,13
Leeani,F,100,13,0,13
Leeon,M,100,0,13,13
Leialoha,F,100,13,0,13
Leilene,F,100,13,0,13
Leisel,F,100,13,0,13
Lejend,M,100,0,13,13
Lelon,M,100,0,13,13
Lelynd,M,100,0,13,13
Lemmie,M,100,0,13,13
Lenon,M,100,0,13,13
Lenor,F,100,13,0,13
Leondria,F,100,13,0,13
Leory,M,100,0,13,13
Lesandra,F,100,13,0,13
Leshae,F,100,13,0,13
Levia,F,100,13,0,13
Lexxus,F,100,13,0,13
Lillieanna,F,100,13,0,13
Lillyahna,F,100,13,0,13
Lillyen,F,100,13,0,13
Lilton,M,100,0,13,13
Liselle,F,100,13,0,13
Lishia,F,100,13,0,13
Loana,F,100,13,0,13
Loann,F,100,13,0,13
Loray,F,100,13,0,13
Loretto,F,100,13,0,13
Lorrane,F,100,13,0,13
Lorrina,F,100,13,0,13
Loucinda,F,100,13,0,13
Lovena,F,100,13,0,13
Lucynda,F,100,13,0,13
Luian,M,100,0,13,13
Luisdavid,M,100,0,13,13
Luismanuel,M,100,0,13,13
Lumi,F,100,13,0,13
Lurlene,F,100,13,0,13
Lusero,F,100,13,0,13
Luticia,F,100,13,0,13
Lycia,F,100,13,0,13
Lyllah,F,100,13,0,13
Lyndol,M,100,0,13,13
Lyndzie,F,100,13,0,13
Lynnex,F,100,13,0,13
Lyrika,F,100,13,0,13
Lytzy,F,100,13,0,13
Maame,F,100,13,0,13
Mackensi,F,100,13,0,13
Macks,M,100,0,13,13
Madhavi,F,100,13,0,13
Madylyn,F,100,13,0,13
Maebh,F,100,13,0,13
Maelys,F,100,13,0,13
Maezie,F,100,13,0,13
Mahan,M,100,0,13,13
Mahlaya,F,100,13,0,13
Mahoganie,F,100,13,0,13
Makaria,F,100,13,0,13
Makayela,F,100,13,0,13
Makenzii,F,100,13,0,13
Makhya,F,100,13,0,13
Makynze,F,100,13,0,13
Malasha,F,100,13,0,13
Malaun,F,100,13,0,13
Malikiah,M,100,0,13,13
Malyna,F,100,13,0,13
Mano,M,100,0,13,13
Maragret,F,100,13,0,13
Marcianne,F,100,13,0,13
Marcquis,M,100,0,13,13
Margareta,F,100,13,0,13
Mariacristina,F,100,13,0,13
Maridee,F,100,13,0,13
Marieliz,F,100,13,0,13
Mariell,F,100,13,0,13
Marisue,F,100,13,0,13
Mariyana,F,100,13,0,13
Marizza,F,100,13,0,13
Marjani,F,100,13,0,13
Marleta,F,100,13,0,13
Marquasia,F,100,13,0,13
Martrice,F,54,7,6,13
Marzella,F,100,13,0,13
Matalie,F,100,13,0,13
Matraca,F,100,13,0,13
Matyas,M,100,0,13,13
Maxene,F,100,13,0,13
Maxmilian,M,100,0,13,13
Maxten,M,100,0,13,13
Maxtyn,M,100,0,13,13
Mays,M,54,6,7,13
Maziar,M,100,0,13,13
Mckensi,F,100,13,0,13
Mckinzy,F,100,13,0,13
Melitta,F,100,13,0,13
Melizza,F,100,13,0,13
Merica,F,100,13,0,13
Merrisa,F,100,13,0,13
Miabelle,F,100,13,0,13
Micaila,F,100,13,0,13
Michaila,F,100,13,0,13
Michalea,F,100,13,0,13
Mihcael,M,100,0,13,13
Mikaelyn,F,100,13,0,13
Mikhai,M,100,0,13,13
Mikias,M,100,0,13,13
Miliano,M,100,0,13,13
Milon,M,100,0,13,13
Miu,F,100,13,0,13
Moataz,M,100,0,13,13
Momo,F,100,13,0,13
Monicia,F,100,13,0,13
Morad,M,100,0,13,13
Morna,F,100,13,0,13
Murielle,F,100,13,0,13
Muse,M,100,0,13,13
Mykela,F,100,13,0,13
Mylen,M,100,0,13,13
Mylik,M,100,0,13,13
Myrla,F,100,13,0,13
Naela,F,100,13,0,13
Nahara,F,100,13,0,13
Naheim,M,100,0,13,13
Nahiara,F,100,13,0,13
Nahim,M,100,0,13,13
Nahsir,M,100,0,13,13
Naithen,M,100,0,13,13
Najeh,M,100,0,13,13
Najmo,F,100,13,0,13
Nakeema,F,100,13,0,13
Nakema,F,100,13,0,13
Nary,F,100,13,0,13
Nasri,M,100,0,13,13
Nasrin,F,100,13,0,13
Natalio,M,100,0,13,13
Natayah,F,100,13,0,13
Natlaie,F,100,13,0,13
Natonya,F,100,13,0,13
Nayalee,F,100,13,0,13
Nayef,M,100,0,13,13
Nayshawn,M,100,0,13,13
Nazaret,F,100,13,0,13
Nedim,M,100,0,13,13
Neeharika,F,100,13,0,13
Nekko,M,100,0,13,13
Neriya,F,100,13,0,13
Nermin,F,54,7,6,13
Ngan,F,100,13,0,13
Niccolas,M,100,0,13,13
Nichael,M,100,0,13,13
Nicholaos,M,100,0,13,13
Niclas,M,100,0,13,13
Nikala,F,100,13,0,13
Nil,M,54,6,7,13
Niley,F,100,13,0,13
Niobe,F,100,13,0,13
Nirvi,F,100,13,0,13
Nivriti,F,100,13,0,13
Niyam,M,100,0,13,13
No,F,54,7,6,13
Nocole,F,100,13,0,13
Noele,F,100,13,0,13
Noriyah,F,100,13,0,13
Nuriyah,F,100,13,0,13
Nyziah,M,100,0,13,13
Oakes,M,100,0,13,13
Obdulia,F,100,13,0,13
Obert,M,100,0,13,13
Obrien,M,100,0,13,13
Ohm,M,100,0,13,13
Okechukwu,M,100,0,13,13
Olden,M,100,0,13,13
Olesia,F,100,13,0,13
Oliveah,F,100,13,0,13
Olman,M,100,0,13,13
Oluwadamilare,M,100,0,13,13
Olyver,M,100,0,13,13
Oneda,F,100,13,0,13
Oneita,F,100,13,0,13
Onesha,F,100,13,0,13
Orlean,F,100,13,0,13
Osamah,M,100,0,13,13
Osmany,M,100,0,13,13
Ossian,M,100,0,13,13
Osten,M,100,0,13,13
Othella,F,100,13,0,13
Owenn,M,100,0,13,13
Pahal,F,100,13,0,13
Pailynn,F,100,13,0,13
Paisely,F,100,13,0,13
Pajtim,M,100,0,13,13
Pamie,F,100,13,0,13
Pancho,M,100,0,13,13
Patt,F,100,13,0,13
Pattricia,F,100,13,0,13
Pella,F,100,13,0,13
Perley,M,100,0,13,13
Perlie,F,100,13,0,13
Persaeus,F,100,13,0,13
Phalyn,F,100,13,0,13
Phelix,M,100,0,13,13
Phenyx,F,100,13,0,13
Pheona,F,100,13,0,13
Philis,F,100,13,0,13
Phoebee,F,100,13,0,13
Pollyann,F,100,13,0,13
Posie,F,100,13,0,13
Prabhleen,F,100,13,0,13
Prahlad,M,100,0,13,13
Prakash,M,100,0,13,13
Pura,F,100,13,0,13
Qian,M,100,0,13,13
Qiara,F,100,13,0,13
Quadasia,F,100,13,0,13
Qualin,M,100,0,13,13
Quanell,M,100,0,13,13
Quayvon,M,100,0,13,13
Quency,M,100,0,13,13
Quenna,F,100,13,0,13
Quennel,M,100,0,13,13
Quentez,M,100,0,13,13
Quinnlan,M,100,0,13,13
Quitman,M,100,0,13,13
Rabeka,F,100,13,0,13
Raechal,F,100,13,0,13
Raemond,M,100,0,13,13
Raesha,F,100,13,0,13
Rage,M,100,0,13,13
Rahkim,M,100,0,13,13
Rahmah,F,100,13,0,13
Raijon,M,100,0,13,13
Ralonda,F,100,13,0,13
Ramzey,M,100,0,13,13
Ranasia,F,100,13,0,13
Random,M,100,0,13,13
Rasool,M,100,0,13,13
Rassan,M,100,0,13,13
Rawlin,M,100,0,13,13
Rayette,F,100,13,0,13
Rayhanna,F,100,13,0,13
Raymir,M,100,0,13,13
Reinhard,M,100,0,13,13
Rejean,M,100,0,13,13
Rejoice,F,100,13,0,13
Remee,F,100,13,0,13
Remiyah,F,100,13,0,13
Reneisha,F,100,13,0,13
Renise,F,100,13,0,13
Revanth,M,100,0,13,13
Revel,M,62,5,8,13
Richerd,M,100,0,13,13
Ricke,M,100,0,13,13
Rickesha,F,100,13,0,13
Rickita,F,100,13,0,13
Ridhaan,M,100,0,13,13
Rihaan,M,100,0,13,13
Riott,M,100,0,13,13
Ritter,M,100,0,13,13
Rocke,M,100,0,13,13
Roemello,M,100,0,13,13
Rom,M,100,0,13,13
Romin,M,100,0,13,13
Rommell,M,100,0,13,13
Rosaleah,F,100,13,0,13
Rosbel,M,100,0,13,13
Rosezella,F,100,13,0,13
Rosheda,F,100,13,0,13
Roxxanne,F,100,13,0,13
Royel,M,62,5,8,13
Roz,F,100,13,0,13
Rozelyn,F,100,13,0,13
Rula,F,100,13,0,13
Ruqaya,F,100,13,0,13
Ruven,M,100,0,13,13
Ryeland,M,100,0,13,13
Rykin,M,100,0,13,13
Rylynne,F,100,13,0,13
Sabastien,M,100,0,13,13
Saby,F,100,13,0,13
Sadat,M,100,0,13,13
Sahiba,F,100,13,0,13
Sahith,M,100,0,13,13
Saidi,F,100,13,0,13
Saintclair,M,100,0,13,13
Sajda,F,100,13,0,13
Saje,F,54,7,6,13
Sajed,M,100,0,13,13
Sakoya,F,100,13,0,13
Salathiel,M,100,0,13,13
Samayra,F,100,13,0,13
Samnang,M,100,0,13,13
Samvel,M,100,0,13,13
Sanaiyah,F,100,13,0,13
Sanel,M,100,0,13,13
Sangita,F,100,13,0,13
Sapphyre,F,100,13,0,13
Saramarie,F,100,13,0,13
Sarely,F,100,13,0,13
Sarissa,F,100,13,0,13
Sarye,F,100,13,0,13
Saylah,F,100,13,0,13
Serayah,F,100,13,0,13
Sereena,F,100,13,0,13
Seydi,F,100,13,0,13
Seymone,F,100,13,0,13
Shacarra,F,100,13,0,13
Shadawn,F,100,13,0,13
Shaely,F,100,13,0,13
Shagun,F,100,13,0,13
Shakala,F,100,13,0,13
Shakea,F,100,13,0,13
Shakeila,F,100,13,0,13
Shalondra,F,100,13,0,13
Shalonna,F,100,13,0,13
Shamaiya,F,100,13,0,13
Shamanda,F,100,13,0,13
Shammah,M,100,0,13,13
Shanessa,F,100,13,0,13
Shanikia,F,100,13,0,13
Shaniqwa,F,100,13,0,13
Shantez,F,62,8,5,13
Shaquanta,F,100,13,0,13
Shaquel,F,62,8,5,13
Shaquela,F,100,13,0,13
Shaquella,F,100,13,0,13
Sharida,F,100,13,0,13
Sharitta,F,100,13,0,13
Sharlyne,F,100,13,0,13
Shaunya,F,100,13,0,13
Shayann,F,100,13,0,13
Shayde,F,54,7,6,13
Shaylynne,F,100,13,0,13
Shayma,F,100,13,0,13
Shaynee,F,100,13,0,13
Shealeigh,F,100,13,0,13
Shelanda,F,100,13,0,13
Shenea,F,100,13,0,13
Shereta,F,100,13,0,13
Sherle,F,100,13,0,13
Sherlonda,F,100,13,0,13
Shetara,F,100,13,0,13
Shimika,F,100,13,0,13
Shiraz,M,100,0,13,13
Shjon,M,100,0,13,13
Shloima,M,100,0,13,13
Shlonda,F,100,13,0,13
Sholonda,F,100,13,0,13
Shondrika,F,100,13,0,13
Shontrell,F,100,13,0,13
Shrihaan,M,100,0,13,13
Shristi,F,100,13,0,13
Shuban,M,100,0,13,13
Shundrea,F,100,13,0,13
Shyane,F,100,13,0,13
Shymir,M,100,0,13,13
Sibley,F,100,13,0,13
Sidh,M,100,0,13,13
Sidonia,F,100,13,0,13
Sihaam,F,100,13,0,13
Simara,F,100,13,0,13
Simisola,F,100,13,0,13
Sinahi,F,100,13,0,13
Sincerity,F,100,13,0,13
Sirenia,F,100,13,0,13
Sitlali,F,100,13,0,13
Siyanna,F,100,13,0,13
Skilah,F,100,13,0,13
Skyi,F,100,13,0,13
Smiley,M,100,0,13,13
Smit,M,100,0,13,13
Smrithi,F,100,13,0,13
Sniyah,F,100,13,0,13
Sohil,M,100,0,13,13
Sohrab,M,100,0,13,13
Solea,F,100,13,0,13
Sovereign,M,62,5,8,13
Stana,F,100,13,0,13
Stayce,F,100,13,0,13
Stellarose,F,100,13,0,13
Stephenia,F,100,13,0,13
Stephonie,F,100,13,0,13
Sua,F,100,13,0,13
Suhan,M,100,0,13,13
Sukhraj,M,100,0,13,13
Sumedha,F,100,13,0,13
Summerlin,F,100,13,0,13
Surah,F,100,13,0,13
Surie,F,100,13,0,13
Sydell,F,100,13,0,13
Sydnye,F,100,13,0,13
Syla,F,100,13,0,13
Syleena,F,100,13,0,13
Synethia,F,100,13,0,13
Syona,F,100,13,0,13
Syrita,F,100,13,0,13
Taaj,M,100,0,13,13
Taela,F,100,13,0,13
Taesha,F,100,13,0,13
Taggert,M,100,0,13,13
Tahesha,F,100,13,0,13
Tahmina,F,100,13,0,13
Taijon,M,100,0,13,13
Tailey,F,100,13,0,13
Taishawn,M,100,0,13,13
Taisley,F,100,13,0,13
Takeysha,F,100,13,0,13
Takoya,F,100,13,0,13
Taleb,M,100,0,13,13
Talecia,F,100,13,0,13
Talika,F,100,13,0,13
Talis,M,100,0,13,13
Tallis,F,100,13,0,13
Tallyn,M,54,6,7,13
Tamarie,F,100,13,0,13
Tamario,M,100,0,13,13
Tambi,F,100,13,0,13
Tamikka,F,100,13,0,13
Tamkia,F,100,13,0,13
Tanayah,F,100,13,0,13
Tang,F,100,13,0,13
Tasheem,M,100,0,13,13
Tason,M,100,0,13,13
Tationna,F,100,13,0,13
Tawhid,M,100,0,13,13
Tawonna,F,100,13,0,13
Tayari,M,100,0,13,13
Taydon,M,100,0,13,13
Taylormarie,F,100,13,0,13
Taymar,F,54,7,6,13
Tayvia,F,100,13,0,13
Teighan,F,62,8,5,13
Tejon,M,100,0,13,13
Tekeya,F,100,13,0,13
Telesha,F,100,13,0,13
Temidayo,M,62,5,8,13
Temur,M,100,0,13,13
Tenli,F,100,13,0,13
Teresha,F,100,13,0,13
Teric,M,100,0,13,13
Tessanne,F,100,13,0,13
Theory,F,62,8,5,13
Therin,M,100,0,13,13
Thermon,M,100,0,13,13
Theta,F,100,13,0,13
Tiaunna,F,100,13,0,13
Tifney,F,100,13,0,13
Titianna,F,100,13,0,13
Tmya,F,100,13,0,13
Toddy,M,100,0,13,13
Tonae,F,100,13,0,13
Toniya,F,100,13,0,13
Torez,M,100,0,13,13
Toris,M,100,0,13,13
Torsha,F,100,13,0,13
Totiana,F,100,13,0,13
Tradarius,M,100,0,13,13
Traeger,M,100,0,13,13
Tralana,F,100,13,0,13
Tranell,M,54,6,7,13
Tranisha,F,100,13,0,13
Traye,M,100,0,13,13
Traysen,M,100,0,13,13
Trease,F,100,13,0,13
Trendyn,M,100,0,13,13
Trevonn,M,100,0,13,13
Trevontae,M,100,0,13,13
Treyshon,M,100,0,13,13
Trillium,F,100,13,0,13
Trinidee,F,100,13,0,13
Tryce,M,100,0,13,13
Turrell,M,100,0,13,13
Tychelle,F,100,13,0,13
Tyffany,F,100,13,0,13
Tyleshia,F,100,13,0,13
Tyrea,F,100,13,0,13
Tysheka,F,100,13,0,13
Valiyah,F,100,13,0,13
Vanesse,F,100,13,0,13
Vaniya,F,100,13,0,13
Vartan,M,100,0,13,13
Vasco,M,100,0,13,13
Vasiliy,M,100,0,13,13
Veldon,M,100,0,13,13
Velisa,F,100,13,0,13
Venesha,F,100,13,0,13
Venisa,F,100,13,0,13
Veria,F,100,13,0,13
Verlee,F,100,13,0,13
Vernadine,F,100,13,0,13
Vian,M,100,0,13,13
Vici,F,100,13,0,13
Vicke,F,100,13,0,13
Victora,F,100,13,0,13
Vidur,M,100,0,13,13
Vihana,F,100,13,0,13
Vineeth,M,100,0,13,13
Viveka,F,100,13,0,13
Viyaan,M,100,0,13,13
Wannetta,F,100,13,0,13
Wilkin,M,100,0,13,13
Wrenley,F,100,13,0,13
Xaine,M,100,0,13,13
Xolani,F,100,13,0,13
Xsavier,M,100,0,13,13
Xya,F,100,13,0,13
Xzavyer,M,100,0,13,13
Yaeli,F,100,13,0,13
Yaelis,F,100,13,0,13
Yali,M,54,6,7,13
Yameli,F,100,13,0,13
Yamili,F,100,13,0,13
Yanelle,F,100,13,0,13
Yarielys,F,100,13,0,13
Yaya,M,100,0,13,13
Yedidya,M,100,0,13,13
Yehya,M,100,0,13,13
Yeily,F,100,13,0,13
Yeiren,M,100,0,13,13
Yeny,F,100,13,0,13
Yeraldy,F,100,13,0,13
Yeremi,M,100,0,13,13
Yeremy,M,100,0,13,13
Yesmin,F,100,13,0,13
Yesnia,F,100,13,0,13
Yifan,M,100,0,13,13
Yoann,M,100,0,13,13
Yohanan,M,100,0,13,13
Yohei,M,100,0,13,13
Yonason,M,100,0,13,13
Yoshio,M,100,0,13,13
Yousof,M,100,0,13,13
Ysabela,F,100,13,0,13
Yuridiana,F,100,13,0,13
Yury,F,100,13,0,13
Zacchary,M,100,0,13,13
Zahkai,M,100,0,13,13
Zahriah,F,100,13,0,13
Zakyla,F,100,13,0,13
Zali,F,100,13,0,13
Zaliya,F,100,13,0,13
Zared,M,100,0,13,13
Zaren,M,100,0,13,13
Zareya,F,100,13,0,13
Zaykeese,M,100,0,13,13
Zebulen,M,100,0,13,13
Zelena,F,100,13,0,13
Zeph,M,100,0,13,13
Zephyra,F,100,13,0,13
Zeriyah,F,100,13,0,13
Zevi,M,100,0,13,13
Zhyaire,M,100,0,13,13
Zhyon,M,100,0,13,13
Zihan,F,54,7,6,13
Zikia,F,100,13,0,13
Zoanne,F,100,13,0,13
Zoella,F,100,13,0,13
Zonna,F,100,13,0,13
Zoua,F,100,13,0,13
Zyiah,F,100,13,0,13
Zymarion,M,100,0,13,13
Zymeer,M,100,0,13,13
Aaila,F,100,12,0,12
Aaima,F,100,12,0,12
Aakarsh,M,100,0,12,12
Aalya,F,100,12,0,12
Aamori,F,100,12,0,12
Aanyah,F,100,12,0,12
Aasin,M,100,0,12,12
Abbrielle,F,100,12,0,12
Abha,F,100,12,0,12
Abhijit,M,100,0,12,12
Abhiraj,M,100,0,12,12
Abilgail,F,100,12,0,12
Adalinn,F,100,12,0,12
Adanely,F,100,12,0,12
Adda,F,100,12,0,12
Addaleigh,F,100,12,0,12
Addelynne,F,100,12,0,12
Adelade,F,100,12,0,12
Adelayde,F,100,12,0,12
Adelee,F,100,12,0,12
Adelfa,F,100,12,0,12
Adewale,M,100,0,12,12
Adhvaith,M,100,0,12,12
Adrius,M,100,0,12,12
Advith,M,100,0,12,12
Aerica,F,100,12,0,12
Afsa,F,100,12,0,12
Agasthya,M,100,0,12,12
Ahlanna,F,100,12,0,12
Ahmire,M,100,0,12,12
Ahnalee,F,100,12,0,12
Ahnesty,F,100,12,0,12
Aiiden,M,100,0,12,12
Aileena,F,100,12,0,12
Ajan,M,100,0,12,12
Ajooni,F,100,12,0,12
Akacia,F,100,12,0,12
Akiba,F,100,12,0,12
Akiem,M,100,0,12,12
Alaniz,F,100,12,0,12
Alaysiah,F,100,12,0,12
Alayssa,F,100,12,0,12
Alaze,F,100,12,0,12
Aldan,M,100,0,12,12
Aleksy,M,100,0,12,12
Alesi,F,100,12,0,12
Algis,M,100,0,12,12
Alianny,F,100,12,0,12
Aliese,F,100,12,0,12
Alira,F,100,12,0,12
Alistar,M,100,0,12,12
Aliyan,M,100,0,12,12
Alizia,F,100,12,0,12
Allani,F,100,12,0,12
Alleena,F,100,12,0,12
Allorah,F,100,12,0,12
Almando,M,100,0,12,12
Almanzo,M,100,0,12,12
Almarie,F,100,12,0,12
Almond,M,100,0,12,12
Alondo,M,100,0,12,12
Alondria,F,100,12,0,12
Alyciana,F,100,12,0,12
Alysiana,F,100,12,0,12
Amairah,F,100,12,0,12
Amanee,F,100,12,0,12
Amaro,M,100,0,12,12
Amarya,F,100,12,0,12
Ameiah,F,100,12,0,12
Ameirah,F,100,12,0,12
Ameliarose,F,100,12,0,12
Amirali,M,100,0,12,12
Ammiel,M,100,0,12,12
Amritpal,M,100,0,12,12
Amryn,F,100,12,0,12
Amunique,F,100,12,0,12
Anacani,F,100,12,0,12
Anachristina,F,100,12,0,12
Anagabriela,F,100,12,0,12
Anahid,F,100,12,0,12
Anahlia,F,100,12,0,12
Analecia,F,100,12,0,12
Analeese,F,100,12,0,12
Analycia,F,100,12,0,12
Anaston,F,100,12,0,12
Andersson,M,100,0,12,12
Andrewjames,M,100,0,12,12
Aneeq,M,100,0,12,12
Aneisa,F,100,12,0,12
Aneudy,M,100,0,12,12
Angellee,F,100,12,0,12
Anginette,F,100,12,0,12
Angula,F,100,12,0,12
Annamay,F,100,12,0,12
Anniemae,F,100,12,0,12
Annison,F,100,12,0,12
Annisten,F,100,12,0,12
Anquette,F,100,12,0,12
Antawon,M,100,0,12,12
Anthonny,M,100,0,12,12
Aquinnah,F,100,12,0,12
Arael,M,100,0,12,12
Arali,F,100,12,0,12
Arita,F,100,12,0,12
Arjenis,M,100,0,12,12
Arleatha,F,100,12,0,12
Arneisha,F,100,12,0,12
Arpita,F,100,12,0,12
Arris,M,100,0,12,12
Arriyana,F,100,12,0,12
Artan,M,100,0,12,12
Arth,M,100,0,12,12
Arvie,M,100,0,12,12
Aryian,F,100,12,0,12
Arzu,F,100,12,0,12
Asah,M,100,0,12,12
Asar,M,100,0,12,12
Asencion,M,100,0,12,12
Aseneth,F,100,12,0,12
Ashantee,F,100,12,0,12
Ashawna,F,100,12,0,12
Ashiyah,F,100,12,0,12
Ashmita,F,100,12,0,12
Ashritha,F,100,12,0,12
Ashtian,M,100,0,12,12
Asra,F,100,12,0,12
Assia,F,100,12,0,12
Atosha,F,100,12,0,12
Atthew,M,100,0,12,12
Audia,F,100,12,0,12
Audrinah,F,100,12,0,12
Aureliana,F,100,12,0,12
Aurther,M,100,0,12,12
Autumne,F,100,12,0,12
Avaclaire,F,100,12,0,12
Avanni,F,100,12,0,12
Avariella,F,100,12,0,12
Aveen,F,100,12,0,12
Averylynn,F,100,12,0,12
Avneesh,M,100,0,12,12
Avonda,F,100,12,0,12
Avonelle,F,100,12,0,12
Avrian,M,100,0,12,12
Avrom,M,100,0,12,12
Ayvion,M,100,0,12,12
Ayvree,F,100,12,0,12
Azaela,F,100,12,0,12
Azaelia,F,100,12,0,12
Azaylah,F,100,12,0,12
Azell,M,100,0,12,12
Azka,F,100,12,0,12
Azumi,F,100,12,0,12
Bascom,M,100,0,12,12
Basit,M,100,0,12,12
Baye,F,100,12,0,12
Beanca,F,100,12,0,12
Becci,F,100,12,0,12
Bekka,F,100,12,0,12
Bellaann,F,100,12,0,12
Benedikt,M,100,0,12,12
Bernerd,M,100,0,12,12
Beunka,F,100,12,0,12
Bhoomi,F,100,12,0,12
Bilinda,F,100,12,0,12
Blaiklee,F,100,12,0,12
Blayz,M,100,0,12,12
Boedy,M,100,0,12,12
Bonniejean,F,100,12,0,12
Bowdy,M,100,0,12,12
Braelie,F,100,12,0,12
Brandilynn,F,100,12,0,12
Braydenn,M,100,0,12,12
Breaja,F,100,12,0,12
Breeah,F,100,12,0,12
Brettany,F,100,12,0,12
Brisyn,M,100,0,12,12
Britiny,F,100,12,0,12
Brittlyn,F,100,12,0,12
Brondon,M,100,0,12,12
Brunetta,F,100,12,0,12
Bryahna,F,100,12,0,12
Brycelyn,F,100,12,0,12
Bryella,F,100,12,0,12
Bryndal,F,100,12,0,12
Brynly,F,100,12,0,12
Brytnee,F,100,12,0,12
Burk,M,100,0,12,12
Cadden,M,100,0,12,12
Cadey,F,100,12,0,12
Caetano,M,100,0,12,12
Cagney,F,100,12,0,12
Caleesi,F,100,12,0,12
Calhoun,M,100,0,12,12
Calixta,F,100,12,0,12
Camrey,F,100,12,0,12
Canela,F,100,12,0,12
Capria,F,100,12,0,12
Caralena,F,100,12,0,12
Cardarius,M,100,0,12,12
Cariah,F,100,12,0,12
Carlicia,F,100,12,0,12
Carlyann,F,100,12,0,12
Carmindy,F,100,12,0,12
Carneshia,F,100,12,0,12
Carreen,F,100,12,0,12
Carshena,F,100,12,0,12
Caselynn,F,100,12,0,12
Cashden,M,100,0,12,12
Caterine,F,100,12,0,12
Catheryne,F,100,12,0,12
Cayci,F,100,12,0,12
Caydn,M,100,0,12,12
Caydyn,M,100,0,12,12
Ceairra,F,100,12,0,12
Cederick,M,100,0,12,12
Cedricka,F,100,12,0,12
Celisse,F,100,12,0,12
Cem,M,100,0,12,12
Ceniya,F,100,12,0,12
Ceria,F,100,12,0,12
Cerita,F,100,12,0,12
Chaille,F,100,12,0,12
Chaison,M,100,0,12,12
Chalet,F,100,12,0,12
Chamia,F,100,12,0,12
Chamika,F,100,12,0,12
Chanan,M,100,0,12,12
Chaneka,F,100,12,0,12
Chantella,F,100,12,0,12
Charitie,F,100,12,0,12
Charniece,F,100,12,0,12
Charrissa,F,100,12,0,12
Chaunice,F,100,12,0,12
Chea,F,100,12,0,12
Chelce,F,100,12,0,12
Chelesea,F,100,12,0,12
Chemaine,F,100,12,0,12
Chenice,F,100,12,0,12
Cherae,F,100,12,0,12
Cherif,M,100,0,12,12
Cherilynn,F,100,12,0,12
Cherylle,F,100,12,0,12
Chevez,M,100,0,12,12
Chidiebere,M,100,0,12,12
Chinedum,M,100,0,12,12
Chinelle,F,100,12,0,12
Chiquitta,F,100,12,0,12
Chonda,F,100,12,0,12
Chriselle,F,100,12,0,12
Christalynn,F,100,12,0,12
Chrostopher,M,100,0,12,12
Cicilia,F,100,12,0,12
Cierah,F,100,12,0,12
Cilicia,F,100,12,0,12
Cinde,F,100,12,0,12
Cintya,F,100,12,0,12
Clancey,M,100,0,12,12
Clearnce,M,100,0,12,12
Cleaven,M,100,0,12,12
Cleone,F,100,12,0,12
Conisha,F,100,12,0,12
Copelin,M,100,0,12,12
Cordarrius,M,100,0,12,12
Corkey,M,100,0,12,12
Cornella,F,100,12,0,12
Correen,F,100,12,0,12
Cruzita,F,100,12,0,12
Crystale,F,100,12,0,12
Crystallynn,F,100,12,0,12
Cuinn,M,100,0,12,12
Cyruss,M,100,0,12,12
Cythina,F,100,12,0,12
Dachelle,F,100,12,0,12
Daeron,M,100,0,12,12
Daiki,M,100,0,12,12
Dajae,F,100,12,0,12
Dakyla,F,100,12,0,12
Dalante,M,100,0,12,12
Daleon,M,100,0,12,12
Damany,M,100,0,12,12
Dameer,M,100,0,12,12
Damek,M,100,0,12,12
Dameria,F,100,12,0,12
Damire,M,100,0,12,12
Danaly,F,100,12,0,12
Danalynn,F,100,12,0,12
Dandria,F,100,12,0,12
Danean,F,100,12,0,12
Danetra,F,100,12,0,12
Danger,M,100,0,12,12
Dannis,M,100,0,12,12
Dannyelle,F,100,12,0,12
Daqwan,M,100,0,12,12
Daray,M,100,0,12,12
Dariany,F,100,12,0,12
Darie,F,100,12,0,12
Dariella,F,100,12,0,12
Darika,F,100,12,0,12
Darr,M,100,0,12,12
Darvon,M,100,0,12,12
Daschel,M,100,0,12,12
Davesha,F,100,12,0,12
Davionte,M,100,0,12,12
Dayah,F,100,12,0,12
Dazha,F,100,12,0,12
Dazion,M,100,0,12,12
Deardra,F,100,12,0,12
Decorey,M,100,0,12,12
Decorian,M,100,0,12,12
Delaysia,F,100,12,0,12
Delee,F,100,12,0,12
Delesha,F,100,12,0,12
Delesia,F,100,12,0,12
Delisia,F,100,12,0,12
Delita,F,100,12,0,12
Dellar,F,100,12,0,12
Delmira,F,100,12,0,12
Delmon,M,100,0,12,12
Delorian,M,58,5,7,12
Delvis,M,100,0,12,12
Demareon,M,100,0,12,12
Demetres,M,100,0,12,12
Demontra,M,100,0,12,12
Demri,F,100,12,0,12
Demyan,M,100,0,12,12
Denaly,F,100,12,0,12
Denari,M,58,5,7,12
Denelda,F,100,12,0,12
Denham,M,100,0,12,12
Der,F,100,12,0,12
Derelle,M,100,0,12,12
Deriel,M,100,0,12,12
Deriona,F,100,12,0,12
Derl,M,100,0,12,12
Dessirae,F,100,12,0,12
Destan,M,100,0,12,12
Detrich,M,100,0,12,12
Deuce,M,100,0,12,12
Devahn,M,100,0,12,12
Devrin,M,100,0,12,12
Devyani,F,100,12,0,12
Devyon,M,100,0,12,12
Dezlynn,F,100,12,0,12
Dezrae,F,100,12,0,12
Deztinee,F,100,12,0,12
Diani,F,100,12,0,12
Diaz,M,100,0,12,12
Dierre,M,100,0,12,12
Diesha,F,100,12,0,12
Dlisa,F,100,12,0,12
Dmarkus,M,100,0,12,12
Doneshia,F,100,12,0,12
Donie,M,100,0,12,12
Doniece,F,100,12,0,12
Donnise,F,100,12,0,12
Dontavion,M,100,0,12,12
Doriane,F,100,12,0,12
Dorraine,F,100,12,0,12
Dorreen,F,100,12,0,12
Dorsie,F,50,6,6,12
Draeson,M,100,0,12,12
Drago,M,100,0,12,12
Drelynn,F,50,6,6,12
Driana,F,100,12,0,12
Drisana,F,100,12,0,12
Drystan,M,100,0,12,12
Durante,M,100,0,12,12
Dwyne,M,100,0,12,12
Dyshaun,M,100,0,12,12
Dystany,F,100,12,0,12
Dzaria,F,100,12,0,12
Ealyn,F,100,12,0,12
Eanna,F,100,12,0,12
Earley,M,100,0,12,12
Ebubechukwu,M,100,0,12,12
Ece,F,100,12,0,12
Edee,F,100,12,0,12
Edmonia,F,100,12,0,12
Edwen,M,100,0,12,12
Edyson,M,100,0,12,12
Eisele,F,100,12,0,12
Ekamjot,M,100,0,12,12
Elanah,F,100,12,0,12
Elen,F,100,12,0,12
Eletha,F,100,12,0,12
Eliazer,M,100,0,12,12
Eliotte,F,100,12,0,12
Elisah,F,50,6,6,12
Elishua,M,100,0,12,12
Ellizabeth,F,100,12,0,12
Ellorie,F,100,12,0,12
Elmar,M,100,0,12,12
Elonzo,M,100,0,12,12
Elta,F,100,12,0,12
Elyanah,F,100,12,0,12
Emannuel,M,100,0,12,12
Emelee,F,100,12,0,12
Emersynn,F,100,12,0,12
Emidio,M,100,0,12,12
Emila,F,100,12,0,12
Emillee,F,100,12,0,12
Emmani,F,100,12,0,12
Emron,M,100,0,12,12
Endre,M,100,0,12,12
Enora,F,100,12,0,12
Eponine,F,100,12,0,12
Erasto,M,100,0,12,12
Erikk,M,100,0,12,12
Eriko,F,100,12,0,12
Erioluwa,F,58,7,5,12
Erman,M,100,0,12,12
Ermin,M,100,0,12,12
Erubiel,M,100,0,12,12
Esrom,M,100,0,12,12
Essense,F,100,12,0,12
Estefano,M,100,0,12,12
Estelita,F,100,12,0,12
Etter,F,100,12,0,12
Euel,M,100,0,12,12
Eulas,M,100,0,12,12
Eunise,F,100,12,0,12
Euphemia,F,100,12,0,12
Evaluna,F,100,12,0,12
Evaly,F,100,12,0,12
Evarose,F,100,12,0,12
Everlynn,F,100,12,0,12
Evonny,F,100,12,0,12
Exander,M,100,0,12,12
Ezeriah,M,100,0,12,12
Eziel,M,100,0,12,12
Fabrizzio,M,100,0,12,12
Fahed,M,100,0,12,12
Falisa,F,100,12,0,12
Faria,F,100,12,0,12
Farzad,M,100,0,12,12
Fatiha,F,100,12,0,12
Fatim,F,100,12,0,12
Fedrick,M,100,0,12,12
Feliks,M,100,0,12,12
Felise,F,100,12,0,12
Ferrin,F,100,12,0,12
Filippa,F,100,12,0,12
Flonnie,F,100,12,0,12
Francely,F,100,12,0,12
Franke,M,100,0,12,12
Frann,F,100,12,0,12
Gaetana,F,100,12,0,12
Garlin,M,100,0,12,12
Gaudencio,M,100,0,12,12
Gawain,M,100,0,12,12
Gazelle,F,100,12,0,12
Gearold,M,100,0,12,12
Geetika,F,100,12,0,12
Genay,F,100,12,0,12
Geneice,F,100,12,0,12
Geniece,F,100,12,0,12
Genieva,F,100,12,0,12
Genoa,F,100,12,0,12
Georgean,F,100,12,0,12
Gerik,M,100,0,12,12
Ghita,F,100,12,0,12
Giang,F,100,12,0,12
Giannie,F,100,12,0,12
Gillianne,F,100,12,0,12
Gillie,M,100,0,12,12
Giovoni,M,100,0,12,12
Girtha,F,100,12,0,12
Glean,M,100,0,12,12
Glendal,M,100,0,12,12
Glenetta,F,100,12,0,12
Glennisha,F,100,12,0,12
Gokul,M,100,0,12,12
Gracelee,F,100,12,0,12
Gracemarie,F,100,12,0,12
Graeden,M,100,0,12,12
Gregoire,M,100,0,12,12
Greogory,M,100,0,12,12
Gresham,M,100,0,12,12
Grisela,F,100,12,0,12
Guage,M,100,0,12,12
Guhan,M,100,0,12,12
Guneet,F,100,12,0,12
Haasini,F,100,12,0,12
Hade,F,100,12,0,12
Hades,M,100,0,12,12
Hadja,F,100,12,0,12
Haelie,F,100,12,0,12
Hafiz,M,100,0,12,12
Haidan,M,100,0,12,12
Haileyann,F,100,12,0,12
Hairo,M,100,0,12,12
Haivyn,F,100,12,0,12
Hajira,F,100,12,0,12
Hakob,M,100,0,12,12
Hamna,F,100,12,0,12
Hara,F,100,12,0,12
Harding,M,100,0,12,12
Harika,F,100,12,0,12
Harumi,F,100,12,0,12
Harut,M,100,0,12,12
Hastings,M,58,5,7,12
Haydar,M,100,0,12,12
Hayzlee,F,100,12,0,12
Hebron,M,58,5,7,12
Hedaya,F,100,12,0,12
Heleena,F,100,12,0,12
Henya,F,100,12,0,12
Heru,M,100,0,12,12
Hilaree,F,100,12,0,12
Hilinai,F,100,12,0,12
Holdon,M,100,0,12,12
Hoor,F,100,12,0,12
Hridaan,M,100,0,12,12
Huntleigh,F,100,12,0,12
Hurshel,M,100,0,12,12
Huxton,M,100,0,12,12
Iago,M,100,0,12,12
Ikeshia,F,100,12,0,12
Iliany,F,100,12,0,12
Imberly,F,100,12,0,12
Imir,M,100,0,12,12
Inesha,F,100,12,0,12
Inmer,M,100,0,12,12
Inri,M,100,0,12,12
Iretha,F,100,12,0,12
Ishmel,M,100,0,12,12
Ithiel,M,100,0,12,12
Itzamara,F,100,12,0,12
Iyanni,F,100,12,0,12
Izai,M,100,0,12,12
Izaia,M,100,0,12,12
Izeiah,M,100,0,12,12
Izen,M,100,0,12,12
Jabe,M,100,0,12,12
Jacier,M,100,0,12,12
Jackston,M,100,0,12,12
Jaclyne,F,100,12,0,12
Jacobson,M,100,0,12,12
Jacorion,M,100,0,12,12
Jacqline,F,100,12,0,12
Jacquenette,F,100,12,0,12
Jadalee,F,100,12,0,12
Jadalise,F,100,12,0,12
Jaeanna,F,100,12,0,12
Jaethan,M,100,0,12,12
Jahmiya,F,100,12,0,12
Jahnay,F,100,12,0,12
Jahzel,F,100,12,0,12
Jaivian,M,100,0,12,12
Jaiyla,F,100,12,0,12
Jaizen,M,100,0,12,12
Jakarra,F,100,12,0,12
Jakevious,M,100,0,12,12
Jakim,M,100,0,12,12
Jakyle,M,100,0,12,12
Jalayne,F,100,12,0,12
Jaleea,F,100,12,0,12
Jaliana,F,100,12,0,12
Jalisia,F,100,12,0,12
Jaliza,F,100,12,0,12
Jalysia,F,100,12,0,12
Jamaira,F,100,12,0,12
Jamarques,M,100,0,12,12
Jamellah,F,100,12,0,12
Jamerria,F,100,12,0,12
Jamse,M,100,0,12,12
Janajah,F,100,12,0,12
Janyth,F,100,12,0,12
Jaquane,M,100,0,12,12
Jaquasia,F,100,12,0,12
Jaquesha,F,100,12,0,12
Jaramie,M,100,0,12,12
Jarelyn,F,100,12,0,12
Jarica,F,100,12,0,12
Jarreth,M,100,0,12,12
Jarrica,F,100,12,0,12
Jary,M,100,0,12,12
Jasreet,F,100,12,0,12
Jasun,M,100,0,12,12
Javanna,F,100,12,0,12
Javohn,M,100,0,12,12
Jawann,M,100,0,12,12
Jayceona,F,100,12,0,12
Jaydalis,F,100,12,0,12
Jaydi,F,100,12,0,12
Jayk,M,100,0,12,12
Jaylannie,F,100,12,0,12
Jaylianie,F,100,12,0,12
Jayr,M,100,0,12,12
Jayshun,M,100,0,12,12
Jazavion,M,100,0,12,12
Jazirah,F,100,12,0,12
Jazly,F,100,12,0,12
Jazzlyne,F,100,12,0,12
Jeanella,F,100,12,0,12
Jeanphilippe,M,100,0,12,12
Jeany,F,100,12,0,12
Jecaryous,M,100,0,12,12
Jeida,F,100,12,0,12
Jeila,F,100,12,0,12
Jeilin,F,100,12,0,12
Jejuan,M,100,0,12,12
Jemuel,M,100,0,12,12
Jenella,F,100,12,0,12
Jenevy,F,100,12,0,12
Jennaya,F,100,12,0,12
Jenniefer,F,100,12,0,12
Jer,F,100,12,0,12
Jericko,M,100,0,12,12
Jerniyah,F,100,12,0,12
Jessic,F,100,12,0,12
Jessina,F,100,12,0,12
Jewelene,F,100,12,0,12
Jhaiden,M,100,0,12,12
Jhourni,F,100,12,0,12
Jiarui,M,100,0,12,12
Jimin,M,100,0,12,12
Jizzelle,F,100,12,0,12
Joaopedro,M,100,0,12,12
Joeline,F,100,12,0,12
Johanthan,M,100,0,12,12
Johnasia,F,100,12,0,12
Johnattan,M,100,0,12,12
Johni,F,100,12,0,12
Johnica,F,100,12,0,12
Johniece,F,100,12,0,12
Johnnell,M,100,0,12,12
Johnnyray,M,100,0,12,12
Johnse,M,100,0,12,12
Jola,F,100,12,0,12
Joliene,F,100,12,0,12
Jonavon,M,100,0,12,12
Jonesha,F,100,12,0,12
Jonessa,F,100,12,0,12
Jonise,F,100,12,0,12
Jonnah,F,58,7,5,12
Jora,F,100,12,0,12
Jordache,M,100,0,12,12
Jorin,M,100,0,12,12
Josearmando,M,100,0,12,12
Joseguadalupe,M,100,0,12,12
Joshuajames,M,100,0,12,12
Joshual,M,100,0,12,12
Josip,M,100,0,12,12
Jovahn,M,100,0,12,12
Jovontae,M,100,0,12,12
Joyceann,F,100,12,0,12
Joyice,F,100,12,0,12
Jozlin,F,100,12,0,12
Jozyah,M,100,0,12,12
Ju,M,58,5,7,12
Judeth,F,100,12,0,12
Julanne,F,100,12,0,12
Juliessa,F,100,12,0,12
Juliete,F,100,12,0,12
Jull,F,100,12,0,12
Jumanah,F,100,12,0,12
Juwana,F,100,12,0,12
Jvaughn,M,100,0,12,12
Jyasia,F,100,12,0,12
Jyquez,M,100,0,12,12
Kadeen,M,100,0,12,12
Kaelem,M,100,0,12,12
Kaiel,M,100,0,12,12
Kaijah,F,100,12,0,12
Kailas,M,100,0,12,12
Kairan,M,100,0,12,12
Kaladin,M,100,0,12,12
Kalandra,F,100,12,0,12
Kalven,M,100,0,12,12
Kalysa,F,100,12,0,12
Kamarius,M,100,0,12,12
Kamariyah,F,100,12,0,12
Kamaryn,F,100,12,0,12
Kamberlyn,F,100,12,0,12
Kamir,M,100,0,12,12
Kano,M,100,0,12,12
Kapiolani,F,100,12,0,12
Karelys,F,100,12,0,12
Karlis,M,100,0,12,12
Karne,F,100,12,0,12
Karo,M,100,0,12,12
Kasarah,F,100,12,0,12
Kashis,M,100,0,12,12
Kastle,M,100,0,12,12
Katalea,F,100,12,0,12
Katelind,F,100,12,0,12
Katelinn,F,100,12,0,12
Kateryna,F,100,12,0,12
Katielyn,F,100,12,0,12
Katria,F,100,12,0,12
Kavia,F,100,12,0,12
Kawanis,F,100,12,0,12
Kayen,M,100,0,12,12
Kaylanni,F,100,12,0,12
Kaylonnie,F,100,12,0,12
Kayman,M,100,0,12,12
Kaytlan,F,100,12,0,12
Kayvin,M,100,0,12,12
Kazim,M,100,0,12,12
Kebra,F,100,12,0,12
Kebron,M,100,0,12,12
Kedron,M,100,0,12,12
Keerstin,F,100,12,0,12
Keiaira,F,100,12,0,12
Keierra,F,100,12,0,12
Kellis,M,100,0,12,12
Keltin,M,100,0,12,12
Kenay,M,100,0,12,12
Kenishia,F,100,12,0,12
Kennett,M,100,0,12,12
Kerianna,F,100,12,0,12
Kerline,F,100,12,0,12
Kerly,F,100,12,0,12
Kes,F,100,12,0,12
Keshonda,F,100,12,0,12
Keshonna,F,100,12,0,12
Ketcher,M,100,0,12,12
Ketzia,F,100,12,0,12
Keuna,F,100,12,0,12
Kevaun,M,100,0,12,12
Kevontay,M,100,0,12,12
Keydi,F,100,12,0,12
Keyen,M,100,0,12,12
Keyira,F,100,12,0,12
Keylani,F,100,12,0,12
Keymora,F,100,12,0,12
Keyonn,M,100,0,12,12
Keyonni,F,100,12,0,12
Keyuana,F,100,12,0,12
Khadar,M,100,0,12,12
Khadyn,M,100,0,12,12
Khaleelah,F,100,12,0,12
Khaleem,M,100,0,12,12
Khalyl,M,100,0,12,12
Khalyn,F,100,12,0,12
Kham,M,100,0,12,12
Kharson,M,100,0,12,12
Khasir,M,100,0,12,12
Khassidy,F,100,12,0,12
Khristen,F,100,12,0,12
Kieon,M,100,0,12,12
Kimanh,F,100,12,0,12
Kimeka,F,100,12,0,12
Kimimila,F,100,12,0,12
Kimmerly,F,100,12,0,12
Kingsolomon,M,100,0,12,12
Kinslea,F,100,12,0,12
Kiralyn,F,100,12,0,12
Kiryn,F,100,12,0,12
Kisara,F,100,12,0,12
Kiswana,F,100,12,0,12
Kitti,F,100,12,0,12
Kivon,M,100,0,12,12
Kiyen,M,100,0,12,12
Kiyoko,F,100,12,0,12
Kliyah,F,100,12,0,12
Knixon,M,100,0,12,12
Knyla,F,100,12,0,12
Ko,M,100,0,12,12
Koralee,F,100,12,0,12
Korynne,F,100,12,0,12
Kresha,F,100,12,0,12
Kripa,F,100,12,0,12
Krishang,M,100,0,12,12
Krishon,M,100,0,12,12
Kristien,F,100,12,0,12
Kristyana,F,100,12,0,12
Krysia,F,100,12,0,12
Krystelle,F,100,12,0,12
Kurstyn,F,100,12,0,12
Kwamain,M,100,0,12,12
Kyian,M,100,0,12,12
Kylle,M,100,0,12,12
Kyllian,M,100,0,12,12
Kynslei,F,100,12,0,12
Kytzia,F,100,12,0,12
Kyung,M,58,5,7,12
Lacresia,F,100,12,0,12
Ladaja,F,100,12,0,12
Ladarrion,M,100,0,12,12
Laeton,M,100,0,12,12
Laiana,F,100,12,0,12
Lajessica,F,100,12,0,12
Lakeeta,F,100,12,0,12
Lakera,F,100,12,0,12
Lakesa,F,100,12,0,12
Lalania,F,100,12,0,12
Laleh,F,100,12,0,12
Lalla,F,100,12,0,12
Laloni,F,100,12,0,12
Lamarquis,M,100,0,12,12
Lamonta,M,100,0,12,12
Laniqua,F,100,12,0,12
Laquia,F,100,12,0,12
Laquisa,F,100,12,0,12
Laria,F,100,12,0,12
Larice,F,100,12,0,12
Larna,F,100,12,0,12
Laroyce,M,100,0,12,12
Larua,F,100,12,0,12
Lashala,F,100,12,0,12
Lashann,F,100,12,0,12
Lashira,F,100,12,0,12
Lashunta,F,100,12,0,12
Lashya,F,100,12,0,12
Latandra,F,100,12,0,12
Latarius,M,100,0,12,12
Lateefa,F,100,12,0,12
Latese,F,100,12,0,12
Lathyn,M,100,0,12,12
Laticha,F,100,12,0,12
Latifha,F,100,12,0,12
Latisia,F,100,12,0,12
Latrinity,F,100,12,0,12
Latwan,M,100,0,12,12
Laurali,F,100,12,0,12
Laurencia,F,100,12,0,12
Laurina,F,100,12,0,12
Lavarius,M,100,0,12,12
Lay,F,58,7,5,12
Laylie,F,100,12,0,12
Leanndra,F,100,12,0,12
Leanor,F,100,12,0,12
Lear,F,100,12,0,12
Leauna,F,100,12,0,12
Leelin,M,100,0,12,12
Leiby,M,100,0,12,12
Leium,M,100,0,12,12
Lekeya,F,100,12,0,12
Leonce,M,100,0,12,12
Leondro,M,100,0,12,12
Leontae,M,100,0,12,12
Leshelle,F,100,12,0,12
Leslian,F,100,12,0,12
Leslieanne,F,100,12,0,12
Lethea,F,100,12,0,12
Levonda,F,100,12,0,12
Lexys,F,100,12,0,12
Liamjames,M,100,0,12,12
Liandro,M,100,0,12,12
Liav,M,100,0,12,12
Libertie,F,100,12,0,12
Licet,F,100,12,0,12
Liesha,F,100,12,0,12
Lilianah,F,100,12,0,12
Linae,F,100,12,0,12
Lincon,M,100,0,12,12
Liyat,F,100,12,0,12
Lizamarie,F,100,12,0,12
Lonisha,F,100,12,0,12
Lonne,M,100,0,12,12
Lorah,F,100,12,0,12
Louellen,F,100,12,0,12
Louretta,F,100,12,0,12
Lovelle,F,58,7,5,12
Lovenia,F,100,12,0,12
Loza,F,100,12,0,12
Ludmila,F,100,12,0,12
Luise,F,58,7,5,12
Luisgustavo,M,100,0,12,12
Lylianah,F,100,12,0,12
Lynli,F,100,12,0,12
Lynora,F,100,12,0,12
Lyrique,F,100,12,0,12
Maanas,M,100,0,12,12
Maanav,M,100,0,12,12
Maanvi,F,100,12,0,12
Maddoc,M,100,0,12,12
Madeeha,F,100,12,0,12
Madelinn,F,100,12,0,12
Madsen,M,100,0,12,12
Mady,F,100,12,0,12
Maejor,M,100,0,12,12
Maekayla,F,100,12,0,12
Magally,F,100,12,0,12
Magdelene,F,100,12,0,12
Mahalah,F,100,12,0,12
Mahd,M,100,0,12,12
Mahogony,F,100,12,0,12
Maijor,M,100,0,12,12
Maitri,F,100,12,0,12
Majer,M,100,0,12,12
Majesti,F,100,12,0,12
Majour,M,100,0,12,12
Makayia,F,100,12,0,12
Makyle,M,100,0,12,12
Malanda,F,100,12,0,12
Malijah,F,100,12,0,12
Malu,F,100,12,0,12
Malyiah,F,100,12,0,12
Mane,F,100,12,0,12
Mani,M,100,0,12,12
Mania,F,100,12,0,12
Manyah,F,100,12,0,12
Marchel,F,100,12,0,12
Marget,F,100,12,0,12
Mariabelen,F,100,12,0,12
Mariavictoria,F,100,12,0,12
Maricus,M,100,0,12,12
Marijah,F,100,12,0,12
Marijayne,F,100,12,0,12
Markala,F,100,12,0,12
Marketia,F,100,12,0,12
Marleena,F,100,12,0,12
Marlita,F,100,12,0,12
Marnell,F,100,12,0,12
Marnesha,F,100,12,0,12
Marshe,F,100,12,0,12
Marsi,F,100,12,0,12
Marvion,M,100,0,12,12
Marvon,M,100,0,12,12
Maryem,F,100,12,0,12
Maryori,F,100,12,0,12
Masahiro,M,100,0,12,12
Mase,M,100,0,12,12
Mashonda,F,100,12,0,12
Maston,M,100,0,12,12
Mattheu,M,100,0,12,12
Maxamus,M,100,0,12,12
Maxin,M,100,0,12,12
Maydelin,F,100,12,0,12
Mayline,F,100,12,0,12
Mcgarrett,M,100,0,12,12
Mckinnon,M,100,0,12,12
Mckinzi,F,100,12,0,12
Mckynzee,F,100,12,0,12
Meaghann,F,100,12,0,12
Mekiah,M,58,5,7,12
Meleia,F,100,12,0,12
Melenda,F,100,12,0,12
Melven,M,100,0,12,12
Melvinia,F,100,12,0,12
Melynn,F,100,12,0,12
Mercury,M,100,0,12,12
Michaelia,F,100,12,0,12
Michaeljoseph,M,100,0,12,12
Michalla,F,100,12,0,12
Mielle,F,100,12,0,12
Mikaylin,F,100,12,0,12
Milam,M,100,0,12,12
Milez,M,100,0,12,12
Mingo,M,100,0,12,12
Miniya,F,100,12,0,12
Mionna,F,100,12,0,12
Miosha,F,100,12,0,12
Miwa,F,100,12,0,12
Momodou,M,100,0,12,12
Monaca,F,100,12,0,12
Mong,M,100,0,12,12
Montey,M,100,0,12,12
Montserrath,F,100,12,0,12
Morgin,F,100,12,0,12
Morningstar,F,100,12,0,12
Morse,M,100,0,12,12
Mosie,M,100,0,12,12
Mounir,M,100,0,12,12
Mung,M,100,0,12,12
Muscab,M,100,0,12,12
Mutasim,M,100,0,12,12
Mykalah,F,100,12,0,12
Mykle,M,100,0,12,12
Myleigha,F,100,12,0,12
Myrtie,F,100,12,0,12
Mythili,F,100,12,0,12
Naason,M,100,0,12,12
Nafisah,F,100,12,0,12
Nahal,F,100,12,0,12
Naiah,F,100,12,0,12
Nameera,F,100,12,0,12
Naoko,F,100,12,0,12
Napolean,M,100,0,12,12
Naraya,F,100,12,0,12
Natha,F,100,12,0,12
Nathally,F,100,12,0,12
Nathanyl,M,100,0,12,12
Natilyn,F,100,12,0,12
Navell,M,100,0,12,12
Naven,M,100,0,12,12
Nayanna,F,100,12,0,12
Nayela,F,100,12,0,12
Nayeliz,F,100,12,0,12
Nayvie,F,100,12,0,12
Ndrew,M,100,0,12,12
Nealie,F,100,12,0,12
Neariah,F,100,12,0,12
Neer,M,100,0,12,12
Nellene,F,100,12,0,12
Nelta,F,100,12,0,12
Nephtalie,F,100,12,0,12
Nerea,F,100,12,0,12
Nerida,F,100,12,0,12
Nevelyn,F,100,12,0,12
Nghia,M,100,0,12,12
Niamiah,F,100,12,0,12
Nicandro,M,100,0,12,12
Nicia,F,100,12,0,12
Nickita,F,100,12,0,12
Nickolette,F,100,12,0,12
Nidra,F,100,12,0,12
Nigil,M,100,0,12,12
Nijay,F,50,6,6,12
Nik,M,100,0,12,12
Nikaela,F,100,12,0,12
Nike,M,100,0,12,12
Nikkol,F,100,12,0,12
Nikolaj,M,100,0,12,12
Nilam,F,100,12,0,12
Nilani,F,100,12,0,12
Nilesh,M,100,0,12,12
Niquita,F,100,12,0,12
Nitara,F,100,12,0,12
Nitosha,F,100,12,0,12
Nivan,M,100,0,12,12
Nixxon,M,100,0,12,12
Nolon,M,100,0,12,12
Noriana,F,100,12,0,12
Norrine,F,100,12,0,12
Nubaid,M,100,0,12,12
Nupur,F,100,12,0,12
Nyair,M,100,0,12,12
Nyalee,F,100,12,0,12
Nycholas,M,100,0,12,12
Nyel,F,50,6,6,12
Nylea,F,100,12,0,12
Nyquan,M,100,0,12,12
Nyrah,F,100,12,0,12
Obdulio,M,100,0,12,12
Odilon,M,100,0,12,12
Ofilia,F,100,12,0,12
Okoye,M,100,0,12,12
Olawale,M,100,0,12,12
Olesya,F,100,12,0,12
Ollis,M,100,0,12,12
Oluwatofunmi,F,100,12,0,12
Oluwatoni,F,100,12,0,12
Oluwatoyin,F,100,12,0,12
Omare,M,100,0,12,12
Omaria,F,100,12,0,12
Onesti,F,100,12,0,12
Oniel,M,100,0,12,12
Onisha,F,100,12,0,12
Opeyemi,F,50,6,6,12
Orbie,M,100,0,12,12
Orit,F,100,12,0,12
Oryn,M,100,0,12,12
Ourania,F,100,12,0,12
Pakou,F,100,12,0,12
Pal,M,100,0,12,12
Pamel,F,100,12,0,12
Pardeep,M,100,0,12,12
Particia,F,100,12,0,12
Pasty,F,100,12,0,12
Patsi,F,100,12,0,12
Pattijo,F,100,12,0,12
Paulanthony,M,100,0,12,12
Pauleen,F,100,12,0,12
Paullette,F,100,12,0,12
Payeton,F,100,12,0,12
Perriann,F,100,12,0,12
Perrine,F,100,12,0,12
Phillippa,F,100,12,0,12
Pierrette,F,100,12,0,12
Porchea,F,100,12,0,12
Pranit,M,100,0,12,12
Pranjal,M,100,0,12,12
Preeya,F,100,12,0,12
Preshus,F,100,12,0,12
Princessa,F,100,12,0,12
Priseis,F,100,12,0,12
Promyce,F,100,12,0,12
Puanani,F,100,12,0,12
Quentavious,M,100,0,12,12
Quiniyah,F,100,12,0,12
Quinshawn,M,100,0,12,12
Quinterrius,M,100,0,12,12
Quintisha,F,100,12,0,12
Quiona,F,100,12,0,12
Rabab,F,100,12,0,12
Rabecka,F,100,12,0,12
Rachid,M,100,0,12,12
Raelea,F,100,12,0,12
Raenelle,F,100,12,0,12
Raevin,F,100,12,0,12
Rahjon,M,100,0,12,12
Rahmaan,M,100,0,12,12
Raife,M,100,0,12,12
Raihana,F,100,12,0,12
Raionna,F,100,12,0,12
Rajvi,F,100,12,0,12
Ralphy,M,100,0,12,12
Raseel,F,100,12,0,12
Rasheema,F,100,12,0,12
Rasheka,F,100,12,0,12
Ravindra,M,100,0,12,12
Rechy,F,100,12,0,12
Reeanna,F,100,12,0,12
Reighan,F,100,12,0,12
Relena,F,100,12,0,12
Rendy,F,100,12,0,12
Rennard,M,100,0,12,12
Renz,M,100,0,12,12
Requel,F,100,12,0,12
Reven,M,100,0,12,12
Revin,M,100,0,12,12
Rhaegan,F,100,12,0,12
Rhyne,M,100,0,12,12
Ricka,F,100,12,0,12
Rigg,M,100,0,12,12
Riky,M,100,0,12,12
Rino,M,100,0,12,12
Rishith,M,100,0,12,12
Riyansh,M,100,0,12,12
Rodnisha,F,100,12,0,12
Rodny,M,100,0,12,12
Rogerick,M,100,0,12,12
Rokhaya,F,100,12,0,12
Rolondo,M,100,0,12,12
Romani,M,100,0,12,12
Romeka,F,100,12,0,12
Romesha,F,100,12,0,12
Ronasia,F,100,12,0,12
Rosalita,F,100,12,0,12
Rosamary,F,100,12,0,12
Rosealyn,F,100,12,0,12
Rosezetta,F,100,12,0,12
Roshini,F,100,12,0,12
Rosmeri,F,100,12,0,12
Rossanna,F,100,12,0,12
Rubby,F,100,12,0,12
Rucha,F,100,12,0,12
Ruwaida,F,100,12,0,12
Ryananthony,M,100,0,12,12
Ryerson,M,100,0,12,12
Ryonna,F,100,12,0,12
Ryszard,M,100,0,12,12
Sabrie,F,100,12,0,12
Sachit,M,100,0,12,12
Sadrac,M,100,0,12,12
Saeeda,F,100,12,0,12
Saheim,M,100,0,12,12
Saifullah,M,100,0,12,12
Saiquan,M,100,0,12,12
Sairy,F,100,12,0,12
Sakariye,M,100,0,12,12
Sakib,M,100,0,12,12
Salaya,F,100,12,0,12
Salayah,F,100,12,0,12
Salil,M,100,0,12,12
Sallee,F,100,12,0,12
Samamtha,F,100,12,0,12
Samere,M,100,0,12,12
Sanchi,F,100,12,0,12
Sandar,F,100,12,0,12
Sanela,F,100,12,0,12
Sansa,F,100,12,0,12
Sante,M,100,0,12,12
Saory,F,100,12,0,12
Saragrace,F,100,12,0,12
Saraye,F,100,12,0,12
Saunders,M,100,0,12,12
Say,F,58,7,5,12
Schaeffer,M,100,0,12,12
Scharlene,F,100,12,0,12
Seaver,M,100,0,12,12
Seda,F,100,12,0,12
Senya,F,100,12,0,12
Seraya,F,100,12,0,12
Sergi,M,100,0,12,12
Seward,M,100,0,12,12
Seyon,M,100,0,12,12
Shaasia,F,100,12,0,12
Shahzad,M,100,0,12,12
Shakthi,F,100,12,0,12
Shalev,M,100,0,12,12
Shamarah,F,100,12,0,12
Shamila,F,100,12,0,12
Shandalyn,F,100,12,0,12
Shanedra,F,100,12,0,12
Shanena,F,100,12,0,12
Shaneta,F,100,12,0,12
Shanikwa,F,100,12,0,12
Shanlee,F,100,12,0,12
Shantalle,F,100,12,0,12
Shantanu,M,100,0,12,12
Shantaya,F,100,12,0,12
Shaquaya,F,100,12,0,12
Shaquia,F,100,12,0,12
Shaquna,F,100,12,0,12
Sharaine,F,100,12,0,12
Shareeka,F,100,12,0,12
Sharnee,F,100,12,0,12
Sharya,F,100,12,0,12
Sharyle,F,100,12,0,12
Shashwat,M,100,0,12,12
Shatanya,F,100,12,0,12
Shaterria,F,100,12,0,12
Shavawn,F,100,12,0,12
Shavonta,F,100,12,0,12
Shawneequa,F,100,12,0,12
Shawntee,F,100,12,0,12
Shazil,M,100,0,12,12
Sheindy,F,100,12,0,12
Shekera,F,100,12,0,12
Shelcy,F,100,12,0,12
Shelisha,F,100,12,0,12
Sheniya,F,100,12,0,12
Shernell,F,100,12,0,12
Sherryann,F,100,12,0,12
Shevette,F,100,12,0,12
Shewanda,F,100,12,0,12
Shin,M,100,0,12,12
Shirika,F,100,12,0,12
Shirlynn,F,100,12,0,12
Shivaan,M,100,0,12,12
Shonique,F,100,12,0,12
Shonnie,F,100,12,0,12
Shontee,F,100,12,0,12
Shulamit,F,100,12,0,12
Shunsuke,M,100,0,12,12
Shykeria,F,100,12,0,12
Shyquan,M,100,0,12,12
Silje,F,100,12,0,12
Silviano,M,100,0,12,12
Simao,M,100,0,12,12
Sims,M,100,0,12,12
Sinaya,F,100,12,0,12
Siriyah,F,100,12,0,12
Skii,F,100,12,0,12
Sofiagrace,F,100,12,0,12
Soleia,F,100,12,0,12
Solomiya,F,100,12,0,12
Solstice,F,100,12,0,12
Sonika,F,100,12,0,12
Sophiee,F,100,12,0,12
Sorah,F,100,12,0,12
Spartacus,M,100,0,12,12
Squire,M,100,0,12,12
Sri,F,100,12,0,12
Srijan,M,100,0,12,12
Sritha,F,100,12,0,12
Starlit,F,100,12,0,12
Stephana,F,100,12,0,12
Storee,F,100,12,0,12
Stpehanie,F,100,12,0,12
Suah,F,100,12,0,12
Sueling,F,100,12,0,12
Suhaas,M,100,0,12,12
Sujata,F,100,12,0,12
Suprena,F,100,12,0,12
Sureya,F,100,12,0,12
Suvir,M,100,0,12,12
Syniyah,F,100,12,0,12
Taahir,M,100,0,12,12
Tacari,M,100,0,12,12
Tachelle,F,100,12,0,12
Tadan,M,100,0,12,12
Tadashi,M,100,0,12,12
Taetum,F,100,12,0,12
Tahya,F,100,12,0,12
Taima,F,100,12,0,12
Talani,F,100,12,0,12
Talli,F,100,12,0,12
Tallin,M,100,0,12,12
Talysa,F,100,12,0,12
Tamantha,F,100,12,0,12
Tamyka,F,100,12,0,12
Tanayia,F,100,12,0,12
Tandre,M,100,0,12,12
Tange,F,100,12,0,12
Tarion,M,100,0,12,12
Tarrel,M,100,0,12,12
Tary,M,58,5,7,12
Tashala,F,100,12,0,12
Tashvi,F,100,12,0,12
Tatsuya,M,100,0,12,12
Tauheed,M,100,0,12,12
Tavari,M,100,0,12,12
Tavio,M,100,0,12,12
Tavonna,F,100,12,0,12
Tayllor,F,100,12,0,12
Taziah,F,100,12,0,12
Teletha,F,100,12,0,12
Teller,M,100,0,12,12
Tenay,F,100,12,0,12
Tennelle,F,100,12,0,12
Tenya,F,100,12,0,12
Teondra,F,100,12,0,12
Terianna,F,100,12,0,12
Terik,M,100,0,12,12
Terree,F,100,12,0,12
Terreon,M,100,0,12,12
Terrisha,F,100,12,0,12
Tesher,M,100,0,12,12
Teshima,F,100,12,0,12
Teva,F,100,12,0,12
Teygan,F,58,7,5,12
Teyo,M,100,0,12,12
Tha,M,58,5,7,12
Thaila,F,100,12,0,12
Thailyn,F,100,12,0,12
Thaniel,M,100,0,12,12
Thaxton,M,100,0,12,12
Theodoro,M,100,0,12,12
Thienkim,F,100,12,0,12
Thurlow,M,100,0,12,12
Ti,F,50,6,6,12
Tieisha,F,100,12,0,12
Tiffin,F,100,12,0,12
Tikesha,F,100,12,0,12
Timeshia,F,100,12,0,12
Timiko,F,100,12,0,12
Tione,M,58,5,7,12
Tison,M,100,0,12,12
Tobbie,F,58,7,5,12
Topacio,F,100,12,0,12
Torino,F,58,7,5,12
Torunn,F,100,12,0,12
Trana,F,100,12,0,12
Trelynn,M,58,5,7,12
Trennen,M,100,0,12,12
Trev,M,100,0,12,12
Trevaris,M,100,0,12,12
Trica,F,100,12,0,12
Trigo,M,100,0,12,12
Trinisha,F,100,12,0,12
Triona,F,100,12,0,12
Tripton,M,100,0,12,12
Trudee,F,100,12,0,12
Twinkle,F,100,12,0,12
Tyaun,M,100,0,12,12
Tyionna,F,100,12,0,12
Tylicia,F,100,12,0,12
Tynae,F,100,12,0,12
Tynisa,F,100,12,0,12
Tyquana,F,100,12,0,12
Tyreesha,F,100,12,0,12
Tyrence,M,100,0,12,12
Tyresa,F,100,12,0,12
Tyriel,F,100,12,0,12
Tyrika,F,100,12,0,12
Tytiyana,F,100,12,0,12
Tyvion,M,100,0,12,12
Uilani,F,100,12,0,12
Ukiah,M,100,0,12,12
Umi,F,100,12,0,12
Ursala,F,100,12,0,12
Valri,F,100,12,0,12
Vanisa,F,100,12,0,12
Vaylen,M,100,0,12,12
Vedder,M,100,0,12,12
Vendetta,F,100,12,0,12
Vernica,F,100,12,0,12
Veronnica,F,100,12,0,12
Versa,F,100,12,0,12
Veverly,F,100,12,0,12
Vickii,F,100,12,0,12
Vickki,F,100,12,0,12
Victoriaann,F,100,12,0,12
Victorian,F,100,12,0,12
Victoriya,F,100,12,0,12
Viktorya,F,100,12,0,12
Virgia,F,100,12,0,12
Vlada,F,100,12,0,12
Waheed,M,100,0,12,12
Wallie,M,100,0,12,12
Wasif,M,100,0,12,12
Wayna,F,100,12,0,12
Waynesha,F,100,12,0,12
Weber,M,100,0,12,12
Welford,M,100,0,12,12
Wetzel,M,100,0,12,12
Wilkes,M,100,0,12,12
Willi,M,100,0,12,12
Williemae,F,100,12,0,12
Willma,F,100,12,0,12
Winner,F,50,6,6,12
Won,M,100,0,12,12
Woodley,M,100,0,12,12
Woodward,M,100,0,12,12
Wynnie,F,100,12,0,12
Wyonia,F,100,12,0,12
Xeng,M,100,0,12,12
Xiadani,F,100,12,0,12
Xing,F,58,7,5,12
Xiomar,M,100,0,12,12
Xue,F,50,6,6,12
Xylan,M,100,0,12,12
Yahweh,M,100,0,12,12
Yamaira,F,100,12,0,12
Yaneri,F,100,12,0,12
Yanneli,F,100,12,0,12
Yaquelyn,F,100,12,0,12
Yareny,F,100,12,0,12
Yaris,F,100,12,0,12
Yashasvi,F,100,12,0,12
Yasira,F,100,12,0,12
Yehonatan,M,100,0,12,12
Yesha,F,100,12,0,12
Yissochor,M,100,0,12,12
Yoandy,M,100,0,12,12
Yolinda,F,100,12,0,12
Yomna,F,100,12,0,12
Yoona,F,100,12,0,12
Yorleny,F,100,12,0,12
Yoyo,F,100,12,0,12
Zacharee,M,100,0,12,12
Zadin,M,100,0,12,12
Zahi,M,100,0,12,12
Zakaiya,F,100,12,0,12
Zakara,F,100,12,0,12
Zakye,M,100,0,12,12
Zalan,M,100,0,12,12
Zamarian,M,100,0,12,12
Zamire,M,100,0,12,12
Zanariah,F,100,12,0,12
Zannah,F,100,12,0,12
Zareth,F,100,12,0,12
Zareyah,F,100,12,0,12
Zayneb,F,100,12,0,12
Zekhi,M,100,0,12,12
Zelig,M,100,0,12,12
Zerita,F,100,12,0,12
Zikeria,F,100,12,0,12
Zoeie,F,100,12,0,12
Zonnique,F,100,12,0,12
Zylar,M,100,0,12,12
Zyonnah,F,100,12,0,12
Aadvik,M,100,0,11,11
Aaleeyah,F,100,11,0,11
Aaliayah,F,100,11,0,11
Aamyah,F,100,11,0,11
Aarica,F,100,11,0,11
Aashika,F,100,11,0,11
Aashni,F,100,11,0,11
Aashrita,F,100,11,0,11
Aayat,F,100,11,0,11
Aban,M,100,0,11,11
Abbegayle,F,100,11,0,11
Abdirahim,M,100,0,11,11
Abigailmarie,F,100,11,0,11
Abigel,F,100,11,0,11
Abisag,F,100,11,0,11
Abisola,F,100,11,0,11
Abrum,M,100,0,11,11
Abshir,M,100,0,11,11
Abuk,F,100,11,0,11
Achille,M,100,0,11,11
Achintya,M,100,0,11,11
Acire,F,100,11,0,11
Adallyn,F,100,11,0,11
Adaria,F,100,11,0,11
Addelina,F,100,11,0,11
Addylynn,F,100,11,0,11
Ademide,M,55,5,6,11
Adeoluwa,M,100,0,11,11
Adetokunbo,M,100,0,11,11
Adisynne,F,100,11,0,11
Adiva,F,100,11,0,11
Adream,F,100,11,0,11
Advit,M,100,0,11,11
Adylee,F,100,11,0,11
Aemon,M,100,0,11,11
Aeriona,F,100,11,0,11
Afaf,F,100,11,0,11
Ahlena,F,100,11,0,11
Ahlyssa,F,100,11,0,11
Ahmiah,F,100,11,0,11
Ahonesty,F,100,11,0,11
Ahsaki,F,100,11,0,11
Aidana,F,100,11,0,11
Aimme,F,100,11,0,11
Airyonna,F,100,11,0,11
Aishling,F,100,11,0,11
Ajane,F,100,11,0,11
Akaiya,F,100,11,0,11
Akaysha,F,100,11,0,11
Akeil,M,100,0,11,11
Akiah,F,100,11,0,11
Akya,F,100,11,0,11
Alanee,F,100,11,0,11
Alaney,F,100,11,0,11
Alarik,M,100,0,11,11
Alassandra,F,100,11,0,11
Alayjha,F,100,11,0,11
Albertus,M,100,0,11,11
Alechia,F,100,11,0,11
Aleighya,F,100,11,0,11
Alejandria,F,100,11,0,11
Alexiya,F,100,11,0,11
Alexzavier,M,100,0,11,11
Aleynna,F,100,11,0,11
Aleza,F,100,11,0,11
Alicemarie,F,100,11,0,11
Aliera,F,100,11,0,11
Alijha,M,55,5,6,11
Alilah,F,100,11,0,11
Aliona,F,100,11,0,11
Alisea,F,100,11,0,11
Alisher,M,100,0,11,11
Aliviana,F,100,11,0,11
Alizza,F,100,11,0,11
Allexa,F,100,11,0,11
Alroy,M,100,0,11,11
Alsha,F,100,11,0,11
Alveda,F,100,11,0,11
Alvira,F,100,11,0,11
Alynda,F,100,11,0,11
Alynne,F,100,11,0,11
Alyssabeth,F,100,11,0,11
Amahri,M,55,5,6,11
Amaly,F,100,11,0,11
Amandajo,F,100,11,0,11
Amantha,F,100,11,0,11
Amarelis,F,100,11,0,11
Amariee,F,100,11,0,11
Amarria,F,100,11,0,11
Amaud,M,100,0,11,11
Ambellina,F,100,11,0,11
Ameka,F,100,11,0,11
Amii,F,100,11,0,11
Amilea,F,100,11,0,11
Amileah,F,100,11,0,11
Amiree,F,100,11,0,11
Amirr,M,100,0,11,11
Amiyra,F,100,11,0,11
Amorita,F,100,11,0,11
Anajulia,F,100,11,0,11
Analeya,F,100,11,0,11
Analyah,F,100,11,0,11
Anarely,F,100,11,0,11
Andilynn,F,100,11,0,11
Andrean,F,55,6,5,11
Andressa,F,100,11,0,11
Andric,M,100,0,11,11
Anees,M,100,0,11,11
Aneliese,F,100,11,0,11
Anelys,F,100,11,0,11
Angeldejesus,M,100,0,11,11
Angelete,F,100,11,0,11
Angelicque,F,100,11,0,11
Angellea,F,100,11,0,11
Angelyse,F,100,11,0,11
Angeni,F,100,11,0,11
Anhar,F,100,11,0,11
Aniko,F,100,11,0,11
Aniqa,F,100,11,0,11
Anjelah,F,100,11,0,11
Anjelita,F,100,11,0,11
Anjoli,F,100,11,0,11
Anjuan,M,100,0,11,11
Annajean,F,100,11,0,11
Annaliesa,F,100,11,0,11
Anndy,M,100,0,11,11
Anniece,F,100,11,0,11
Annikah,F,100,11,0,11
Annique,F,100,11,0,11
Annleigh,F,100,11,0,11
Anntionette,F,100,11,0,11
Anshuman,M,100,0,11,11
Anslei,F,100,11,0,11
Antanisha,F,100,11,0,11
Antelmo,M,100,0,11,11
Anthem,M,100,0,11,11
Antwione,M,100,0,11,11
Antwonette,F,100,11,0,11
Arabell,F,100,11,0,11
Aracelly,F,100,11,0,11
Araf,M,100,0,11,11
Araiah,F,100,11,0,11
Aransa,F,100,11,0,11
Arayiah,F,100,11,0,11
Archita,F,100,11,0,11
Ardan,M,100,0,11,11
Ardath,F,100,11,0,11
Ardi,M,100,0,11,11
Areen,F,100,11,0,11
Argelio,M,100,0,11,11
Ariatna,F,100,11,0,11
Arielyz,F,100,11,0,11
Ariyahna,F,100,11,0,11
Ariz,M,100,0,11,11
Arjanae,F,100,11,0,11
Arka,M,100,0,11,11
Arpi,F,100,11,0,11
Aryahi,F,100,11,0,11
Aryahna,F,100,11,0,11
Aryani,F,100,11,0,11
Aser,M,100,0,11,11
Ashantia,F,100,11,0,11
Ashiah,F,100,11,0,11
Asjia,F,100,11,0,11
Assyria,F,100,11,0,11
Asta,F,100,11,0,11
Astyn,M,55,5,6,11
Asyria,F,100,11,0,11
Ataya,F,100,11,0,11
Athea,F,100,11,0,11
Athens,M,100,0,11,11
Aubriona,F,100,11,0,11
Aubyn,F,100,11,0,11
Avalise,F,100,11,0,11
Avenly,F,100,11,0,11
Avlyn,F,100,11,0,11
Avrahom,M,100,0,11,11
Aynslie,F,100,11,0,11
Ayo,M,100,0,11,11
Ayris,F,100,11,0,11
Ayslin,F,100,11,0,11
Ayvrie,F,100,11,0,11
Azarah,F,100,11,0,11
Azaya,F,100,11,0,11
Azelie,F,100,11,0,11
Azeria,F,100,11,0,11
Azi,M,100,0,11,11
Azzan,M,100,0,11,11
Babetta,F,100,11,0,11
Baelee,F,100,11,0,11
Balbina,F,100,11,0,11
Balen,M,100,0,11,11
Bayly,F,55,6,5,11
Bellany,F,100,11,0,11
Belmaris,F,100,11,0,11
Benedicta,F,100,11,0,11
Benicia,F,100,11,0,11
Benz,M,100,0,11,11
Berkay,M,100,0,11,11
Bernardina,F,100,11,0,11
Bernd,M,100,0,11,11
Bethene,F,100,11,0,11
Bettey,F,100,11,0,11
Bhavesh,M,100,0,11,11
Bindu,F,100,11,0,11
Birkley,F,100,11,0,11
Bitanya,F,100,11,0,11
Blakleigh,F,100,11,0,11
Bobetta,F,100,11,0,11
Boen,M,100,0,11,11
Bohan,M,100,0,11,11
Bonham,M,100,0,11,11
Bonnetta,F,100,11,0,11
Bosten,M,100,0,11,11
Braelan,M,100,0,11,11
Branae,F,100,11,0,11
Brandonmichael,M,100,0,11,11
Brandonn,M,100,0,11,11
Brendalynn,F,100,11,0,11
Brenita,F,100,11,0,11
Breshay,F,100,11,0,11
Brewster,M,100,0,11,11
Brezlin,M,55,5,6,11
Briarrose,F,100,11,0,11
Bridgetta,F,100,11,0,11
Briscoe,M,100,0,11,11
Britteney,F,100,11,0,11
Brittian,F,100,11,0,11
Briyan,M,100,0,11,11
Broedy,M,100,0,11,11
Brom,M,100,0,11,11
Brookston,M,100,0,11,11
Brox,M,100,0,11,11
Brysa,F,100,11,0,11
Burkley,M,100,0,11,11
Byren,M,100,0,11,11
Cace,M,100,0,11,11
Cailean,M,100,0,11,11
Calea,F,100,11,0,11
Caleen,F,100,11,0,11
Camaren,M,55,5,6,11
Cameshia,F,100,11,0,11
Camyah,F,100,11,0,11
Caprecia,F,100,11,0,11
Caralina,F,100,11,0,11
Careem,M,100,0,11,11
Caresa,F,100,11,0,11
Carisse,F,100,11,0,11
Carmita,F,100,11,0,11
Carrell,F,100,11,0,11
Cashous,M,100,0,11,11
Cassee,F,100,11,0,11
Catilyn,F,100,11,0,11
Catrin,F,100,11,0,11
Caya,F,100,11,0,11
Cayd,M,100,0,11,11
Caynen,M,100,0,11,11
Cecia,F,100,11,0,11
Cedrina,F,100,11,0,11
Celedonio,M,100,0,11,11
Celese,F,100,11,0,11
Celvin,M,100,0,11,11
Chakyra,F,100,11,0,11
Chalsey,F,100,11,0,11
Chamiya,F,100,11,0,11
Chandell,F,100,11,0,11
Chanese,F,100,11,0,11
Chanoch,M,100,0,11,11
Chantille,F,100,11,0,11
Charel,F,100,11,0,11
Charleson,M,100,0,11,11
Charleton,M,100,0,11,11
Charlianne,F,100,11,0,11
Charliegh,F,100,11,0,11
Charman,F,100,11,0,11
Charmeka,F,100,11,0,11
Charmelle,F,100,11,0,11
Charnel,F,100,11,0,11
Charod,M,100,0,11,11
Chaye,F,100,11,0,11
Chaylin,F,100,11,0,11
Cheila,F,100,11,0,11
Chelcea,F,100,11,0,11
Chely,F,100,11,0,11
Chenel,F,100,11,0,11
Chenequa,F,100,11,0,11
Cheral,F,100,11,0,11
Cherine,F,100,11,0,11
Cherol,F,100,11,0,11
Cherre,F,100,11,0,11
Cherrita,F,100,11,0,11
Cherylee,F,100,11,0,11
Chesa,F,100,11,0,11
Chinaza,F,100,11,0,11
Chinonso,M,100,0,11,11
Choya,M,100,0,11,11
Chrishauna,F,100,11,0,11
Chrishun,M,100,0,11,11
Chrysa,F,100,11,0,11
Claris,F,100,11,0,11
Claudetta,F,100,11,0,11
Clayborne,M,100,0,11,11
Clinique,F,100,11,0,11
Clista,F,100,11,0,11
Coleston,M,100,0,11,11
Coletha,F,100,11,0,11
Coletin,M,100,0,11,11
Colisha,F,100,11,0,11
Columba,F,100,11,0,11
Conda,F,100,11,0,11
Consandra,F,100,11,0,11
Constant,F,100,11,0,11
Coray,M,100,0,11,11
Corlyn,F,100,11,0,11
Countney,F,100,11,0,11
Courntey,F,100,11,0,11
Craigory,M,100,0,11,11
Crescencio,M,100,0,11,11
Crews,M,100,0,11,11
Crislynn,F,100,11,0,11
Cristella,F,100,11,0,11
Croy,M,100,0,11,11
Crystine,F,100,11,0,11
Cybelle,F,100,11,0,11
Cyndel,F,100,11,0,11
Cyniyah,F,100,11,0,11
Cyron,M,100,0,11,11
Daarina,F,100,11,0,11
Daegon,M,100,0,11,11
Daemeon,M,100,0,11,11
Daeson,M,100,0,11,11
Dafna,F,100,11,0,11
Dahani,M,100,0,11,11
Dahlton,M,100,0,11,11
Daisja,F,100,11,0,11
Daiyan,M,100,0,11,11
Daiza,F,100,11,0,11
Daizon,M,100,0,11,11
Dajai,F,100,11,0,11
Dajiah,F,100,11,0,11
Dakia,F,100,11,0,11
Dakotta,F,55,6,5,11
Damaree,M,100,0,11,11
Damariah,F,100,11,0,11
Damarien,M,100,0,11,11
Damontre,M,100,0,11,11
Damorion,M,100,0,11,11
Danalyn,F,100,11,0,11
Danaria,F,100,11,0,11
Dandy,M,100,0,11,11
Danian,M,100,0,11,11
Danyael,M,100,0,11,11
Danyetta,F,100,11,0,11
Daphyne,F,100,11,0,11
Darene,F,100,11,0,11
Darielys,F,100,11,0,11
Darlis,F,100,11,0,11
Darneshia,F,100,11,0,11
Darnika,F,100,11,0,11
Darryon,M,100,0,11,11
Darsha,F,100,11,0,11
Darshell,F,100,11,0,11
Dashanae,F,100,11,0,11
Datwan,M,100,0,11,11
Davae,F,55,6,5,11
Daveena,F,100,11,0,11
Davidanthony,M,100,0,11,11
Davonya,F,100,11,0,11
Daysean,M,100,0,11,11
Daytin,M,100,0,11,11
Dayvid,M,100,0,11,11
Dazon,M,100,0,11,11
Deadre,F,100,11,0,11
Deairra,F,100,11,0,11
Deanza,F,100,11,0,11
Dearia,F,100,11,0,11
Dearion,F,55,6,5,11
Dearon,M,100,0,11,11
Deatrick,M,100,0,11,11
Deeba,F,100,11,0,11
Deem,F,100,11,0,11
Dehaven,M,100,0,11,11
Dejana,F,100,11,0,11
Dekisha,F,100,11,0,11
Deliza,F,100,11,0,11
Dellia,F,100,11,0,11
Delone,M,55,5,6,11
Delrae,F,100,11,0,11
Delron,M,100,0,11,11
Demarrius,M,100,0,11,11
Demeria,F,100,11,0,11
Demiana,F,100,11,0,11
Demico,M,100,0,11,11
Demitrios,M,100,0,11,11
Deniqua,F,100,11,0,11
Dennell,F,55,6,5,11
Denylah,F,100,11,0,11
Deoni,F,100,11,0,11
Derel,M,100,0,11,11
Deris,M,100,0,11,11
Deronte,M,100,0,11,11
Derringer,M,100,0,11,11
Deshea,F,100,11,0,11
Desmarie,F,100,11,0,11
Destinii,F,100,11,0,11
Detavius,M,100,0,11,11
Devane,M,100,0,11,11
Devaris,M,100,0,11,11
Devetta,F,100,11,0,11
Devoria,F,100,11,0,11
Dewarren,M,100,0,11,11
Deylani,F,100,11,0,11
Dezera,F,100,11,0,11
Dhyani,F,100,11,0,11
Diamonds,F,100,11,0,11
Diavionne,F,100,11,0,11
Dilraj,M,100,0,11,11
Dimonique,F,100,11,0,11
Dinh,M,100,0,11,11
Diore,F,100,11,0,11
Dirck,M,100,0,11,11
Diron,M,100,0,11,11
Dixi,F,100,11,0,11
Dmonte,M,100,0,11,11
Dominyck,M,100,0,11,11
Domitila,F,100,11,0,11
Doneta,F,100,11,0,11
Donjuan,M,100,0,11,11
Donnamae,F,100,11,0,11
Donnamaria,F,100,11,0,11
Donnavan,M,100,0,11,11
Dontrez,M,100,0,11,11
Dorell,M,100,0,11,11
Dorlisa,F,100,11,0,11
Dorrene,F,100,11,0,11
Draegan,M,100,0,11,11
Drayvin,M,100,0,11,11
Dreylon,M,100,0,11,11
Drita,F,100,11,0,11
Druann,F,100,11,0,11
Duanne,F,100,11,0,11
Dulse,F,100,11,0,11
Durelle,M,100,0,11,11
Durinda,F,100,11,0,11
Dyamon,F,100,11,0,11
Dynastie,F,100,11,0,11
Dynesty,F,100,11,0,11
Eaton,M,100,0,11,11
Eaven,M,100,0,11,11
Edom,F,100,11,0,11
Edrik,M,100,0,11,11
Edwena,F,100,11,0,11
Ehaan,M,100,0,11,11
Eiji,M,100,0,11,11
Ekaterini,F,100,11,0,11
Ekta,F,100,11,0,11
Elainey,F,100,11,0,11
Elby,M,100,0,11,11
Eldonna,F,100,11,0,11
Eleesa,F,100,11,0,11
Elianis,F,100,11,0,11
Elige,M,100,0,11,11
Elijaha,M,100,0,11,11
Elizar,M,100,0,11,11
Ellian,M,100,0,11,11
Elnatan,M,100,0,11,11
Elsworth,M,100,0,11,11
Elway,M,100,0,11,11
Emali,F,100,11,0,11
Emiliah,F,100,11,0,11
Emmalena,F,100,11,0,11
Emmrie,F,100,11,0,11
Endora,F,100,11,0,11
Endrit,M,100,0,11,11
Enisa,F,100,11,0,11
Enrike,M,100,0,11,11
Ericberto,M,100,0,11,11
Erilynn,F,100,11,0,11
Ernisha,F,100,11,0,11
Erva,F,100,11,0,11
Espiridion,M,100,0,11,11
Estle,M,100,0,11,11
Etana,F,100,11,0,11
Eton,M,100,0,11,11
Eudelia,F,100,11,0,11
Eulices,M,100,0,11,11
Eura,F,100,11,0,11
Evalyna,F,100,11,0,11
Evertt,M,100,0,11,11
Ewelina,F,100,11,0,11
Eylan,M,100,0,11,11
Ezequias,M,100,0,11,11
Ezzie,M,55,5,6,11
Fabain,M,100,0,11,11
Falan,F,100,11,0,11
Falesha,F,100,11,0,11
Famous,M,100,0,11,11
Farnaz,F,100,11,0,11
Farooq,M,100,0,11,11
Faruq,M,100,0,11,11
Fatime,F,100,11,0,11
Feliciti,F,100,11,0,11
Feliza,F,100,11,0,11
Fender,M,100,0,11,11
Fenway,M,100,0,11,11
Ferran,M,55,5,6,11
Fey,F,100,11,0,11
Finton,M,100,0,11,11
Flower,F,100,11,0,11
Forbes,M,100,0,11,11
Fotios,M,100,0,11,11
Francyne,F,100,11,0,11
Fraya,F,100,11,0,11
Gailen,M,100,0,11,11
Gali,F,100,11,0,11
Gana,F,100,11,0,11
Garvens,M,100,0,11,11
Gaya,F,100,11,0,11
Gearldean,F,100,11,0,11
Gem,F,100,11,0,11
Geneieve,F,100,11,0,11
Geovanie,M,100,0,11,11
Geraldin,F,100,11,0,11
Geralene,F,100,11,0,11
Gerrianne,F,100,11,0,11
Gianmichael,M,100,0,11,11
Gianpaolo,M,100,0,11,11
Gitzel,F,100,11,0,11
Gopi,F,100,11,0,11
Graceland,F,100,11,0,11
Graviela,F,100,11,0,11
Greycen,M,100,0,11,11
Guerin,M,100,0,11,11
Guyla,F,100,11,0,11
Habeeb,M,100,0,11,11
Haddi,F,100,11,0,11
Haiti,F,100,11,0,11
Halayah,F,100,11,0,11
Hall,M,100,0,11,11
Hananiah,F,55,6,5,11
Harla,F,100,11,0,11
Harlequin,F,100,11,0,11
Harleyann,F,100,11,0,11
Harshaan,M,100,0,11,11
Hartwell,M,100,0,11,11
Harvard,M,100,0,11,11
Hawi,F,100,11,0,11
Hawraa,F,100,11,0,11
Heatherly,F,100,11,0,11
Heavan,F,100,11,0,11
Hebah,F,100,11,0,11
Hedi,F,100,11,0,11
Hendryx,M,100,0,11,11
Henlie,F,100,11,0,11
Hermine,F,100,11,0,11
Hetty,F,100,11,0,11
Hines,M,100,0,11,11
Hitomi,F,100,11,0,11
Hoby,M,100,0,11,11
Hodges,M,100,0,11,11
Holston,M,100,0,11,11
Hopemarie,F,100,11,0,11
Hosam,M,100,0,11,11
Hristopher,M,100,0,11,11
Humzah,M,100,0,11,11
Hydi,F,100,11,0,11
Hydia,F,100,11,0,11
Ichelle,F,100,11,0,11
Idiris,M,100,0,11,11
Ifra,F,100,11,0,11
Ilaisaane,F,100,11,0,11
Ilanna,F,100,11,0,11
Imar,F,100,11,0,11
Imaya,F,100,11,0,11
Indria,F,100,11,0,11
Ingri,F,100,11,0,11
Isaiahs,M,100,0,11,11
Isata,F,100,11,0,11
Isia,F,55,6,5,11
Ismeal,M,100,0,11,11
Itzael,M,100,0,11,11
Ivyrose,F,100,11,0,11
Iyauna,F,100,11,0,11
Izhar,M,100,0,11,11
Izzabel,F,100,11,0,11
Jaasia,F,100,11,0,11
Jachelle,F,100,11,0,11
Jacolbi,M,100,0,11,11
Jacorien,M,100,0,11,11
Jadene,F,100,11,0,11
Jaegar,M,100,0,11,11
Jaemarie,F,100,11,0,11
Jaena,F,100,11,0,11
Jaeonna,F,100,11,0,11
Jahdai,F,100,11,0,11
Jahlen,M,100,0,11,11
Jahlisa,F,100,11,0,11
Jahlon,M,100,0,11,11
Jahzaria,F,100,11,0,11
Jaicion,M,100,0,11,11
Jaimya,F,100,11,0,11
Jakaiya,F,100,11,0,11
Jakaleb,M,100,0,11,11
Jakiera,F,100,11,0,11
Jakylen,M,100,0,11,11
Jaland,M,100,0,11,11
Jalexus,F,100,11,0,11
Jalissia,F,100,11,0,11
Jamane,M,100,0,11,11
Jameison,M,100,0,11,11
Jamele,M,100,0,11,11
Jamesdean,M,100,0,11,11
Jamesley,M,100,0,11,11
Jametta,F,100,11,0,11
Jamirra,F,100,11,0,11
Jamisa,F,100,11,0,11
Jamonie,M,100,0,11,11
Jamorian,M,100,0,11,11
Janaa,F,100,11,0,11
Jancie,F,100,11,0,11
Jany,F,100,11,0,11
Jaonna,F,100,11,0,11
Japji,F,100,11,0,11
Jaquavian,M,100,0,11,11
Jaquline,F,100,11,0,11
Jarik,M,100,0,11,11
Jarl,M,100,0,11,11
Jarmon,M,100,0,11,11
Jartavious,M,100,0,11,11
Jaseon,M,100,0,11,11
Jashley,F,100,11,0,11
Jaskarn,M,100,0,11,11
Jauron,M,100,0,11,11
Java,M,55,5,6,11
Javad,M,100,0,11,11
Javette,F,100,11,0,11
Javeyon,M,100,0,11,11
Jaycey,F,100,11,0,11
Jaycieon,M,100,0,11,11
Jayliany,F,100,11,0,11
Jaymez,M,100,0,11,11
Jayquon,M,100,0,11,11
Jayvan,M,100,0,11,11
Jazen,M,100,0,11,11
Jazmina,F,100,11,0,11
Jazziel,M,100,0,11,11
Jeanmarc,M,100,0,11,11
Jeidi,F,100,11,0,11
Jekhi,M,100,0,11,11
Jelessa,F,100,11,0,11
Jenalise,F,100,11,0,11
Jenessis,F,100,11,0,11
Jenisse,F,100,11,0,11
Jennalise,F,100,11,0,11
Jereld,M,100,0,11,11
Jereth,M,100,0,11,11
Jerian,M,100,0,11,11
Jermeisha,F,100,11,0,11
Jerramy,M,100,0,11,11
Jerriann,F,100,11,0,11
Jesa,F,100,11,0,11
Jeslie,F,100,11,0,11
Jevaughn,M,100,0,11,11
Jex,M,100,0,11,11
Jeydon,M,100,0,11,11
Jianah,F,100,11,0,11
Jillann,F,100,11,0,11
Jimia,F,100,11,0,11
Jion,M,100,0,11,11
Jisha,F,100,11,0,11
Jlah,F,100,11,0,11
Jlen,M,100,0,11,11
Jmarion,M,100,0,11,11
Jnyah,F,100,11,0,11
Johathon,M,100,0,11,11
Jolly,M,100,0,11,11
Jonaven,M,100,0,11,11
Jonerik,M,100,0,11,11
Jonhatan,M,100,0,11,11
Jonmarc,M,100,0,11,11
Josaih,M,100,0,11,11
Joscelyne,F,100,11,0,11
Joseh,M,100,0,11,11
Josely,F,100,11,0,11
Joshelyn,F,100,11,0,11
Josia,M,100,0,11,11
Jovona,F,100,11,0,11
Joyanne,F,100,11,0,11
Joyclyn,F,100,11,0,11
Jsoeph,M,100,0,11,11
Jsutin,M,100,0,11,11
Juanandres,M,100,0,11,11
Juanfrancisco,M,100,0,11,11
Juelle,F,100,11,0,11
Juergen,M,100,0,11,11
Jujhar,M,100,0,11,11
Juliona,F,100,11,0,11
Juliyana,F,100,11,0,11
Justinlee,M,100,0,11,11
Justun,M,100,0,11,11
Jyair,M,100,0,11,11
Jyree,M,100,0,11,11
Jyrese,M,100,0,11,11
Kabe,M,100,0,11,11
Kadelyn,F,100,11,0,11
Kadian,F,100,11,0,11
Kaelei,F,100,11,0,11
Kaelib,M,100,0,11,11
Kahekili,M,100,0,11,11
Kahner,M,100,0,11,11
Kahri,M,100,0,11,11
Kailo,M,100,0,11,11
Kaizlee,F,100,11,0,11
Kalayna,F,100,11,0,11
Kalaysha,F,100,11,0,11
Kalima,F,100,11,0,11
Kamalei,F,100,11,0,11
Kambrea,F,100,11,0,11
Kamlyn,F,100,11,0,11
Kamylle,F,100,11,0,11
Kanise,F,100,11,0,11
Karar,M,100,0,11,11
Kare,F,100,11,0,11
Karesa,F,100,11,0,11
Karinda,F,100,11,0,11
Karliah,F,100,11,0,11
Karnell,M,100,0,11,11
Karolee,F,100,11,0,11
Karrar,M,100,0,11,11
Karrson,M,100,0,11,11
Karynna,F,100,11,0,11
Karysa,F,100,11,0,11
Karyss,F,100,11,0,11
Kashima,F,100,11,0,11
Kashiya,F,100,11,0,11
Kaspian,M,100,0,11,11
Kassydi,F,100,11,0,11
Kataleena,F,100,11,0,11
Kathlean,F,100,11,0,11
Katiuska,F,100,11,0,11
Kavir,M,100,0,11,11
Kavontae,M,100,0,11,11
Kaygen,M,55,5,6,11
Kayland,M,55,5,6,11
Kaylib,M,100,0,11,11
Kaymon,M,100,0,11,11
Kaynan,M,100,0,11,11
Kayren,F,100,11,0,11
Kaytelynn,F,100,11,0,11
Kazmira,F,100,11,0,11
Keaisha,F,100,11,0,11
Kealie,F,100,11,0,11
Kealin,M,100,0,11,11
Keante,M,100,0,11,11
Keddrick,M,100,0,11,11
Keeanna,F,100,11,0,11
Keimarion,M,100,0,11,11
Keiya,F,100,11,0,11
Kelissa,F,100,11,0,11
Kelita,F,100,11,0,11
Kellum,M,100,0,11,11
Kenae,F,100,11,0,11
Kenaniah,M,100,0,11,11
Kenidy,F,100,11,0,11
Kenitha,F,100,11,0,11
Kennette,F,100,11,0,11
Kennyth,M,100,0,11,11
Kensuke,M,100,0,11,11
Kensy,F,100,11,0,11
Keoshia,F,100,11,0,11
Kerryn,F,100,11,0,11
Kesleigh,F,100,11,0,11
Keslyn,F,100,11,0,11
Keslynn,F,100,11,0,11
Keta,F,100,11,0,11
Kethan,M,100,0,11,11
Keviana,F,100,11,0,11
Keyairah,F,100,11,0,11
Keyshawna,F,100,11,0,11
Khadejah,F,100,11,0,11
Khaleef,M,100,0,11,11
Khamar,M,100,0,11,11
Khamarion,M,100,0,11,11
Khamil,F,100,11,0,11
Kharli,F,100,11,0,11
Kherrington,F,100,11,0,11
Khiem,M,100,0,11,11
Khila,F,100,11,0,11
Khoury,M,100,0,11,11
Khristal,F,100,11,0,11
Khurram,M,100,0,11,11
Khyara,F,100,11,0,11
Kieanna,F,100,11,0,11
Kijuana,F,100,11,0,11
Kimery,F,100,11,0,11
Kimiah,F,100,11,0,11
Kimla,F,100,11,0,11
Kimley,F,100,11,0,11
Kindsey,F,100,11,0,11
Kinlea,F,100,11,0,11
Kinnie,M,100,0,11,11
Kinzly,F,100,11,0,11
Kirke,M,100,0,11,11
Kishauna,F,100,11,0,11
Kishawna,F,100,11,0,11
Kitra,F,100,11,0,11
Kjuan,M,100,0,11,11
Kloi,F,100,11,0,11
Kmarie,F,100,11,0,11
Kode,M,100,0,11,11
Kohler,M,100,0,11,11
Kollen,M,100,0,11,11
Koriana,F,100,11,0,11
Kortland,M,100,0,11,11
Kourtland,M,100,0,11,11
Kristapher,M,100,0,11,11
Krister,M,100,0,11,11
Krystale,F,100,11,0,11
Krystianna,F,100,11,0,11
Kurstie,F,100,11,0,11
Kyannah,F,100,11,0,11
Kyiana,F,100,11,0,11
Kymere,M,100,0,11,11
Kynadie,F,100,11,0,11
Kyston,M,100,0,11,11
Kyvan,M,100,0,11,11
Lachell,F,100,11,0,11
Lacorey,M,100,0,11,11
Lacourtney,F,100,11,0,11
Ladetra,F,100,11,0,11
Ladiamond,F,100,11,0,11
Ladrea,F,100,11,0,11
Lafrances,F,100,11,0,11
Lahari,F,100,11,0,11
Laik,M,100,0,11,11
Laithen,M,100,0,11,11
Lajayla,F,100,11,0,11
Lakendric,M,100,0,11,11
Lakethia,F,100,11,0,11
Lakim,M,100,0,11,11
Lakima,F,100,11,0,11
Lakindra,F,100,11,0,11
Lamondre,M,100,0,11,11
Lamontez,M,100,0,11,11
Lamor,M,100,0,11,11
Landrum,M,100,0,11,11
Lanet,F,100,11,0,11
Lanina,F,100,11,0,11
Lanore,F,100,11,0,11
Laqueshia,F,100,11,0,11
Lataija,F,100,11,0,11
Lataja,F,100,11,0,11
Lataria,F,100,11,0,11
Latavion,M,100,0,11,11
Latayvia,F,100,11,0,11
Latiffa,F,100,11,0,11
Latoiya,F,100,11,0,11
Latresia,F,100,11,0,11
Latronda,F,100,11,0,11
Latya,F,100,11,0,11
Lauralye,F,100,11,0,11
Lauralynn,F,100,11,0,11
Lavasha,F,100,11,0,11
Lavella,F,100,11,0,11
Lavenda,F,100,11,0,11
Laverta,F,100,11,0,11
Lavester,M,100,0,11,11
Laython,M,100,0,11,11
Lazette,F,100,11,0,11
Leaira,F,100,11,0,11
Leary,M,100,0,11,11
Leeandrew,M,100,0,11,11
Leeona,F,100,11,0,11
Leissa,F,100,11,0,11
Lenamarie,F,100,11,0,11
Lendia,F,100,11,0,11
Lendsey,F,100,11,0,11
Lerae,F,100,11,0,11
Leshea,F,100,11,0,11
Letina,F,100,11,0,11
Levander,M,100,0,11,11
Leveah,F,100,11,0,11
Leyan,F,100,11,0,11
Lianys,F,100,11,0,11
Lichelle,F,100,11,0,11
Lindan,M,100,0,11,11
Lionardo,M,100,0,11,11
Lissie,F,100,11,0,11
Liticia,F,100,11,0,11
Litzzy,F,100,11,0,11
Lizelle,F,100,11,0,11
Lizvette,F,100,11,0,11
Lizza,F,100,11,0,11
Lizzete,F,100,11,0,11
Loey,F,100,11,0,11
Logynn,F,100,11,0,11
Loistine,F,100,11,0,11
Longino,M,100,0,11,11
Lonya,F,100,11,0,11
Lorelee,F,100,11,0,11
Loresa,F,100,11,0,11
Lorimar,F,100,11,0,11
Lorryn,F,100,11,0,11
Lovett,M,100,0,11,11
Luisdaniel,M,100,0,11,11
Lulia,F,100,11,0,11
Lurena,F,100,11,0,11
Lyndley,F,100,11,0,11
Lynnsie,F,100,11,0,11
Lynze,F,100,11,0,11
Lyria,F,100,11,0,11
Lyrics,F,100,11,0,11
Lyris,F,100,11,0,11
Lyzander,M,100,0,11,11
Maccoy,M,100,0,11,11
Macin,M,100,0,11,11
Maddysen,F,100,11,0,11
Madilin,F,100,11,0,11
Madisin,F,100,11,0,11
Madissyn,F,100,11,0,11
Madolynn,F,100,11,0,11
Maecyn,F,100,11,0,11
Maiden,F,100,11,0,11
Mairen,F,100,11,0,11
Mairim,F,100,11,0,11
Makailee,F,100,11,0,11
Makyi,M,100,0,11,11
Malala,F,100,11,0,11
Malechi,M,100,0,11,11
Malgorzata,F,100,11,0,11
Malicia,F,100,11,0,11
Malonie,F,100,11,0,11
Mamoun,M,100,0,11,11
Mandana,F,100,11,0,11
Maor,M,100,0,11,11
Marajade,F,100,11,0,11
Marcangelo,M,100,0,11,11
Marcedez,F,100,11,0,11
Marcha,F,100,11,0,11
Marcille,F,100,11,0,11
Margaretha,F,100,11,0,11
Mariani,F,100,11,0,11
Marinah,F,100,11,0,11
Marji,F,100,11,0,11
Marke,M,100,0,11,11
Markeece,M,100,0,11,11
Marken,M,100,0,11,11
Marlaya,F,100,11,0,11
Marrian,F,100,11,0,11
Marsa,F,100,11,0,11
Marsel,M,100,0,11,11
Marshel,M,100,0,11,11
Marthann,F,100,11,0,11
Martita,F,100,11,0,11
Marton,M,100,0,11,11
Martrez,M,100,0,11,11
Marvins,M,100,0,11,11
Maryjayne,F,100,11,0,11
Massey,F,55,6,5,11
Mataeo,M,100,0,11,11
Mataio,M,100,0,11,11
Mato,M,100,0,11,11
Mats,M,100,0,11,11
Matthewjames,M,100,0,11,11
Mattisen,F,100,11,0,11
Mattson,M,100,0,11,11
Maveryk,M,100,0,11,11
Maxsim,M,100,0,11,11
Mayjor,M,100,0,11,11
Maylan,F,100,11,0,11
Maymunah,F,100,11,0,11
Meeyah,F,100,11,0,11
Mekael,M,100,0,11,11
Melady,F,100,11,0,11
Meleane,F,100,11,0,11
Melvena,F,100,11,0,11
Merecedes,F,100,11,0,11
Meridyth,F,100,11,0,11
Merika,F,100,11,0,11
Micca,F,100,11,0,11
Michellle,F,100,11,0,11
Mikeisha,F,100,11,0,11
Miku,F,100,11,0,11
Milanni,F,100,11,0,11
Milda,F,100,11,0,11
Milenna,F,100,11,0,11
Miliany,F,100,11,0,11
Millianna,F,100,11,0,11
Minori,F,100,11,0,11
Minyon,F,100,11,0,11
Mischele,F,100,11,0,11
Mohmmed,M,100,0,11,11
Mohnish,M,100,0,11,11
Moneisha,F,100,11,0,11
Moneke,F,100,11,0,11
Monserrate,F,100,11,0,11
Monzerat,F,100,11,0,11
Morissa,F,100,11,0,11
Morry,M,100,0,11,11
Mridula,F,100,11,0,11
Mry,F,100,11,0,11
Mulki,F,100,11,0,11
Myda,F,100,11,0,11
Mykaylah,F,100,11,0,11
Mykeisha,F,100,11,0,11
Mykelti,F,100,11,0,11
Myshaun,M,100,0,11,11
Nacona,F,100,11,0,11
Nahdia,F,100,11,0,11
Najya,F,100,11,0,11
Nandana,F,100,11,0,11
Narin,F,100,11,0,11
Narine,F,100,11,0,11
Nashira,F,100,11,0,11
Nasif,M,100,0,11,11
Nasteho,F,100,11,0,11
Natane,F,100,11,0,11
Natasja,F,100,11,0,11
Natiley,F,100,11,0,11
Nazira,F,100,11,0,11
Nealy,F,100,11,0,11
Neria,F,100,11,0,11
Nethan,M,100,0,11,11
Neveya,F,100,11,0,11
Nickolos,M,100,0,11,11
Nii,M,100,0,11,11
Nikali,M,100,0,11,11
Nikan,M,100,0,11,11
Nissan,M,100,0,11,11
Niven,M,100,0,11,11
Noahjames,M,100,0,11,11
Nollan,M,100,0,11,11
Nonnie,F,100,11,0,11
Noraida,F,100,11,0,11
Norberta,F,100,11,0,11
Norrin,M,100,0,11,11
Nubian,F,100,11,0,11
Numa,F,100,11,0,11
Nuno,M,100,0,11,11
Nuriya,F,100,11,0,11
Nyajah,F,100,11,0,11
Nyamal,F,100,11,0,11
Nyhla,F,100,11,0,11
Nyxon,M,100,0,11,11
Obaloluwa,M,100,0,11,11
Ogechukwu,M,55,5,6,11
Olanrewaju,M,100,0,11,11
Oleh,M,100,0,11,11
Olene,F,100,11,0,11
Oluwatoniloba,F,55,6,5,11
Olyve,F,100,11,0,11
Olyviah,F,100,11,0,11
Omarii,M,100,0,11,11
Omarius,M,100,0,11,11
Omeka,F,100,11,0,11
Onie,F,100,11,0,11
Oria,F,100,11,0,11
Orissa,F,100,11,0,11
Oryon,M,100,0,11,11
Oseph,M,100,0,11,11
Osmani,M,100,0,11,11
Paislei,F,100,11,0,11
Paislynn,F,100,11,0,11
Paralee,F,100,11,0,11
Pason,M,100,0,11,11
Patryce,F,100,11,0,11
Pattianne,F,100,11,0,11
Pavle,M,100,0,11,11
Perpetua,F,100,11,0,11
Phinn,M,100,0,11,11
Phoenixx,F,100,11,0,11
Pierceson,M,100,0,11,11
Posy,F,100,11,0,11
Prarthana,F,100,11,0,11
Prerana,F,100,11,0,11
Previn,M,100,0,11,11
Printice,M,100,0,11,11
Priscylla,F,100,11,0,11
Qadira,F,100,11,0,11
Quandre,M,100,0,11,11
Quaniya,F,100,11,0,11
Quasia,F,100,11,0,11
Quindarious,M,100,0,11,11
Quineisha,F,100,11,0,11
Quintera,F,100,11,0,11
Quintonia,F,100,11,0,11
Raahil,M,100,0,11,11
Rachelmarie,F,100,11,0,11
Raekwan,M,100,0,11,11
Rafia,F,100,11,0,11
Rahniya,F,100,11,0,11
Raiana,F,100,11,0,11
Raighan,F,100,11,0,11
Rajanae,F,100,11,0,11
Rakhi,F,100,11,0,11
Raksha,F,100,11,0,11
Rakwon,M,100,0,11,11
Rambo,M,100,0,11,11
Ramika,F,100,11,0,11
Randarius,M,100,0,11,11
Ranetta,F,100,11,0,11
Ranique,F,100,11,0,11
Rannon,M,100,0,11,11
Ranyiah,F,100,11,0,11
Rashika,F,100,11,0,11
Ratasha,F,100,11,0,11
Rawad,M,100,0,11,11
Raydell,M,100,0,11,11
Rayel,M,55,5,6,11
Raymonde,F,100,11,0,11
Raymound,M,100,0,11,11
Raynav,M,100,0,11,11
Rayshard,M,100,0,11,11
Rayssa,F,100,11,0,11
Rayza,F,100,11,0,11
Razi,M,100,0,11,11
Read,M,100,0,11,11
Redrick,M,100,0,11,11
Refujio,M,100,0,11,11
Regana,F,100,11,0,11
Regginald,M,100,0,11,11
Regionald,M,100,0,11,11
Rejina,F,100,11,0,11
Remer,M,100,0,11,11
Renorda,F,100,11,0,11
Rexann,F,100,11,0,11
Reynel,M,100,0,11,11
Rheanne,F,100,11,0,11
Rhet,M,100,0,11,11
Rhonin,M,100,0,11,11
Rhyden,M,100,0,11,11
Rickiya,F,100,11,0,11
Ridha,M,100,0,11,11
Righteous,M,100,0,11,11
Rikardo,M,100,0,11,11
Rilan,M,100,0,11,11
Rilley,M,100,0,11,11
Ringo,M,100,0,11,11
Ritisha,F,100,11,0,11
Roberth,M,100,0,11,11
Rodrico,M,100,0,11,11
Roe,F,55,6,5,11
Rokia,F,100,11,0,11
Rola,F,100,11,0,11
Romari,M,100,0,11,11
Roniqua,F,100,11,0,11
Ronja,F,100,11,0,11
Rosine,F,100,11,0,11
Rounak,M,100,0,11,11
Roverto,M,100,0,11,11
Roxene,F,100,11,0,11
Ruah,F,100,11,0,11
Rus,M,55,5,6,11
Russia,F,100,11,0,11
Rykia,F,100,11,0,11
Ryleah,F,100,11,0,11
Rylund,M,100,0,11,11
Saamiya,F,100,11,0,11
Saanvika,F,100,11,0,11
Saavi,F,100,11,0,11
Saffiyah,F,100,11,0,11
Safiatou,F,100,11,0,11
Sahalie,F,100,11,0,11
Sahand,M,100,0,11,11
Sakena,F,100,11,0,11
Sakira,F,100,11,0,11
Salif,M,100,0,11,11
Salisha,F,100,11,0,11
Sametria,F,100,11,0,11
Samon,F,100,11,0,11
Samorah,F,100,11,0,11
Samvit,M,100,0,11,11
Sanja,F,100,11,0,11
Santasia,F,100,11,0,11
Sarahanne,F,100,11,0,11
Saranda,F,100,11,0,11
Sarrinah,F,100,11,0,11
Sary,F,100,11,0,11
Saryia,F,100,11,0,11
Sasuke,M,100,0,11,11
Sathvika,F,100,11,0,11
Savayah,F,100,11,0,11
Seanne,F,100,11,0,11
Sebastiaan,M,100,0,11,11
Seiya,M,100,0,11,11
Seleta,F,100,11,0,11
Semia,F,100,11,0,11
Senaya,F,100,11,0,11
Serai,F,100,11,0,11
Seresa,F,100,11,0,11
Serin,F,100,11,0,11
Seydina,M,100,0,11,11
Seyla,F,100,11,0,11
Shabreka,F,100,11,0,11
Shabsi,M,100,0,11,11
Shacoya,F,100,11,0,11
Shadasia,F,100,11,0,11
Shahil,M,100,0,11,11
Shahla,F,100,11,0,11
Shaiel,F,100,11,0,11
Shakiah,F,100,11,0,11
Shakura,F,100,11,0,11
Shalaina,F,100,11,0,11
Shalandria,F,100,11,0,11
Shanayah,F,100,11,0,11
Shandale,F,100,11,0,11
Shandee,F,100,11,0,11
Shandolyn,F,100,11,0,11
Shanndolyn,F,100,11,0,11
Shannia,F,100,11,0,11
Shanora,F,100,11,0,11
Shantera,F,100,11,0,11
Shanterica,F,100,11,0,11
Shantise,F,100,11,0,11
Shaquez,M,100,0,11,11
Shaquon,M,100,0,11,11
Shaquoya,F,100,11,0,11
Sharane,F,100,11,0,11
Sharmarke,M,100,0,11,11
Sharmila,F,100,11,0,11
Sharnette,F,100,11,0,11
Shatarra,F,100,11,0,11
Shataya,F,100,11,0,11
Shaunae,F,100,11,0,11
Shawney,F,100,11,0,11
Sheera,F,100,11,0,11
Shenica,F,100,11,0,11
Sherrine,F,100,11,0,11
Shikia,F,100,11,0,11
Shintaro,M,100,0,11,11
Shiquan,M,100,0,11,11
Shirlena,F,100,11,0,11
Shirrell,F,100,11,0,11
Shivangi,F,100,11,0,11
Shivaun,F,100,11,0,11
Shonita,F,100,11,0,11
Shradha,F,100,11,0,11
Shreyaan,M,100,0,11,11
Shunn,M,100,0,11,11
Shunte,F,100,11,0,11
Shuntel,F,100,11,0,11
Shuron,M,55,5,6,11
Shyhiem,M,100,0,11,11
Shyniece,F,100,11,0,11
Shyvonne,F,100,11,0,11
Siddanth,M,100,0,11,11
Simora,F,100,11,0,11
Siobhain,F,100,11,0,11
Sirr,M,100,0,11,11
Sisto,M,100,0,11,11
Skyelyn,F,100,11,0,11
Skylon,M,100,0,11,11
Solomone,M,100,0,11,11
Somone,F,100,11,0,11
Sonata,F,100,11,0,11
Sondos,F,100,11,0,11
Sorren,M,100,0,11,11
Soteria,F,100,11,0,11
Soumil,M,100,0,11,11
Sriansh,M,100,0,11,11
Staceyann,F,100,11,0,11
Stachia,F,100,11,0,11
Stanlee,M,100,0,11,11
Starsky,M,100,0,11,11
Stasi,F,100,11,0,11
Statham,M,100,0,11,11
Stepheni,F,100,11,0,11
Stevette,F,100,11,0,11
Stevey,F,100,11,0,11
Stylianos,M,100,0,11,11
Suany,F,100,11,0,11
Sufia,F,100,11,0,11
Sukhjot,M,100,0,11,11
Suliana,F,100,11,0,11
Sumar,F,100,11,0,11
Sumika,F,100,11,0,11
Syana,F,100,11,0,11
Symira,F,100,11,0,11
Symphanie,F,100,11,0,11
Tabaitha,F,100,11,0,11
Tabrina,F,100,11,0,11
Tacoma,M,100,0,11,11
Tahjanae,F,100,11,0,11
Tahleah,F,100,11,0,11
Taiba,F,100,11,0,11
Taigan,F,100,11,0,11
Taijae,M,100,0,11,11
Taitlyn,F,100,11,0,11
Taiwana,F,100,11,0,11
Takeena,F,100,11,0,11
Takeyla,F,100,11,0,11
Takirah,F,100,11,0,11
Takyah,F,100,11,0,11
Talithia,F,100,11,0,11
Tamalyn,F,100,11,0,11
Tamana,F,100,11,0,11
Tamauri,M,55,5,6,11
Tametha,F,100,11,0,11
Tamonica,F,100,11,0,11
Tamzin,F,100,11,0,11
Tanaija,F,100,11,0,11
Tanairy,F,100,11,0,11
Tanyiah,F,100,11,0,11
Tanyika,F,100,11,0,11
Tanyon,M,100,0,11,11
Tarris,M,100,0,11,11
Tashai,F,100,11,0,11
Tashya,F,100,11,0,11
Tashyra,F,100,11,0,11
Tawania,F,100,11,0,11
Tayja,F,100,11,0,11
Tayley,F,100,11,0,11
Tayli,F,100,11,0,11
Tayona,F,100,11,0,11
Telesa,F,100,11,0,11
Temujin,M,100,0,11,11
Tenaj,F,100,11,0,11
Teresina,F,100,11,0,11
Teriah,F,100,11,0,11
Terissa,F,100,11,0,11
Terrial,M,100,0,11,11
Tessalyn,F,100,11,0,11
Thadd,M,100,0,11,11
Thandi,F,100,11,0,11
Thelia,F,100,11,0,11
Theodoric,M,100,0,11,11
Theone,F,100,11,0,11
Thereas,F,100,11,0,11
Thersia,F,100,11,0,11
Thornell,M,100,0,11,11
Tiaria,F,100,11,0,11
Tiffanni,F,100,11,0,11
Tiffni,F,100,11,0,11
Tijon,M,100,0,11,11
Tilisa,F,100,11,0,11
Timotheus,M,100,0,11,11
Ting,F,100,11,0,11
Tiwatope,F,100,11,0,11
Tiyah,F,100,11,0,11
Tola,F,100,11,0,11
Tomar,M,100,0,11,11
Tonea,F,100,11,0,11
Torreon,M,100,0,11,11
Toshima,F,100,11,0,11
Traeshawn,M,100,0,11,11
Tranesha,F,100,11,0,11
Travaughn,M,100,0,11,11
Trei,M,100,0,11,11
Trelon,M,100,0,11,11
Treniya,F,100,11,0,11
Trinadee,F,100,11,0,11
Trooper,M,100,0,11,11
Tychicus,M,100,0,11,11
Tyjai,F,55,6,5,11
Tykwan,M,100,0,11,11
Tyliek,M,100,0,11,11
Tymeir,M,100,0,11,11
Tymeka,F,100,11,0,11
Tymisha,F,100,11,0,11
Tyniah,F,100,11,0,11
Tyreonna,F,100,11,0,11
Tzion,M,100,0,11,11
Udell,M,100,0,11,11
Unk,M,55,5,6,11
Ursela,F,100,11,0,11
Vahin,M,100,0,11,11
Vail,F,100,11,0,11
Valary,F,100,11,0,11
Valin,M,100,0,11,11
Valincia,F,100,11,0,11
Valire,F,100,11,0,11
Vallory,F,100,11,0,11
Vanika,F,100,11,0,11
Varen,M,100,0,11,11
Vear,F,100,11,0,11
Velen,F,100,11,0,11
Velisha,F,100,11,0,11
Venicio,M,100,0,11,11
Venkat,M,100,0,11,11
Venya,F,100,11,0,11
Veralynn,F,100,11,0,11
Verdon,M,100,0,11,11
Victorie,F,100,11,0,11
Vidyuth,M,100,0,11,11
Vila,F,100,11,0,11
Vinchenzo,M,100,0,11,11
Vinod,M,100,0,11,11
Vista,F,100,11,0,11
Volney,M,100,0,11,11
Vue,M,100,0,11,11
Vuong,M,100,0,11,11
Wafaa,F,100,11,0,11
Walther,M,100,0,11,11
Wander,F,100,11,0,11
Wanza,F,100,11,0,11
Waris,M,100,0,11,11
Wash,M,100,0,11,11
Wilkie,M,100,0,11,11
Willo,F,100,11,0,11
Willoh,F,100,11,0,11
Wilmarie,F,100,11,0,11
Wilmon,M,100,0,11,11
Win,F,55,6,5,11
Wyndy,F,100,11,0,11
Wynonna,F,100,11,0,11
Wyvonnia,F,100,11,0,11
Xain,M,100,0,11,11
Xairexis,F,100,11,0,11
Xavianna,F,100,11,0,11
Xochilth,F,100,11,0,11
Yackelin,F,100,11,0,11
Yadel,M,100,0,11,11
Yagmur,F,100,11,0,11
Yailine,F,100,11,0,11
Yalixa,F,100,11,0,11
Yanisa,F,100,11,0,11
Yar,F,100,11,0,11
Yarieli,F,100,11,0,11
Yasaman,F,100,11,0,11
Yaslene,F,100,11,0,11
Yaviel,M,100,0,11,11
Yazleen,F,100,11,0,11
Yejin,F,100,11,0,11
Yhael,M,100,0,11,11
Yigit,M,100,0,11,11
Ynez,F,100,11,0,11
Yoandry,M,100,0,11,11
Yonna,F,100,11,0,11
Yosniel,M,100,0,11,11
Ysela,F,100,11,0,11
Yujin,F,100,11,0,11
Zacara,F,100,11,0,11
Zacardi,M,100,0,11,11
Zadien,M,100,0,11,11
Zaevian,M,100,0,11,11
Zaion,M,100,0,11,11
Zaiyah,F,100,11,0,11
Zamayah,F,100,11,0,11
Zamoni,F,100,11,0,11
Zamyrah,F,100,11,0,11
Zanasia,F,100,11,0,11
Zareah,F,100,11,0,11
Zareena,F,100,11,0,11
Zariha,F,100,11,0,11
Zaryia,F,100,11,0,11
Zavannah,F,100,11,0,11
Zayshawn,M,100,0,11,11
Zeltzin,F,100,11,0,11
Zhaiden,M,100,0,11,11
Zhanna,F,100,11,0,11
Zhayden,M,100,0,11,11
Ziarah,F,100,11,0,11
Zineb,F,100,11,0,11
Zisel,F,100,11,0,11
Zorawar,M,100,0,11,11
Zorina,F,100,11,0,11
Zuriya,F,100,11,0,11
Zurri,F,100,11,0,11
Zyliah,F,100,11,0,11
Zylin,M,100,0,11,11
Zymiere,M,100,0,11,11
Zyona,F,100,11,0,11
Zyriyah,F,100,11,0,11
Aairah,F,100,10,0,10
Aaliyan,F,100,10,0,10
Aamer,M,100,0,10,10
Aashish,M,100,0,10,10
Aayanna,F,100,10,0,10
Abbeygail,F,100,10,0,10
Abdulmajid,M,100,0,10,10
Abednego,M,100,0,10,10
Abney,F,100,10,0,10
Abraam,M,100,0,10,10
Abrien,M,100,0,10,10
Abrionna,F,100,10,0,10
Abron,M,100,0,10,10
Abubacarr,M,100,0,10,10
Abygayle,F,100,10,0,10
Acer,M,100,0,10,10
Adalicia,F,100,10,0,10
Adejah,F,100,10,0,10
Aderyn,F,100,10,0,10
Adlin,F,100,10,0,10
Adolpho,M,100,0,10,10
Adom,M,100,0,10,10
Adoni,M,100,0,10,10
Adreanne,F,100,10,0,10
Adreian,M,100,0,10,10
Adylan,F,100,10,0,10
Aella,F,100,10,0,10
Afeni,F,100,10,0,10
Agrim,M,100,0,10,10
Ahijah,M,100,0,10,10
Ahmyah,F,100,10,0,10
Ailanie,F,100,10,0,10
Ailena,F,100,10,0,10
Aileth,F,100,10,0,10
Ainzlee,F,100,10,0,10
Aisia,F,100,10,0,10
Aiyona,F,100,10,0,10
Ajana,F,100,10,0,10
Ajeenah,F,100,10,0,10
Akara,F,100,10,0,10
Akashdeep,M,100,0,10,10
Akenya,F,100,10,0,10
Akirra,F,100,10,0,10
Alandis,M,100,0,10,10
Alecea,F,100,10,0,10
Alecxis,M,100,0,10,10
Aletia,F,100,10,0,10
Alexarae,F,100,10,0,10
Alexaundria,F,100,10,0,10
Alexica,F,100,10,0,10
Alexiea,F,100,10,0,10
Alexine,F,100,10,0,10
Aleyia,F,100,10,0,10
Aleyla,F,100,10,0,10
Algenis,M,100,0,10,10
Alhan,M,100,0,10,10
Aliene,F,100,10,0,10
Aliou,M,100,0,10,10
Aljandro,M,100,0,10,10
Allivia,F,100,10,0,10
Allix,F,100,10,0,10
Almas,F,100,10,0,10
Alonia,F,100,10,0,10
Alonie,F,100,10,0,10
Altamese,F,100,10,0,10
Alveta,F,100,10,0,10
Alysiah,F,100,10,0,10
Alyssum,F,100,10,0,10
Alyzon,F,100,10,0,10
Amaani,F,100,10,0,10
Amandalee,F,100,10,0,10
Amary,F,50,5,5,10
Amberle,F,100,10,0,10
Ameeyah,F,100,10,0,10
Amenia,F,100,10,0,10
Amiela,F,100,10,0,10
Amiir,M,100,0,10,10
Ammanuel,M,100,0,10,10
Amree,F,100,10,0,10
Anabelen,F,100,10,0,10
Anacarolina,F,100,10,0,10
Anadelia,F,100,10,0,10
Anaisabella,F,100,10,0,10
Anaissa,F,100,10,0,10
Anarose,F,100,10,0,10
Anastazja,F,100,10,0,10
Anayi,F,100,10,0,10
Anayjah,F,100,10,0,10
Andreaus,M,100,0,10,10
Andros,M,100,0,10,10
Angeldaniel,M,100,0,10,10
Ankush,M,100,0,10,10
Annaleese,F,100,10,0,10
Annarae,F,100,10,0,10
Annesia,F,100,10,0,10
Annorah,F,100,10,0,10
Antanette,F,100,10,0,10
Antonae,F,100,10,0,10
Antoney,M,100,0,10,10
Antuane,M,100,0,10,10
Anuradha,F,100,10,0,10
Anyra,F,100,10,0,10
Anysa,F,100,10,0,10
Anyssia,F,100,10,0,10
Apryll,F,100,10,0,10
Arainna,F,100,10,0,10
Archimedes,M,100,0,10,10
Aricela,F,100,10,0,10
Ariee,F,100,10,0,10
Arieh,M,100,0,10,10
Arkangel,M,100,0,10,10
Arles,M,100,0,10,10
Arlesha,F,100,10,0,10
Arli,F,100,10,0,10
Arlissa,F,100,10,0,10
Arlyce,F,100,10,0,10
Armiyah,F,100,10,0,10
Arnecia,F,100,10,0,10
Arnela,F,100,10,0,10
Aroura,F,100,10,0,10
Arrietty,F,100,10,0,10
Arshawn,M,100,0,10,10
Aryss,F,100,10,0,10
Arzella,F,100,10,0,10
Asenet,F,100,10,0,10
Aseret,F,100,10,0,10
Ashan,M,100,0,10,10
Ashanna,F,100,10,0,10
Ashiana,F,100,10,0,10
Ashlley,F,100,10,0,10
Ashyra,F,100,10,0,10
Asil,F,50,5,5,10
Asuka,F,100,10,0,10
Athira,F,100,10,0,10
Atilano,M,100,0,10,10
Atilla,M,100,0,10,10
Audreena,F,100,10,0,10
Audrianne,F,100,10,0,10
Audriella,F,100,10,0,10
Autumm,F,100,10,0,10
Autym,F,100,10,0,10
Avaiya,F,100,10,0,10
Avaiyah,F,100,10,0,10
Avalea,F,100,10,0,10
Avantae,M,100,0,10,10
Avedis,M,100,0,10,10
Avelin,F,100,10,0,10
Averlee,F,100,10,0,10
Averley,F,100,10,0,10
Avya,F,100,10,0,10
Ayen,F,100,10,0,10
Aylena,F,100,10,0,10
Ayn,F,100,10,0,10
Ayreanna,F,100,10,0,10
Ayzlee,F,100,10,0,10
Azani,F,100,10,0,10
Azavion,M,100,0,10,10
Azelynn,F,100,10,0,10
Azoria,F,100,10,0,10
Azyla,F,100,10,0,10
Bae,F,100,10,0,10
Bahareh,F,100,10,0,10
Baltasar,M,100,0,10,10
Bandy,M,100,0,10,10
Baraa,M,100,0,10,10
Barnetta,F,100,10,0,10
Batul,F,100,10,0,10
Behati,F,100,10,0,10
Beily,F,100,10,0,10
Bekim,M,100,0,10,10
Berneda,F,100,10,0,10
Bethannie,F,100,10,0,10
Beza,F,100,10,0,10
Biancia,F,100,10,0,10
Bilan,F,100,10,0,10
Blaikley,F,100,10,0,10
Blaydon,M,100,0,10,10
Bobak,M,100,0,10,10
Boneta,F,100,10,0,10
Bonnye,F,100,10,0,10
Bracey,F,100,10,0,10
Braddox,M,100,0,10,10
Bradee,F,50,5,5,10
Bradlie,F,100,10,0,10
Braeton,M,100,0,10,10
Brandel,M,100,0,10,10
Brandley,M,100,0,10,10
Breanca,F,100,10,0,10
Breeza,F,100,10,0,10
Breilyn,F,100,10,0,10
Brendolyn,F,100,10,0,10
Brenlyn,F,100,10,0,10
Brettley,M,100,0,10,10
Bridey,F,100,10,0,10
Bridge,M,100,0,10,10
Briellah,F,100,10,0,10
Brigido,M,100,0,10,10
Brionca,F,100,10,0,10
Brittanyann,F,100,10,0,10
Brittanye,F,100,10,0,10
Brittinie,F,100,10,0,10
Bry,M,100,0,10,10
Bryanah,F,100,10,0,10
Bufford,M,100,0,10,10
Bunni,F,100,10,0,10
Burman,M,100,0,10,10
Cambrea,F,100,10,0,10
Canada,F,100,10,0,10
Candas,F,100,10,0,10
Candid,F,100,10,0,10
Caraleigh,F,100,10,0,10
Carlaysia,F,100,10,0,10
Carmynn,F,100,10,0,10
Carrine,F,100,10,0,10
Cassel,M,100,0,10,10
Cathal,M,100,0,10,10
Catilin,F,100,10,0,10
Caycie,F,100,10,0,10
Caye,F,100,10,0,10
Cecylia,F,100,10,0,10
Celecia,F,100,10,0,10
Cella,F,100,10,0,10
Chamari,F,100,10,0,10
Chandlor,M,100,0,10,10
Chanetta,F,100,10,0,10
Charesse,F,100,10,0,10
Charika,F,100,10,0,10
Charina,F,100,10,0,10
Charlann,F,100,10,0,10
Charlestine,F,100,10,0,10
Charlisha,F,100,10,0,10
Charvez,M,100,0,10,10
Charvis,M,100,0,10,10
Chaselynn,F,100,10,0,10
Chasmine,F,100,10,0,10
Chatara,F,100,10,0,10
Chayim,M,100,0,10,10
Chemene,F,100,10,0,10
Chemere,F,100,10,0,10
Cherylin,F,100,10,0,10
Cheyan,F,100,10,0,10
Cheyney,F,50,5,5,10
Chidozie,M,100,0,10,10
Chie,F,100,10,0,10
Chihiro,F,100,10,0,10
Chimera,F,100,10,0,10
Chiniqua,F,100,10,0,10
Chonte,F,100,10,0,10
Chosen,M,100,0,10,10
Chrisha,F,100,10,0,10
Christof,M,100,0,10,10
Christyann,F,100,10,0,10
Chrysten,F,100,10,0,10
Chukwuka,M,100,0,10,10
Cianne,F,100,10,0,10
Cidnee,F,100,10,0,10
Ciona,F,100,10,0,10
Citlalic,F,100,10,0,10
Claus,M,100,0,10,10
Clayden,M,100,0,10,10
Clayson,M,100,0,10,10
Cleave,M,100,0,10,10
Clemetine,F,100,10,0,10
Cleto,M,100,0,10,10
Clever,M,100,0,10,10
Cloris,F,100,10,0,10
Colleena,F,100,10,0,10
Colsyn,M,100,0,10,10
Conleigh,F,100,10,0,10
Constancia,F,100,10,0,10
Conya,F,100,10,0,10
Corabella,F,100,10,0,10
Cordelle,M,100,0,10,10
Corean,F,100,10,0,10
Corrisa,F,100,10,0,10
Cortlin,M,100,0,10,10
Cotter,M,100,0,10,10
Courvoisier,M,100,0,10,10
Crissi,F,100,10,0,10
Crusoe,M,100,0,10,10
Crytal,F,100,10,0,10
Cyera,F,100,10,0,10
Cymon,M,100,0,10,10
Cynara,F,100,10,0,10
Dacie,F,100,10,0,10
Dair,M,100,0,10,10
Daiwik,M,100,0,10,10
Dakai,M,100,0,10,10
Daking,M,100,0,10,10
Dalayah,F,100,10,0,10
Dalbert,M,100,0,10,10
Dalesha,F,100,10,0,10
Damarkis,M,100,0,10,10
Dameshia,F,100,10,0,10
Dametri,M,100,0,10,10
Danard,M,100,0,10,10
Danayla,F,100,10,0,10
Daneja,F,100,10,0,10
Danikka,F,100,10,0,10
Danisa,F,100,10,0,10
Daniyel,M,100,0,10,10
Danniell,F,100,10,0,10
Daouda,M,100,0,10,10
Dar,M,100,0,10,10
Daresha,F,100,10,0,10
Darlisa,F,100,10,0,10
Darriell,F,100,10,0,10
Dasaun,M,100,0,10,10
Dashell,F,50,5,5,10
Dasie,F,100,10,0,10
Daton,M,100,0,10,10
Daughtry,M,100,0,10,10
Davee,F,100,10,0,10
Dayn,M,100,0,10,10
Dayzia,F,100,10,0,10
Dazie,F,100,10,0,10
Deacan,M,100,0,10,10
Dearie,F,100,10,0,10
Dearis,M,100,0,10,10
Dearra,F,100,10,0,10
Deaton,M,100,0,10,10
Deaunna,F,100,10,0,10
Deenna,F,100,10,0,10
Deionna,F,100,10,0,10
Dejahnae,F,100,10,0,10
Deklynn,F,100,10,0,10
Delara,F,100,10,0,10
Delcina,F,100,10,0,10
Delio,M,100,0,10,10
Delshon,M,100,0,10,10
Demaree,M,100,0,10,10
Demarkis,M,100,0,10,10
Demba,M,100,0,10,10
Demeterius,M,100,0,10,10
Demontray,M,100,0,10,10
Denaisha,F,100,10,0,10
Denekia,F,100,10,0,10
Denero,M,100,0,10,10
Denisia,F,100,10,0,10
Denni,F,100,10,0,10
Deoveon,F,100,10,0,10
Dequandre,M,100,0,10,10
Dequante,M,100,0,10,10
Deria,F,100,10,0,10
Derionna,F,100,10,0,10
Derone,M,100,0,10,10
Dervon,M,100,0,10,10
Deshana,F,100,10,0,10
Deshondra,F,100,10,0,10
Desia,F,100,10,0,10
Deslynn,F,100,10,0,10
Desrae,F,100,10,0,10
Detavious,M,100,0,10,10
Dezare,F,100,10,0,10
Dezirea,F,100,10,0,10
Deziya,F,100,10,0,10
Dhamar,F,100,10,0,10
Dheeraj,M,100,0,10,10
Dhiren,M,100,0,10,10
Diandrea,F,100,10,0,10
Dianira,F,100,10,0,10
Diella,F,100,10,0,10
Dilen,M,100,0,10,10
Dinesh,M,100,0,10,10
Dinna,F,100,10,0,10
Doaa,F,100,10,0,10
Doll,F,100,10,0,10
Domnic,M,100,0,10,10
Donivin,M,100,0,10,10
Donnalyn,F,100,10,0,10
Donnavon,M,100,0,10,10
Dontee,M,100,0,10,10
Dontrae,M,100,0,10,10
Dorca,F,100,10,0,10
Dounia,F,100,10,0,10
Draxton,M,100,0,10,10
Drayk,M,100,0,10,10
Dredon,M,100,0,10,10
Drury,M,100,0,10,10
Duarte,M,100,0,10,10
Duell,M,100,0,10,10
Duglas,M,100,0,10,10
Durga,F,100,10,0,10
Durron,M,100,0,10,10
Dustee,F,100,10,0,10
Dvante,M,100,0,10,10
Dvora,F,100,10,0,10
Dyonne,F,100,10,0,10
Earlena,F,100,10,0,10
Eastynn,F,100,10,0,10
Edita,F,100,10,0,10
Edjuan,M,100,0,10,10
Edwynn,M,100,0,10,10
Efrat,F,100,10,0,10
Eiliana,F,100,10,0,10
Eito,M,100,0,10,10
Elay,M,100,0,10,10
Elbin,M,100,0,10,10
Eldric,M,100,0,10,10
Elhadji,M,100,0,10,10
Elira,F,100,10,0,10
Elisabel,F,100,10,0,10
Elison,F,50,5,5,10
Elleson,F,100,10,0,10
Elliett,F,100,10,0,10
Elmarie,F,100,10,0,10
Elnita,F,100,10,0,10
Elsha,F,100,10,0,10
Emberley,F,100,10,0,10
Emberlie,F,100,10,0,10
Emeril,M,100,0,10,10
Emmariah,F,100,10,0,10
Emmeri,F,100,10,0,10
Emric,M,100,0,10,10
Emrik,M,100,0,10,10
Emyli,F,100,10,0,10
Enan,M,100,0,10,10
Enyah,F,100,10,0,10
Enzley,F,100,10,0,10
Erby,M,100,0,10,10
Ercia,F,100,10,0,10
Eryss,F,100,10,0,10
Escarleth,F,100,10,0,10
Esparanza,F,100,10,0,10
Ethanjacob,M,100,0,10,10
Ettie,F,100,10,0,10
Etzio,M,100,0,10,10
Eugen,M,100,0,10,10
Eurydice,F,100,10,0,10
Evlynn,F,100,10,0,10
Evva,F,100,10,0,10
Eyani,F,100,10,0,10
Ezabelle,F,100,10,0,10
Ezykiel,M,100,0,10,10
Falen,F,100,10,0,10
Fanchon,F,100,10,0,10
Fani,F,100,10,0,10
Farhaan,M,100,0,10,10
Fatih,M,100,0,10,10
Fatisha,F,100,10,0,10
Fatoumatta,F,100,10,0,10
Fawwaz,M,100,0,10,10
Fayrene,F,100,10,0,10
Federick,M,100,0,10,10
Fedra,F,100,10,0,10
Fenris,M,100,0,10,10
Ferenc,M,100,0,10,10
Ferlando,M,100,0,10,10
Firman,M,100,0,10,10
Flordia,F,100,10,0,10
Forrester,M,100,0,10,10
Francess,F,100,10,0,10
Franchester,F,100,10,0,10
Frasier,M,100,0,10,10
Gabrel,M,100,0,10,10
Gabriyel,F,50,5,5,10
Gad,M,100,0,10,10
Galan,M,100,0,10,10
Garima,F,100,10,0,10
Garo,M,100,0,10,10
Garr,M,100,0,10,10
Gaspard,M,100,0,10,10
Genni,F,100,10,0,10
Genya,F,100,10,0,10
Georgian,F,100,10,0,10
Georgiy,M,100,0,10,10
Gerica,F,100,10,0,10
Giankarlo,M,100,0,10,10
Gianpiero,M,100,0,10,10
Giavannah,F,100,10,0,10
Gitana,F,100,10,0,10
Giustina,F,100,10,0,10
Glorimar,F,100,10,0,10
Graciano,M,100,0,10,10
Graisen,M,100,0,10,10
Granada,F,100,10,0,10
Graysyn,M,100,0,10,10
Greeley,F,100,10,0,10
Gwennyth,F,100,10,0,10
Haben,F,50,5,5,10
Hadara,F,100,10,0,10
Haidin,F,50,5,5,10
Hailen,F,100,10,0,10
Hammond,M,100,0,10,10
Hanish,M,100,0,10,10
Hannes,M,100,0,10,10
Harden,M,100,0,10,10
Harles,M,100,0,10,10
Hartlynn,F,100,10,0,10
Harvis,M,100,0,10,10
Havisha,F,100,10,0,10
Haydenn,F,100,10,0,10
Haylan,F,100,10,0,10
Hela,F,100,10,0,10
Helia,F,100,10,0,10
Heliana,F,100,10,0,10
Helin,F,100,10,0,10
Helmer,M,100,0,10,10
Heyab,F,100,10,0,10
Heylin,F,100,10,0,10
Hezeki,M,100,0,10,10
Hiran,M,100,0,10,10
Hoke,M,100,0,10,10
Horlando,M,100,0,10,10
Hoy,M,100,0,10,10
Hritik,M,100,0,10,10
Htoo,M,100,0,10,10
Hurbert,M,100,0,10,10
Hy,M,100,0,10,10
Icie,F,100,10,0,10
Idalys,F,100,10,0,10
Idara,F,100,10,0,10
Ifeanyi,M,100,0,10,10
Ikechi,M,100,0,10,10
Ilany,F,100,10,0,10
Ilithyia,F,100,10,0,10
Illeanna,F,100,10,0,10
Indyia,F,100,10,0,10
Iniyan,M,100,0,10,10
Iolana,F,100,10,0,10
Iqbal,M,100,0,10,10
Irem,F,100,10,0,10
Israelle,F,100,10,0,10
Issachar,M,100,0,10,10
Issiac,M,100,0,10,10
Itali,F,100,10,0,10
Iyah,F,100,10,0,10
Iyon,M,100,0,10,10
Iysha,F,100,10,0,10
Izaias,M,100,0,10,10
Izibella,F,100,10,0,10
Izza,F,100,10,0,10
Jackalynn,F,100,10,0,10
Jackob,M,100,0,10,10
Jackqulyn,F,100,10,0,10
Jaclene,F,100,10,0,10
Jacoria,F,100,10,0,10
Jacoya,F,100,10,0,10
Jacqeline,F,100,10,0,10
Jacqlynn,F,100,10,0,10
Jacquell,M,100,0,10,10
Jacyeon,M,100,0,10,10
Jacyon,M,100,0,10,10
Jaen,M,100,0,10,10
Jahanna,F,100,10,0,10
Jaharie,M,100,0,10,10
Jahshaun,M,100,0,10,10
Jakalyn,F,100,10,0,10
Jakela,F,100,10,0,10
Jakelyne,F,100,10,0,10
Jakyi,M,100,0,10,10
Jalaiya,F,100,10,0,10
Jalexy,F,100,10,0,10
Jameire,M,100,0,10,10
Jamespatrick,M,100,0,10,10
Jammel,M,100,0,10,10
Jamyson,M,100,0,10,10
Janas,F,50,5,5,10
Janaysha,F,100,10,0,10
Janisse,F,100,10,0,10
Jantz,M,100,0,10,10
Jaquae,M,100,0,10,10
Jaqueta,F,100,10,0,10
Jaquil,M,100,0,10,10
Jaquila,F,100,10,0,10
Jaquilla,F,100,10,0,10
Jarreau,M,100,0,10,10
Jasara,F,100,10,0,10
Jasilyn,F,100,10,0,10
Jasly,F,100,10,0,10
Jasmane,F,100,10,0,10
Jasmie,F,100,10,0,10
Jasminne,F,100,10,0,10
Jatara,F,100,10,0,10
Jatavis,M,100,0,10,10
Jaterrious,M,100,0,10,10
Jayciana,F,100,10,0,10
Jaydy,F,100,10,0,10
Jayelynn,F,100,10,0,10
Jayonni,F,100,10,0,10
Jayva,F,100,10,0,10
Jayze,M,100,0,10,10
Jayzion,M,100,0,10,10
Jazsmin,F,100,10,0,10
Jediael,M,100,0,10,10
Jeffree,M,100,0,10,10
Jeilany,F,100,10,0,10
Jemarion,M,100,0,10,10
Jemil,M,100,0,10,10
Jenayah,F,100,10,0,10
Jeneal,F,100,10,0,10
Jenisa,F,100,10,0,10
Jenneth,F,100,10,0,10
Jennier,F,100,10,0,10
Jennylee,F,100,10,0,10
Jenry,M,100,0,10,10
Jermesha,F,100,10,0,10
Jerol,M,100,0,10,10
Jerona,F,100,10,0,10
Jeshurun,M,100,0,10,10
Jessice,F,100,10,0,10
Jessye,F,100,10,0,10
Jesy,F,50,5,5,10
Jeyda,F,100,10,0,10
Jhada,F,100,10,0,10
Jhamar,M,100,0,10,10
Jhancarlos,M,100,0,10,10
Jiair,M,100,0,10,10
Jihaad,M,100,0,10,10
Jillien,F,100,10,0,10
Jimie,F,50,5,5,10
Jinnifer,F,100,10,0,10
Jisaiah,M,100,0,10,10
Jisella,F,100,10,0,10
Jkobe,M,100,0,10,10
Joeph,M,100,0,10,10
Joevanni,M,100,0,10,10
Johnanna,F,100,10,0,10
Johnese,F,100,10,0,10
Jolane,F,100,10,0,10
Jole,F,100,10,0,10
Joliet,F,100,10,0,10
Jolisha,F,100,10,0,10
Jonaye,F,100,10,0,10
Jonnathon,M,100,0,10,10
Jonnelle,F,100,10,0,10
Jontay,M,100,0,10,10
Jordano,M,100,0,10,10
Jorma,M,100,0,10,10
Josealfredo,M,100,0,10,10
Josefrancisco,M,100,0,10,10
Josephmichael,M,100,0,10,10
Joshawn,M,100,0,10,10
Josniel,M,100,0,10,10
Josphine,F,100,10,0,10
Joumana,F,100,10,0,10
Jrake,M,100,0,10,10
Jrayden,M,100,0,10,10
Jsiah,M,100,0,10,10
Julean,M,100,0,10,10
Juliarose,F,100,10,0,10
Junetta,F,100,10,0,10
Juwaun,M,100,0,10,10
Juwuan,M,100,0,10,10
Jya,F,100,10,0,10
Jynesis,F,100,10,0,10
Jyren,M,100,0,10,10
Jyzelle,F,100,10,0,10
Kaceon,M,100,0,10,10
Kada,F,100,10,0,10
Kaedance,F,100,10,0,10
Kahleil,M,100,0,10,10
Kaianna,F,100,10,0,10
Kailaya,F,100,10,0,10
Kaileia,F,100,10,0,10
Kailly,F,100,10,0,10
Kaimi,F,100,10,0,10
Kaina,F,100,10,0,10
Kaishawn,M,100,0,10,10
Kaite,F,100,10,0,10
Kaliannah,F,100,10,0,10
Kamahao,M,100,0,10,10
Kamayah,F,100,10,0,10
Kameesha,F,100,10,0,10
Kamerion,M,100,0,10,10
Kamirra,F,100,10,0,10
Kanija,F,100,10,0,10
Kanishka,F,100,10,0,10
Kanyia,F,100,10,0,10
Kapena,M,100,0,10,10
Karilynn,F,100,10,0,10
Karion,F,50,5,5,10
Karmyne,M,100,0,10,10
Karstin,F,50,5,5,10
Karynne,F,100,10,0,10
Kashira,F,100,10,0,10
Kataleyah,F,100,10,0,10
Kath,F,100,10,0,10
Katori,F,100,10,0,10
Kattia,F,100,10,0,10
Kaymarie,F,100,10,0,10
Kaziya,F,100,10,0,10
Kealoha,F,100,10,0,10
Keatin,M,100,0,10,10
Keaura,F,100,10,0,10
Kedrian,M,100,0,10,10
Keedan,M,100,0,10,10
Keesa,F,100,10,0,10
Keigen,M,100,0,10,10
Keinan,M,100,0,10,10
Keionte,M,100,0,10,10
Keirstan,F,100,10,0,10
Kele,M,100,0,10,10
Kelian,M,100,0,10,10
Kelilah,F,100,10,0,10
Kellina,F,100,10,0,10
Kelsye,F,100,10,0,10
Kemarrion,M,100,0,10,10
Kemontae,M,100,0,10,10
Kendarrius,M,100,0,10,10
Kenecia,F,100,10,0,10
Keniesha,F,100,10,0,10
Kente,M,100,0,10,10
Keondrae,M,100,0,10,10
Kerilynn,F,100,10,0,10
Kerney,M,100,0,10,10
Kery,F,100,10,0,10
Keryl,F,100,10,0,10
Ketih,M,100,0,10,10
Ketisha,F,100,10,0,10
Kevonn,M,100,0,10,10
Keyiana,F,100,10,0,10
Keyion,M,100,0,10,10
Keymya,F,100,10,0,10
Keyner,M,100,0,10,10
Keynon,M,100,0,10,10
Keyvan,M,100,0,10,10
Keywon,M,100,0,10,10
Khaira,F,100,10,0,10
Khaleil,M,100,0,10,10
Khaleya,F,100,10,0,10
Khaloni,F,100,10,0,10
Khileigh,F,100,10,0,10
Khmari,M,100,0,10,10
Kiandria,F,100,10,0,10
Kidada,F,100,10,0,10
Kiersti,F,100,10,0,10
Kihana,F,100,10,0,10
Kijon,M,100,0,10,10
Kilea,F,100,10,0,10
Kilen,M,100,0,10,10
Kimila,F,100,10,0,10
Kindyl,F,100,10,0,10
Kingson,M,100,0,10,10
Kinnidi,F,100,10,0,10
Kinyada,F,100,10,0,10
Kirie,F,100,10,0,10
Kiry,M,100,0,10,10
Kishore,M,100,0,10,10
Kivin,M,100,0,10,10
Kiyani,F,100,10,0,10
Kiylah,F,100,10,0,10
Kolsyn,M,100,0,10,10
Koner,M,100,0,10,10
Korianna,F,100,10,0,10
Kornelius,M,100,0,10,10
Korrey,M,100,0,10,10
Kortlynn,F,100,10,0,10
Kosha,F,100,10,0,10
Kratos,M,100,0,10,10
Kresta,F,100,10,0,10
Krissandra,F,100,10,0,10
Kristinamarie,F,100,10,0,10
Kruti,F,100,10,0,10
Ku,M,100,0,10,10
Kumba,F,100,10,0,10
Kwamel,M,100,0,10,10
Kweku,M,100,0,10,10
Kwynn,F,100,10,0,10
Kyanah,F,100,10,0,10
Kydan,M,100,0,10,10
Kyeshia,F,100,10,0,10
Kylise,F,100,10,0,10
Kymorah,F,100,10,0,10
Kyrene,F,100,10,0,10
Kyriakos,M,100,0,10,10
Kyuss,M,100,0,10,10
Kyven,M,100,0,10,10
Laaibah,F,100,10,0,10
Labiba,F,100,10,0,10
Labrisha,F,100,10,0,10
Ladarren,M,100,0,10,10
Ladarrian,M,100,0,10,10
Ladavia,F,100,10,0,10
Laderius,M,100,0,10,10
Ladislao,M,100,0,10,10
Laighla,F,100,10,0,10
Laikin,F,100,10,0,10
Lakeishia,F,100,10,0,10
Lakela,F,100,10,0,10
Lakeland,F,50,5,5,10
Lakicia,F,100,10,0,10
Lakida,F,100,10,0,10
Lakshya,F,50,5,5,10
Lamaj,M,100,0,10,10
Lamesa,F,100,10,0,10
Lanaisha,F,100,10,0,10
Lanautica,F,100,10,0,10
Lanaysha,F,100,10,0,10
Landonn,M,100,0,10,10
Lanese,F,100,10,0,10
Laniesha,F,100,10,0,10
Lapatrick,M,100,0,10,10
Lareyna,F,100,10,0,10
Lashanti,F,100,10,0,10
Lasharn,F,100,10,0,10
Latria,F,100,10,0,10
Lattie,F,50,5,5,10
Laureano,M,100,0,10,10
Laurian,F,100,10,0,10
Lavasia,F,100,10,0,10
Laymond,M,100,0,10,10
Leeshawn,M,100,0,10,10
Leeyana,F,100,10,0,10
Leighland,M,100,0,10,10
Lekecia,F,100,10,0,10
Lemonte,M,100,0,10,10
Lemoyne,M,100,0,10,10
Lencola,F,100,10,0,10
Lendale,M,100,0,10,10
Lendel,M,100,0,10,10
Lennart,M,100,0,10,10
Leoma,F,100,10,0,10
Leonetta,F,100,10,0,10
Leorah,F,100,10,0,10
Lesleyann,F,100,10,0,10
Leslyann,F,100,10,0,10
Leticha,F,100,10,0,10
Leva,F,100,10,0,10
Lewi,M,100,0,10,10
Lexxy,F,100,10,0,10
Leyli,F,100,10,0,10
Leyona,F,100,10,0,10
Liley,F,100,10,0,10
Lillis,F,100,10,0,10
Lillyannah,F,100,10,0,10
Lisl,F,100,10,0,10
Lizardo,M,100,0,10,10
Loetta,F,100,10,0,10
Login,M,100,0,10,10
Lokelani,F,100,10,0,10
Lonzetta,F,100,10,0,10
Lopez,M,100,0,10,10
Lorik,M,100,0,10,10
Lorynn,F,100,10,0,10
Louiza,F,100,10,0,10
Luara,F,100,10,0,10
Lucindy,F,100,10,0,10
Lylla,F,100,10,0,10
Lyly,F,100,10,0,10
Lynard,M,100,0,10,10
Lynix,F,100,10,0,10
Lyzbeth,F,100,10,0,10
Macaulay,M,100,0,10,10
Maciee,F,100,10,0,10
Mackinlee,F,100,10,0,10
Maclovio,M,100,0,10,10
Madajah,F,100,10,0,10
Madeson,F,100,10,0,10
Maelea,F,100,10,0,10
Maelena,F,100,10,0,10
Magin,F,100,10,0,10
Maguadalupe,F,100,10,0,10
Mahra,F,100,10,0,10
Maileen,F,100,10,0,10
Maizen,M,100,0,10,10
Majel,F,100,10,0,10
Makael,M,100,0,10,10
Makendra,F,100,10,0,10
Makhail,M,100,0,10,10
Makinzey,F,100,10,0,10
Maleyna,F,100,10,0,10
Mamta,F,100,10,0,10
Mandolin,F,100,10,0,10
Manly,M,100,0,10,10
Manna,F,100,10,0,10
Maraiya,F,100,10,0,10
Marceil,F,100,10,0,10
Mareka,F,100,10,0,10
Marguarite,F,100,10,0,10
Marguise,M,100,0,10,10
Mariany,F,100,10,0,10
Maricsa,F,100,10,0,10
Marieanne,F,100,10,0,10
Marilea,F,100,10,0,10
Marilyne,F,100,10,0,10
Marinell,F,100,10,0,10
Mariola,F,100,10,0,10
Maripat,F,100,10,0,10
Markavious,M,100,0,10,10
Markitta,F,100,10,0,10
Marlou,F,100,10,0,10
Marlyse,F,100,10,0,10
Marq,M,100,0,10,10
Marquasha,F,100,10,0,10
Marrell,M,100,0,10,10
Martica,F,100,10,0,10
Marylynne,F,100,10,0,10
Masiela,F,100,10,0,10
Masion,M,100,0,10,10
Matheau,M,100,0,10,10
Mathhew,M,100,0,10,10
Mavin,M,100,0,10,10
Maxxim,M,100,0,10,10
Mayanna,F,100,10,0,10
Maybrie,F,100,10,0,10
Mayerli,F,100,10,0,10
Mayka,F,100,10,0,10
Maylah,F,100,10,0,10
Mazlyn,F,100,10,0,10
Mccade,M,100,0,10,10
Mccain,M,100,0,10,10
Mckenleigh,F,100,10,0,10
Mckenze,F,100,10,0,10
Mckinlie,F,100,10,0,10
Mckinze,F,100,10,0,10
Meade,M,100,0,10,10
Meba,M,100,0,10,10
Mega,F,100,10,0,10
Megh,M,100,0,10,10
Meike,F,100,10,0,10
Meilynn,F,100,10,0,10
Mekaela,F,100,10,0,10
Mekah,F,100,10,0,10
Melaya,F,100,10,0,10
Meldon,M,100,0,10,10
Melisssa,F,100,10,0,10
Merribeth,F,100,10,0,10
Meshack,M,100,0,10,10
Mete,M,100,0,10,10
Mianicole,F,100,10,0,10
Mic,M,100,0,10,10
Michaelangel,M,100,0,10,10
Michaelpaul,M,100,0,10,10
Miche,F,100,10,0,10
Midas,M,100,0,10,10
Mihailo,M,100,0,10,10
Mikenzy,F,100,10,0,10
Mikhala,F,100,10,0,10
Miliah,F,100,10,0,10
Milie,F,100,10,0,10
Milley,F,100,10,0,10
Mirasol,F,100,10,0,10
Mireyli,F,100,10,0,10
Mirical,F,100,10,0,10
Misato,F,100,10,0,10
Mishele,F,100,10,0,10
Mistique,F,100,10,0,10
Mithran,M,100,0,10,10
Miyani,F,100,10,0,10
Molinda,F,100,10,0,10
Momar,M,100,0,10,10
Monick,F,100,10,0,10
Monise,F,100,10,0,10
Monserath,F,100,10,0,10
Montarious,M,100,0,10,10
Montique,F,50,5,5,10
Montravious,M,100,0,10,10
Monyette,F,100,10,0,10
Morgon,F,50,5,5,10
Morning,F,100,10,0,10
Motty,M,100,0,10,10
Murrel,M,100,0,10,10
Murvin,M,100,0,10,10
Myaire,F,50,5,5,10
Myishia,F,100,10,0,10
Mylisa,F,100,10,0,10
Myndi,F,100,10,0,10
Myrian,F,100,10,0,10
Mystee,F,100,10,0,10
Naamah,F,100,10,0,10
Nadea,F,100,10,0,10
Naftula,M,100,0,10,10
Naidelin,F,100,10,0,10
Naiylah,F,100,10,0,10
Naje,F,100,10,0,10
Nakeyia,F,100,10,0,10
Naleia,F,100,10,0,10
Nanayaw,M,100,0,10,10
Nancylee,F,100,10,0,10
Naome,F,100,10,0,10
Naporsha,F,100,10,0,10
Narai,F,100,10,0,10
Nathaiel,M,100,0,10,10
Natilynn,F,100,10,0,10
Naylen,F,50,5,5,10
Nazaire,M,100,0,10,10
Nazeef,M,100,0,10,10
Nazirah,F,100,10,0,10
Nedal,M,100,0,10,10
Neeti,F,100,10,0,10
Negeen,F,100,10,0,10
Nehemiyah,M,100,0,10,10
Neisa,F,100,10,0,10
Nekeya,F,100,10,0,10
Nelani,F,100,10,0,10
Nello,M,100,0,10,10
Nicholad,M,100,0,10,10
Nicholous,M,100,0,10,10
Nickelle,F,100,10,0,10
Nicoles,M,100,0,10,10
Nicolia,F,100,10,0,10
Nikcole,F,100,10,0,10
Nilton,M,100,0,10,10
Ninel,F,100,10,0,10
Ninna,F,100,10,0,10
Niome,F,100,10,0,10
Nivaeh,F,100,10,0,10
Noahgabriel,M,100,0,10,10
Noman,M,100,0,10,10
Norville,M,100,0,10,10
Nouran,F,100,10,0,10
Novalyn,F,100,10,0,10
Nusaibah,F,100,10,0,10
Nussen,M,100,0,10,10
Nyan,M,100,0,10,10
Nyeema,F,100,10,0,10
Nyell,F,100,10,0,10
Nygeria,F,100,10,0,10
Nykerria,F,100,10,0,10
Nylen,M,100,0,10,10
Nylene,F,100,10,0,10
Nzuri,F,100,10,0,10
Obediah,M,100,0,10,10
Oceania,F,100,10,0,10
Odean,F,100,10,0,10
Ofir,M,100,0,10,10
Olukemi,F,100,10,0,10
Oluwadara,F,100,10,0,10
Oluwajomiloju,F,100,10,0,10
Omnia,F,100,10,0,10
Ondine,F,100,10,0,10
Othel,M,100,0,10,10
Ova,F,50,5,5,10
Par,F,100,10,0,10
Payzley,F,100,10,0,10
Pecola,F,100,10,0,10
Peggye,F,100,10,0,10
Pele,M,100,0,10,10
Penelopi,F,100,10,0,10
Phadra,F,100,10,0,10
Phoebie,F,100,10,0,10
Piedad,F,100,10,0,10
Pincus,M,100,0,10,10
Poe,F,50,5,5,10
Ponce,M,100,0,10,10
Pranshu,M,100,0,10,10
Quamain,M,100,0,10,10
Quatavious,M,100,0,10,10
Quentavius,M,100,0,10,10
Quinnetta,F,100,10,0,10
Quy,M,100,0,10,10
Racquell,F,100,10,0,10
Radin,M,100,0,10,10
Radiya,F,100,10,0,10
Radwan,M,100,0,10,10
Raeqwon,M,100,0,10,10
Raghib,M,100,0,10,10
Rahm,M,100,0,10,10
Ralanda,F,100,10,0,10
Ramah,F,100,10,0,10
Ramari,M,100,0,10,10
Ramesses,M,100,0,10,10
Ramina,F,100,10,0,10
Randahl,M,100,0,10,10
Rangel,M,100,0,10,10
Ranika,F,100,10,0,10
Ranna,F,100,10,0,10
Ranyia,F,100,10,0,10
Raqueal,F,100,10,0,10
Rawn,M,100,0,10,10
Raylena,F,100,10,0,10
Raynald,M,100,0,10,10
Raynna,F,100,10,0,10
Rayshawna,F,100,10,0,10
Reata,F,100,10,0,10
Reemas,F,100,10,0,10
Reeshemah,F,100,10,0,10
Reg,M,100,0,10,10
Reggy,M,100,0,10,10
Regie,M,100,0,10,10
Rehman,M,100,0,10,10
Reino,M,100,0,10,10
Renauda,F,100,10,0,10
Renel,F,100,10,0,10
Reshell,F,100,10,0,10
Retia,F,100,10,0,10
Reynald,M,100,0,10,10
Rhandy,M,100,0,10,10
Rhemy,F,50,5,5,10
Rhiann,F,100,10,0,10
Rickiyah,F,100,10,0,10
Riham,F,100,10,0,10
Rijul,M,100,0,10,10
Rikka,F,100,10,0,10
Rilei,F,100,10,0,10
Rily,F,100,10,0,10
Rindy,F,100,10,0,10
Rinka,F,100,10,0,10
Rjay,M,100,0,10,10
Rodie,M,100,0,10,10
Roey,M,100,0,10,10
Rohail,M,100,0,10,10
Rohil,M,100,0,10,10
Roise,F,100,10,0,10
Rollen,M,100,0,10,10
Romaisa,F,100,10,0,10
Roneka,F,100,10,0,10
Rontez,M,100,0,10,10
Roshanna,F,100,10,0,10
Rosslynn,F,100,10,0,10
Rosyln,F,100,10,0,10
Rowe,M,100,0,10,10
Rozelle,F,50,5,5,10
Rudine,F,100,10,0,10
Ruhama,F,100,10,0,10
Ruqayah,F,100,10,0,10
Ruther,F,100,10,0,10
Ryiah,F,100,10,0,10
Ryian,F,50,5,5,10
Ryman,M,100,0,10,10
Ryosuke,M,100,0,10,10
Saarim,M,100,0,10,10
Saaya,F,100,10,0,10
Sabion,M,100,0,10,10
Sacora,F,100,10,0,10
Sacoya,F,100,10,0,10
Sadler,M,100,0,10,10
Safir,M,100,0,10,10
Saiyan,M,100,0,10,10
Sajad,M,100,0,10,10
Sala,F,100,10,0,10
Sambhav,M,100,0,10,10
Sametra,F,100,10,0,10
Samiria,F,100,10,0,10
Sammatha,F,100,10,0,10
Samrawit,F,100,10,0,10
Samuelle,M,100,0,10,10
Sanaai,F,100,10,0,10
Sandrina,F,100,10,0,10
Sanil,M,100,0,10,10
Sanjiv,M,100,0,10,10
Sanora,F,100,10,0,10
Sanvika,F,100,10,0,10
Saraia,F,100,10,0,10
Sashank,M,100,0,10,10
Satira,F,100,10,0,10
Satsuki,F,100,10,0,10
Savannahlynn,F,100,10,0,10
Savhanna,F,100,10,0,10
Savitri,F,100,10,0,10
Savonne,F,50,5,5,10
Scarlettrose,F,100,10,0,10
Selisa,F,100,10,0,10
Semhal,F,100,10,0,10
Sen,M,100,0,10,10
Serani,M,100,0,10,10
Sevasti,F,100,10,0,10
Shadin,F,100,10,0,10
Shaeley,F,100,10,0,10
Shahira,F,100,10,0,10
Shalaunda,F,100,10,0,10
Shalen,F,100,10,0,10
Shalissa,F,100,10,0,10
Shambria,F,100,10,0,10
Shameaka,F,100,10,0,10
Shamelia,F,100,10,0,10
Shamonique,F,100,10,0,10
Shamsuddin,M,100,0,10,10
Shandelle,F,100,10,0,10
Shaneese,F,100,10,0,10
Shanetha,F,100,10,0,10
Shannae,F,100,10,0,10
Shantana,F,100,10,0,10
Shantavious,F,100,10,0,10
Shaquayla,F,100,10,0,10
Sharilynn,F,100,10,0,10
Sharnise,F,100,10,0,10
Shastina,F,100,10,0,10
Shatonga,F,100,10,0,10
Shatora,F,100,10,0,10
Shaula,F,100,10,0,10
Shaunt,M,100,0,10,10
Shauntal,F,100,10,0,10
Shavna,F,100,10,0,10
Shavy,F,100,10,0,10
Shawndale,M,100,0,10,10
Shawntrell,F,100,10,0,10
Shaynah,F,100,10,0,10
Shayvonne,F,100,10,0,10
Shellina,F,100,10,0,10
Shelvin,M,100,0,10,10
Shemicka,F,100,10,0,10
Sheraya,F,100,10,0,10
Shereece,F,100,10,0,10
Sheriah,F,100,10,0,10
Sheridyn,F,100,10,0,10
Sherisa,F,100,10,0,10
Sherissa,F,100,10,0,10
Shermar,M,100,0,10,10
Sherol,F,100,10,0,10
Sherray,F,100,10,0,10
Sherricka,F,100,10,0,10
Shevawn,F,100,10,0,10
Sheya,M,100,0,10,10
Shilla,F,100,10,0,10
Shiny,F,100,10,0,10
Shivank,M,100,0,10,10
Shunna,F,100,10,0,10
Shykeem,M,100,0,10,10
Shyrone,M,100,0,10,10
Sigal,F,100,10,0,10
Siniya,F,100,10,0,10
Sionna,F,100,10,0,10
Skylla,F,100,10,0,10
Slayter,M,100,0,10,10
Snezana,F,100,10,0,10
Sochi,F,100,10,0,10
Solay,F,100,10,0,10
Somya,F,100,10,0,10
Sondi,F,100,10,0,10
Sonnia,F,100,10,0,10
Sopheap,F,50,5,5,10
Sophianna,F,100,10,0,10
Soryn,F,50,5,5,10
Spyridon,M,100,0,10,10
Sricharan,M,100,0,10,10
Srihita,F,100,10,0,10
Staccato,M,100,0,10,10
Starleigh,F,100,10,0,10
Starletta,F,100,10,0,10
Stephaun,M,100,0,10,10
Stihl,M,100,0,10,10
Subhana,F,100,10,0,10
Suheyla,F,100,10,0,10
Sukayna,F,100,10,0,10
Sukhman,F,50,5,5,10
Sumi,F,100,10,0,10
Sya,F,100,10,0,10
Syeed,M,100,0,10,10
Symere,M,100,0,10,10
Tahel,F,100,10,0,10
Taiyana,F,100,10,0,10
Taiyari,F,100,10,0,10
Tajma,F,100,10,0,10
Takylah,F,100,10,0,10
Taleesa,F,100,10,0,10
Tamaris,F,100,10,0,10
Tamboura,F,50,5,5,10
Tameaka,F,100,10,0,10
Tamecka,F,100,10,0,10
Tamella,F,100,10,0,10
Tameron,F,50,5,5,10
Taneah,F,100,10,0,10
Taneia,F,100,10,0,10
Tanesa,F,100,10,0,10
Tangula,F,100,10,0,10
Tanley,F,100,10,0,10
Tarajii,F,100,10,0,10
Tarquin,M,100,0,10,10
Tarrin,M,100,0,10,10
Tashaya,F,100,10,0,10
Tayen,F,100,10,0,10
Taze,M,100,0,10,10
Teadra,F,100,10,0,10
Tearia,F,100,10,0,10
Tehreem,F,100,10,0,10
Telsa,F,100,10,0,10
Tema,F,100,10,0,10
Temesgen,M,100,0,10,10
Temesha,F,100,10,0,10
Tenzing,M,100,0,10,10
Terrice,F,100,10,0,10
Tewanda,F,100,10,0,10
Theona,F,100,10,0,10
Thoran,M,100,0,10,10
Thorian,M,100,0,10,10
Tiam,M,100,0,10,10
Tierza,F,100,10,0,10
Tiffanye,F,100,10,0,10
Tildon,M,100,0,10,10
Tilisha,F,100,10,0,10
Timarie,F,100,10,0,10
Timira,F,100,10,0,10
Tine,F,100,10,0,10
Tinea,F,100,10,0,10
Tirth,M,100,0,10,10
Tniya,F,100,10,0,10
Tomia,F,100,10,0,10
Tommas,M,100,0,10,10
Tonishia,F,100,10,0,10
Tonye,F,100,10,0,10
Torianne,F,100,10,0,10
Torilynn,F,100,10,0,10
Toronda,F,100,10,0,10
Toshika,F,100,10,0,10
Trajen,M,100,0,10,10
Tramane,M,100,0,10,10
Trance,M,100,0,10,10
Tranise,F,100,10,0,10
Trasean,M,100,0,10,10
Trashaun,M,100,0,10,10
Tretha,F,100,10,0,10
Trevante,M,100,0,10,10
Treyana,F,100,10,0,10
Treycen,M,100,0,10,10
Triena,F,100,10,0,10
Trinese,F,100,10,0,10
Trinetta,F,100,10,0,10
Trinitty,F,100,10,0,10
Trintin,M,100,0,10,10
Tristany,F,100,10,0,10
Troya,F,100,10,0,10
Tura,F,100,10,0,10
Tyajah,F,100,10,0,10
Tyheim,M,100,0,10,10
Tyhir,M,100,0,10,10
Tyme,F,50,5,5,10
Tyniesha,F,100,10,0,10
Tynslee,F,100,10,0,10
Tyrec,M,100,0,10,10
Tysa,F,100,10,0,10
Unika,F,100,10,0,10
Unita,F,100,10,0,10
Usha,F,100,10,0,10
Valerya,F,100,10,0,10
Vali,F,50,5,5,10
Vanae,F,100,10,0,10
Vasilia,F,100,10,0,10
Vatsal,M,100,0,10,10
Vaun,M,100,0,10,10
Veatrice,F,100,10,0,10
Venba,F,100,10,0,10
Venesa,F,100,10,0,10
Venia,F,100,10,0,10
Veretta,F,100,10,0,10
Verneice,F,100,10,0,10
Victoralfonso,M,100,0,10,10
Viraat,M,100,0,10,10
Viya,F,100,10,0,10
Vontez,M,100,0,10,10
Wareesha,F,100,10,0,10
Waylyn,M,100,0,10,10
Wilene,F,100,10,0,10
Xaidyn,M,100,0,10,10
Xiamara,F,100,10,0,10
Xin,F,100,10,0,10
Xzaiver,M,100,0,10,10
Yacqub,M,100,0,10,10
Yadir,M,100,0,10,10
Yahav,F,50,5,5,10
Yamel,F,100,10,0,10
Yancarlo,M,100,0,10,10
Yanelie,F,100,10,0,10
Yanin,F,100,10,0,10
Yanitzia,F,100,10,0,10
Yarisa,F,100,10,0,10
Yaritsa,F,100,10,0,10
Yeilen,F,100,10,0,10
Yelissa,F,100,10,0,10
Yenni,F,100,10,0,10
Yesena,F,100,10,0,10
Yesennia,F,100,10,0,10
Yetzael,M,100,0,10,10
Yicel,F,100,10,0,10
Yiran,F,50,5,5,10
Yixuan,F,100,10,0,10
Yordin,M,100,0,10,10
Yoscar,M,100,0,10,10
Yuan,M,100,0,10,10
Yugo,M,100,0,10,10
Yukta,F,100,10,0,10
Yuktha,F,100,10,0,10
Yuleni,F,100,10,0,10
Zabriel,M,100,0,10,10
Zahniya,F,100,10,0,10
Zahriya,F,100,10,0,10
Zaileigh,F,100,10,0,10
Zaionna,F,100,10,0,10
Zakarian,M,100,0,10,10
Zamauria,F,100,10,0,10
Zameria,F,100,10,0,10
Zarak,M,100,0,10,10
Zaray,F,100,10,0,10
Zarhia,F,100,10,0,10
Zaveion,M,100,0,10,10
Zaviera,F,100,10,0,10
Zay,M,100,0,10,10
Zayvin,M,100,0,10,10
Zell,F,50,5,5,10
Zerah,F,100,10,0,10
Zhariyah,F,100,10,0,10
Zierre,M,100,0,10,10
Ziyona,F,100,10,0,10
Zoeyann,F,100,10,0,10
Zolee,F,100,10,0,10
Zorana,F,100,10,0,10
Zoriana,F,100,10,0,10
Zorita,F,100,10,0,10
Zulie,F,100,10,0,10
Zurii,F,100,10,0,10
Zyanah,F,100,10,0,10
Zygmunt,M,100,0,10,10
Zyheim,M,100,0,10,10
Zylie,F,100,10,0,10
Zylynn,F,100,10,0,10
Zyquavious,M,100,0,10,10
Zyran,M,100,0,10,10
Zyrihanna,F,100,10,0,10
Zyrus,M,100,0,10,10
Aabha,F,100,9,0,9
Aadith,M,100,0,9,9
Aadon,M,100,0,9,9
Aaidyn,M,100,0,9,9
Aakriti,F,100,9,0,9
Aalani,F,100,9,0,9
Aalayna,F,100,9,0,9
Aariyana,F,100,9,0,9
Aarsh,M,100,0,9,9
Aaylah,F,100,9,0,9
Aayliah,F,100,9,0,9
Aaziyah,F,100,9,0,9
Abbygael,F,100,9,0,9
Abdihafid,M,100,0,9,9
Abdishakur,M,100,0,9,9
Adagio,M,100,0,9,9
Adalida,F,100,9,0,9
Adalys,F,100,9,0,9
Adeliah,F,100,9,0,9
Aderinsola,F,100,9,0,9
Adhav,M,100,0,9,9
Adline,F,100,9,0,9
Adreona,F,100,9,0,9
Adryen,M,100,0,9,9
Adylen,F,100,9,0,9
Adylynn,F,100,9,0,9
Ahking,M,100,0,9,9
Ahmarie,F,100,9,0,9
Ahmyra,F,100,9,0,9
Ahrian,M,100,0,9,9
Ahriya,F,100,9,0,9
Aimon,M,100,0,9,9
Aishi,F,100,9,0,9
Aislee,F,100,9,0,9
Ajiah,F,100,9,0,9
Akilan,M,100,0,9,9
Alancia,F,100,9,0,9
Alann,M,100,0,9,9
Alantis,F,100,9,0,9
Alcindor,M,100,0,9,9
Aldean,F,100,9,0,9
Aleska,F,100,9,0,9
Alissah,F,100,9,0,9
Aliyiah,F,100,9,0,9
Alizayah,F,100,9,0,9
Allysandra,F,100,9,0,9
Alvonte,M,100,0,9,9
Alyaan,M,100,0,9,9
Alyssamae,F,100,9,0,9
Ambrianna,F,100,9,0,9
Ameah,F,100,9,0,9
Ameet,M,100,0,9,9
Ameilya,F,100,9,0,9
Amelda,F,100,9,0,9
Ameriyah,F,100,9,0,9
Amiere,M,100,0,9,9
Amisadai,F,100,9,0,9
Amiylah,F,100,9,0,9
Amunet,F,100,9,0,9
Amyna,F,100,9,0,9
Anabrenda,F,100,9,0,9
Anakarina,F,100,9,0,9
Analah,F,100,9,0,9
Anapatricia,F,100,9,0,9
Anautica,F,100,9,0,9
Anayaa,F,100,9,0,9
Angelinne,F,100,9,0,9
Angellia,F,100,9,0,9
Anir,M,100,0,9,9
Anivea,F,100,9,0,9
Anjalie,F,100,9,0,9
Anjolina,F,100,9,0,9
Annalisha,F,100,9,0,9
Annjanette,F,100,9,0,9
Anthone,M,100,0,9,9
Antonela,F,100,9,0,9
Antwonne,M,100,0,9,9
Anubis,M,100,0,9,9
Anushri,F,100,9,0,9
Anwesha,F,100,9,0,9
Aowyn,F,100,9,0,9
Apiffany,F,100,9,0,9
Araiza,F,100,9,0,9
Arata,M,100,0,9,9
Ardeth,F,100,9,0,9
Arietta,F,100,9,0,9
Ariq,M,100,0,9,9
Ark,M,100,0,9,9
Arlanda,F,100,9,0,9
Arlita,F,100,9,0,9
Armonee,F,100,9,0,9
Arpil,F,100,9,0,9
Asberry,M,100,0,9,9
Atzi,F,100,9,0,9
Aubreelynn,F,100,9,0,9
Audreyann,F,100,9,0,9
Aunyae,F,100,9,0,9
Auriah,F,100,9,0,9
Avagail,F,100,9,0,9
Averleigh,F,100,9,0,9
Avienda,F,100,9,0,9
Avryl,F,100,9,0,9
Axiel,M,100,0,9,9
Aybrie,F,100,9,0,9
Aydain,M,100,0,9,9
Aylina,F,100,9,0,9
Ayrah,F,100,9,0,9
Azahria,F,100,9,0,9
Azayvion,M,100,0,9,9
Azizah,F,100,9,0,9
Aztlan,M,100,0,9,9
Azusa,F,100,9,0,9
Azzie,F,100,9,0,9
Babbette,F,100,9,0,9
Bassheva,F,100,9,0,9
Bayyinah,F,100,9,0,9
Bearett,M,100,0,9,9
Bellamie,F,100,9,0,9
Belmin,M,100,0,9,9
Bennetta,F,100,9,0,9
Berenize,F,100,9,0,9
Berke,M,100,0,9,9
Bernetha,F,100,9,0,9
Besnik,M,100,0,9,9
Bianica,F,100,9,0,9
Bilma,F,100,9,0,9
Binnie,F,100,9,0,9
Birda,F,100,9,0,9
Blerta,F,100,9,0,9
Bogar,M,100,0,9,9
Bohden,M,100,0,9,9
Bond,M,100,0,9,9
Borach,M,100,0,9,9
Braeley,F,100,9,0,9
Brailon,M,100,0,9,9
Breale,F,100,9,0,9
Breighanna,F,100,9,0,9
Brelon,M,100,0,9,9
Brenham,M,100,0,9,9
Breseis,F,100,9,0,9
Bretley,M,100,0,9,9
Breuna,F,100,9,0,9
Briggston,M,100,0,9,9
Brisha,F,100,9,0,9
Brittannie,F,100,9,0,9
Brittnae,F,100,9,0,9
Brittnea,F,100,9,0,9
Broady,M,100,0,9,9
Brodan,M,100,0,9,9
Bronwynn,F,100,9,0,9
Bryla,F,100,9,0,9
Caasi,F,100,9,0,9
Cabria,F,100,9,0,9
Cadarrius,M,100,0,9,9
Calii,F,100,9,0,9
Calirae,F,100,9,0,9
Calirose,F,100,9,0,9
Calisi,F,100,9,0,9
Caly,F,100,9,0,9
Cameka,F,100,9,0,9
Camery,F,100,9,0,9
Camika,F,100,9,0,9
Capree,F,100,9,0,9
Carbon,M,100,0,9,9
Caree,F,100,9,0,9
Carenda,F,100,9,0,9
Carnelius,M,100,0,9,9
Carnisha,F,100,9,0,9
Carwyn,M,100,0,9,9
Caryle,F,100,9,0,9
Casara,F,100,9,0,9
Casarah,F,100,9,0,9
Casha,F,100,9,0,9
Cassundra,F,100,9,0,9
Catalea,F,100,9,0,9
Cayton,M,100,0,9,9
Cecili,F,100,9,0,9
Celiana,F,100,9,0,9
Cerinity,F,100,9,0,9
Ceylin,F,100,9,0,9
Champale,F,100,9,0,9
Chamya,F,100,9,0,9
Chardonay,F,100,9,0,9
Chariyah,F,100,9,0,9
Charne,F,100,9,0,9
Charnee,F,100,9,0,9
Chaske,M,100,0,9,9
Chavone,F,100,9,0,9
Chayah,F,100,9,0,9
Chaysen,M,100,0,9,9
Ched,M,100,0,9,9
Cheniece,F,100,9,0,9
Chenoah,F,100,9,0,9
Cheriese,F,100,9,0,9
Chiante,F,100,9,0,9
Chinara,F,100,9,0,9
Chinasa,F,100,9,0,9
Chloi,F,100,9,0,9
Chonita,F,100,9,0,9
Christean,F,100,9,0,9
Chynia,F,100,9,0,9
Ciclaly,F,100,9,0,9
Cicley,F,100,9,0,9
Ciji,F,100,9,0,9
Clairabelle,F,100,9,0,9
Claudis,M,100,0,9,9
Clois,M,100,0,9,9
Clydene,F,100,9,0,9
Cniyah,F,100,9,0,9
Codylee,M,100,0,9,9
Copelynn,F,100,9,0,9
Coralei,F,100,9,0,9
Cordera,M,100,0,9,9
Corrion,M,100,0,9,9
Corvette,F,100,9,0,9
Cosmos,M,100,0,9,9
Courtne,F,100,9,0,9
Creedon,M,100,0,9,9
Crys,F,100,9,0,9
Crystianna,F,100,9,0,9
Cyson,M,100,0,9,9
Cystal,F,100,9,0,9
Dahlya,F,100,9,0,9
Daiya,F,100,9,0,9
Daleysha,F,100,9,0,9
Daleyzah,F,100,9,0,9
Dalyah,F,100,9,0,9
Damini,F,100,9,0,9
Danari,M,100,0,9,9
Daneesha,F,100,9,0,9
Danek,M,100,0,9,9
Danequa,F,100,9,0,9
Danielly,F,100,9,0,9
Danielys,F,100,9,0,9
Danyon,M,100,0,9,9
Danzig,M,100,0,9,9
Daquavious,M,100,0,9,9
Dariann,F,100,9,0,9
Darlette,F,100,9,0,9
Darrington,M,100,0,9,9
Darrio,M,100,0,9,9
Darryal,M,100,0,9,9
Dashanti,F,100,9,0,9
Dasja,F,100,9,0,9
Daveney,F,100,9,0,9
Dawt,F,100,9,0,9
Dayanira,F,100,9,0,9
Dayceon,M,100,0,9,9
Dayln,M,100,0,9,9
Daymen,M,100,0,9,9
Dazariah,F,100,9,0,9
Deaisa,F,100,9,0,9
Deborh,F,100,9,0,9
Decklen,M,100,0,9,9
Decota,M,100,0,9,9
Deddrick,M,100,0,9,9
Deiondra,F,100,9,0,9
Dekhari,M,100,0,9,9
Delance,M,100,0,9,9
Delenn,F,100,9,0,9
Dellon,M,100,0,9,9
Deontrey,M,100,0,9,9
Dequavius,M,100,0,9,9
Deridre,F,100,9,0,9
Derrico,M,100,0,9,9
Derrisha,F,100,9,0,9
Desarea,F,100,9,0,9
Deshundra,F,100,9,0,9
Destenee,F,100,9,0,9
Destony,F,100,9,0,9
Devoe,M,100,0,9,9
Devory,F,100,9,0,9
Devota,F,100,9,0,9
Devun,M,100,0,9,9
Deward,M,100,0,9,9
Deysha,F,100,9,0,9
Dezaria,F,100,9,0,9
Dezyrae,F,100,9,0,9
Dhillon,M,100,0,9,9
Dhrithi,F,100,9,0,9
Dim,F,100,9,0,9
Dionysios,M,100,0,9,9
Dipesh,M,100,0,9,9
Dmani,M,100,0,9,9
Dnasia,F,100,9,0,9
Dobie,M,100,0,9,9
Dollene,F,100,9,0,9
Domingue,M,100,0,9,9
Donda,F,100,9,0,9
Dontasia,F,100,9,0,9
Dontreal,M,100,0,9,9
Donzaleigh,F,100,9,0,9
Dorianna,F,100,9,0,9
Drayah,F,100,9,0,9
Dreshon,M,100,0,9,9
Dulcey,F,100,9,0,9
Dymin,F,100,9,0,9
Dynette,F,100,9,0,9
Eames,M,100,0,9,9
Ecrin,F,100,9,0,9
Edahi,M,100,0,9,9
Edis,M,100,0,9,9
Edwinna,F,100,9,0,9
Elanora,F,100,9,0,9
Elbia,F,100,9,0,9
Elean,M,100,0,9,9
Eleasha,F,100,9,0,9
Elion,M,100,0,9,9
Ellenmarie,F,100,9,0,9
Ellieann,F,100,9,0,9
Ellodie,F,100,9,0,9
Elnor,F,100,9,0,9
Elsey,F,100,9,0,9
Elyannah,F,100,9,0,9
Emanuelly,F,100,9,0,9
Emera,F,100,9,0,9
Emmaree,F,100,9,0,9
Enner,M,100,0,9,9
Eryanna,F,100,9,0,9
Esbeydi,F,100,9,0,9
Eshe,F,100,9,0,9
Esmirna,F,100,9,0,9
Essiah,M,100,0,9,9
Estera,F,100,9,0,9
Ether,F,100,9,0,9
Eulis,M,100,0,9,9
Evelet,F,100,9,0,9
Evelise,F,100,9,0,9
Everlea,F,100,9,0,9
Eyas,M,100,0,9,9
Ezmay,F,100,9,0,9
Faithmarie,F,100,9,0,9
Fard,M,100,0,9,9
Fermina,F,100,9,0,9
Ferrel,M,100,0,9,9
Finas,M,100,0,9,9
Finna,F,100,9,0,9
Finnan,M,100,0,9,9
Finnly,M,100,0,9,9
Firdaus,F,100,9,0,9
Fiyinfoluwa,F,100,9,0,9
Flamur,M,100,0,9,9
Flormaria,F,100,9,0,9
Foye,M,100,0,9,9
Frayda,F,100,9,0,9
Fredna,F,100,9,0,9
Frey,M,100,0,9,9
Garrus,M,100,0,9,9
Genesa,F,100,9,0,9
Geniah,F,100,9,0,9
Gerrica,F,100,9,0,9
Gesenia,F,100,9,0,9
Gianlucca,M,100,0,9,9
Gidgett,F,100,9,0,9
Giona,F,100,9,0,9
Giorgi,M,100,0,9,9
Gladystine,F,100,9,0,9
Glenys,F,100,9,0,9
Gowri,F,100,9,0,9
Graycelynn,F,100,9,0,9
Greydi,F,100,9,0,9
Haaziq,M,100,0,9,9
Haim,M,100,0,9,9
Hallah,F,100,9,0,9
Haloa,M,100,0,9,9
Haly,F,100,9,0,9
Harshika,F,100,9,0,9
Hatem,M,100,0,9,9
Hawra,F,100,9,0,9
Hildreth,F,100,9,0,9
Hollianne,F,100,9,0,9
Hooria,F,100,9,0,9
Hulen,M,100,0,9,9
Huntter,M,100,0,9,9
Hydeia,F,100,9,0,9
Ianthe,F,100,9,0,9
Ibrohim,M,100,0,9,9
Ikesha,F,100,9,0,9
Illene,F,100,9,0,9
Indianna,F,100,9,0,9
Ingra,F,100,9,0,9
Inis,F,100,9,0,9
Inisha,F,100,9,0,9
Ishya,F,100,9,0,9
Ismenia,F,100,9,0,9
Ivalee,F,100,9,0,9
Izma,F,100,9,0,9
Jacklene,F,100,9,0,9
Jacquette,F,100,9,0,9
Jadakis,M,100,0,9,9
Jader,M,100,0,9,9
Jadyen,M,100,0,9,9
Jaesha,F,100,9,0,9
Jahne,F,100,9,0,9
Jahnelle,F,100,9,0,9
Jahsai,M,100,0,9,9
Jahzier,M,100,0,9,9
Jahzir,M,100,0,9,9
Jaileigh,F,100,9,0,9
Jaiyda,F,100,9,0,9
Jakwan,M,100,0,9,9
Jalacia,F,100,9,0,9
Jaleshia,F,100,9,0,9
Jalessia,F,100,9,0,9
Jaleyza,F,100,9,0,9
Jamanda,F,100,9,0,9
Jameon,M,100,0,9,9
Jamesedward,M,100,0,9,9
Jamikal,M,100,0,9,9
Jamiria,F,100,9,0,9
Jamonta,M,100,0,9,9
Jamora,F,100,9,0,9
Janal,F,100,9,0,9
Japleen,F,100,9,0,9
Jaqualyn,M,100,0,9,9
Jaquanda,F,100,9,0,9
Jarielle,F,100,9,0,9
Jarquavious,M,100,0,9,9
Jarriel,M,100,0,9,9
Jashay,F,100,9,0,9
Jasminn,F,100,9,0,9
Jasniel,M,100,0,9,9
Jasnoor,F,100,9,0,9
Javeyah,F,100,9,0,9
Jayco,M,100,0,9,9
Jaydie,F,100,9,0,9
Jayleana,F,100,9,0,9
Jaymason,M,100,0,9,9
Jazariyah,F,100,9,0,9
Jeanet,F,100,9,0,9
Jeleesa,F,100,9,0,9
Jemiah,F,100,9,0,9
Jendaya,F,100,9,0,9
Jeneice,F,100,9,0,9
Jennamarie,F,100,9,0,9
Jenniferann,F,100,9,0,9
Jerimey,M,100,0,9,9
Jermall,M,100,0,9,9
Jermia,F,100,9,0,9
Jerrimiah,M,100,0,9,9
Jerrius,M,100,0,9,9
Jessicalynn,F,100,9,0,9
Jessilynn,F,100,9,0,9
Jeven,M,100,0,9,9
Jhaniyah,F,100,9,0,9
Jie,M,100,0,9,9
Jinna,F,100,9,0,9
Jinora,F,100,9,0,9
Joandry,M,100,0,9,9
Joathan,M,100,0,9,9
Johnika,F,100,9,0,9
Jomarion,M,100,0,9,9
Joneric,M,100,0,9,9
Jonuel,M,100,0,9,9
Joory,F,100,9,0,9
Josehua,M,100,0,9,9
Josiahs,M,100,0,9,9
Jossiel,M,100,0,9,9
Juanika,F,100,9,0,9
Judithe,F,100,9,0,9
Juleena,F,100,9,0,9
Julena,F,100,9,0,9
Juridia,F,100,9,0,9
Juriel,M,100,0,9,9
Kadasha,F,100,9,0,9
Kahmora,F,100,9,0,9
Kaikane,M,100,0,9,9
Kainat,F,100,9,0,9
Kalirose,F,100,9,0,9
Kallysta,F,100,9,0,9
Kamauria,F,100,9,0,9
Kaneeshia,F,100,9,0,9
Kaneka,F,100,9,0,9
Kaniqua,F,100,9,0,9
Kaoir,F,100,9,0,9
Karess,F,100,9,0,9
Karlissa,F,100,9,0,9
Kashayla,F,100,9,0,9
Kassadi,F,100,9,0,9
Kataleia,F,100,9,0,9
Kathaleya,F,100,9,0,9
Katira,F,100,9,0,9
Kaveah,F,100,9,0,9
Kavonte,M,100,0,9,9
Kaydience,F,100,9,0,9
Kayleanna,F,100,9,0,9
Kayleeana,F,100,9,0,9
Kaynon,M,100,0,9,9
Kazoua,F,100,9,0,9
Keaisa,F,100,9,0,9
Keantae,M,100,0,9,9
Kearrah,F,100,9,0,9
Kedeem,M,100,0,9,9
Keerica,F,100,9,0,9
Keirston,F,100,9,0,9
Kemely,F,100,9,0,9
Kenaan,M,100,0,9,9
Kentlee,F,100,9,0,9
Keontre,M,100,0,9,9
Kevondre,M,100,0,9,9
Khailyn,F,100,9,0,9
Khennedi,F,100,9,0,9
Khilynn,F,100,9,0,9
Khrysten,F,100,9,0,9
Khup,M,100,0,9,9
Khyia,F,100,9,0,9
Khyrin,M,100,0,9,9
Kiahnna,F,100,9,0,9
Kiaja,F,100,9,0,9
Kiere,M,100,0,9,9
Kierstie,F,100,9,0,9
Kiira,F,100,9,0,9
Kijani,M,100,0,9,9
Kimbrly,F,100,9,0,9
Kimothy,M,100,0,9,9
Kingsly,M,100,0,9,9
Kinlyn,F,100,9,0,9
Kinslei,F,100,9,0,9
Kiria,F,100,9,0,9
Kirollos,M,100,0,9,9
Kix,M,100,0,9,9
Kiyaan,M,100,0,9,9
Knightley,F,100,9,0,9
Kohan,M,100,0,9,9
Kohlson,M,100,0,9,9
Korayma,F,100,9,0,9
Korrah,F,100,9,0,9
Krishonda,F,100,9,0,9
Kristyanna,F,100,9,0,9
Kuba,M,100,0,9,9
Kutler,M,100,0,9,9
Kyira,F,100,9,0,9
Kynesha,F,100,9,0,9
Kyrstal,F,100,9,0,9
Kyryn,M,100,0,9,9
Lagretta,F,100,9,0,9
Lais,F,100,9,0,9
Lakena,F,100,9,0,9
Laketia,F,100,9,0,9
Lalana,F,100,9,0,9
Lalisa,F,100,9,0,9
Lanitra,F,100,9,0,9
Laqueisha,F,100,9,0,9
Laretha,F,100,9,0,9
Lashavia,F,100,9,0,9
Latacha,F,100,9,0,9
Latangela,F,100,9,0,9
Latash,F,100,9,0,9
Laterrian,M,100,0,9,9
Latifia,F,100,9,0,9
Latiqua,F,100,9,0,9
Latre,M,100,0,9,9
Latrel,M,100,0,9,9
Lauralie,F,100,9,0,9
Laurier,M,100,0,9,9
Laurren,F,100,9,0,9
Layanah,F,100,9,0,9
Layann,F,100,9,0,9
Layia,F,100,9,0,9
Leata,F,100,9,0,9
Leeandre,M,100,0,9,9
Leinaala,F,100,9,0,9
Lekiesha,F,100,9,0,9
Lekita,F,100,9,0,9
Lennan,F,100,9,0,9
Lenni,F,100,9,0,9
Lerry,M,100,0,9,9
Lety,F,100,9,0,9
Levana,F,100,9,0,9
Leven,M,100,0,9,9
Lezette,F,100,9,0,9
Lianni,F,100,9,0,9
Lil,F,100,9,0,9
Lilija,F,100,9,0,9
Lillette,F,100,9,0,9
Lindel,M,100,0,9,9
Liran,M,100,0,9,9
Lissy,F,100,9,0,9
Lohith,M,100,0,9,9
Londynne,F,100,9,0,9
Lonza,M,100,0,9,9
Lorea,F,100,9,0,9
Loula,F,100,9,0,9
Lucee,F,100,9,0,9
Luciella,F,100,9,0,9
Lucyana,F,100,9,0,9
Lukisha,F,100,9,0,9
Lun,F,100,9,0,9
Lundin,F,100,9,0,9
Luqmaan,M,100,0,9,9
Luzdary,F,100,9,0,9
Lwren,F,100,9,0,9
Lyndora,F,100,9,0,9
Lynese,F,100,9,0,9
Lysbeth,F,100,9,0,9
Mackenze,F,100,9,0,9
Maevis,F,100,9,0,9
Maielle,F,100,9,0,9
Maitlyn,F,100,9,0,9
Makhyla,F,100,9,0,9
Makua,M,100,0,9,9
Malic,M,100,0,9,9
Maliea,F,100,9,0,9
Malila,F,100,9,0,9
Malise,F,100,9,0,9
Mancel,M,100,0,9,9
Mansfield,M,100,0,9,9
Marcianna,F,100,9,0,9
Mardene,F,100,9,0,9
Marene,F,100,9,0,9
Marielly,F,100,9,0,9
Marites,F,100,9,0,9
Markale,M,100,0,9,9
Markan,F,100,9,0,9
Markees,M,100,0,9,9
Markenzie,F,100,9,0,9
Markeyta,F,100,9,0,9
Markjoseph,M,100,0,9,9
Markquis,M,100,0,9,9
Markum,M,100,0,9,9
Marlies,F,100,9,0,9
Marloe,F,100,9,0,9
Marrina,F,100,9,0,9
Marteze,M,100,0,9,9
Martini,F,100,9,0,9
Marvia,F,100,9,0,9
Matayah,F,100,9,0,9
Matviy,M,100,0,9,9
Mavery,F,100,9,0,9
Mawada,F,100,9,0,9
Maxxon,M,100,0,9,9
Mayella,F,100,9,0,9
Mayvis,F,100,9,0,9
Mayzi,F,100,9,0,9
Mckai,M,100,0,9,9
Mechille,F,100,9,0,9
Meichelle,F,100,9,0,9
Mekesha,F,100,9,0,9
Mekia,F,100,9,0,9
Mekisha,F,100,9,0,9
Meli,F,100,9,0,9
Melitza,F,100,9,0,9
Mikita,F,100,9,0,9
Mileidi,F,100,9,0,9
Milind,M,100,0,9,9
Millani,F,100,9,0,9
Mirandah,F,100,9,0,9
Mishay,F,100,9,0,9
Misheel,F,100,9,0,9
Mistina,F,100,9,0,9
Mohib,M,100,0,9,9
Mollye,F,100,9,0,9
Montero,M,100,0,9,9
Morgaine,F,100,9,0,9
Motaz,M,100,0,9,9
Myara,F,100,9,0,9
Mycheal,M,100,0,9,9
Myli,F,100,9,0,9
Myraa,F,100,9,0,9
Naavya,F,100,9,0,9
Namine,F,100,9,0,9
Namirah,F,100,9,0,9
Nand,M,100,0,9,9
Narya,F,100,9,0,9
Natalin,F,100,9,0,9
Natash,F,100,9,0,9
Nathanal,M,100,0,9,9
Natiyah,F,100,9,0,9
Navey,F,100,9,0,9
Naviya,F,100,9,0,9
Necol,F,100,9,0,9
Nedenia,F,100,9,0,9
Neharika,F,100,9,0,9
Nektarios,M,100,0,9,9
Neleh,F,100,9,0,9
Neng,M,100,0,9,9
Neshanta,F,100,9,0,9
Netasha,F,100,9,0,9
Nevena,F,100,9,0,9
Niasha,F,100,9,0,9
Nicolaos,M,100,0,9,9
Nikolis,M,100,0,9,9
Nilaya,F,100,9,0,9
Ninoska,F,100,9,0,9
Nizaiah,M,100,0,9,9
Novalei,F,100,9,0,9
Nyaisha,F,100,9,0,9
Nyjai,F,100,9,0,9
Nykea,F,100,9,0,9
Nymir,M,100,0,9,9
Oaklei,F,100,9,0,9
Odessey,F,100,9,0,9
Odeth,F,100,9,0,9
Oletta,F,100,9,0,9
Oley,M,100,0,9,9
Othon,M,100,0,9,9
Oxford,M,100,0,9,9
Paizlie,F,100,9,0,9
Pamelyn,F,100,9,0,9
Pape,M,100,0,9,9
Parin,M,100,0,9,9
Patrich,M,100,0,9,9
Patrinia,F,100,9,0,9
Payzlie,F,100,9,0,9
Pecolia,F,100,9,0,9
Penelopy,F,100,9,0,9
Philant,M,100,0,9,9
Phinley,F,100,9,0,9
Phyllicia,F,100,9,0,9
Phyllip,M,100,0,9,9
Pranika,F,100,9,0,9
Preanna,F,100,9,0,9
Preslea,F,100,9,0,9
Pressly,F,100,9,0,9
Priscille,F,100,9,0,9
Pristine,F,100,9,0,9
Quameisha,F,100,9,0,9
Quanasia,F,100,9,0,9
Quinnly,F,100,9,0,9
Quisha,F,100,9,0,9
Rahzel,M,100,0,9,9
Raianna,F,100,9,0,9
Raidan,M,100,0,9,9
Raimee,F,100,9,0,9
Rainell,F,100,9,0,9
Raizo,M,100,0,9,9
Rajai,M,100,0,9,9
Rakeen,M,100,0,9,9
Rameez,M,100,0,9,9
Ramirez,M,100,0,9,9
Randye,F,100,9,0,9
Ranessa,F,100,9,0,9
Ranoda,F,100,9,0,9
Raquon,M,100,0,9,9
Rashee,M,100,0,9,9
Rasheim,M,100,0,9,9
Raushan,M,100,0,9,9
Rayanah,F,100,9,0,9
Rayvn,F,100,9,0,9
Reakwon,M,100,0,9,9
Reather,F,100,9,0,9
Rebelle,F,100,9,0,9
Reice,M,100,0,9,9
Renarta,F,100,9,0,9
Reneshia,F,100,9,0,9
Renso,M,100,0,9,9
Renya,F,100,9,0,9
Rexene,F,100,9,0,9
Reyonna,F,100,9,0,9
Rhiyan,F,100,9,0,9
Richardine,F,100,9,0,9
Ricketta,F,100,9,0,9
Rilya,F,100,9,0,9
Rimsha,F,100,9,0,9
Rixon,M,100,0,9,9
Rixton,M,100,0,9,9
Rmontay,M,100,0,9,9
Rondo,M,100,0,9,9
Rosalynne,F,100,9,0,9
Rosamund,F,100,9,0,9
Rosha,F,100,9,0,9
Roshawna,F,100,9,0,9
Roshondra,F,100,9,0,9
Roxine,F,100,9,0,9
Royelle,F,100,9,0,9
Ruffus,M,100,0,9,9
Ruhee,F,100,9,0,9
Ruqiya,F,100,9,0,9
Rushelle,F,100,9,0,9
Ruya,F,100,9,0,9
Ryesha,F,100,9,0,9
Ryett,M,100,0,9,9
Sabrenia,F,100,9,0,9
Sache,F,100,9,0,9
Sadiel,M,100,0,9,9
Samantah,F,100,9,0,9
Samarria,F,100,9,0,9
Samin,M,100,0,9,9
Samrat,M,100,0,9,9
Samus,F,100,9,0,9
Sandip,M,100,0,9,9
Santiana,F,100,9,0,9
Saphyra,F,100,9,0,9
Sargun,F,100,9,0,9
Savahanna,F,100,9,0,9
Secoya,F,100,9,0,9
Seini,F,100,9,0,9
Semih,M,100,0,9,9
Senecca,M,100,0,9,9
Sentell,M,100,0,9,9
Sequia,F,100,9,0,9
Seva,F,100,9,0,9
Severino,M,100,0,9,9
Seylah,F,100,9,0,9
Shaarav,M,100,0,9,9
Shahn,M,100,0,9,9
Shakhia,F,100,9,0,9
Shakyrah,F,100,9,0,9
Shalah,F,100,9,0,9
Shalay,F,100,9,0,9
Shalesa,F,100,9,0,9
Shali,F,100,9,0,9
Shaliah,F,100,9,0,9
Shanautica,F,100,9,0,9
Shanielle,F,100,9,0,9
Shanovia,F,100,9,0,9
Shaquisha,F,100,9,0,9
Sharbel,M,100,0,9,9
Shareta,F,100,9,0,9
Sharneice,F,100,9,0,9
Sharquita,F,100,9,0,9
Shatira,F,100,9,0,9
Shavez,M,100,0,9,9
Shayona,F,100,9,0,9
Sheika,F,100,9,0,9
Shemya,F,100,9,0,9
Shenitta,F,100,9,0,9
Shenouda,M,100,0,9,9
Sherrard,M,100,0,9,9
Sherrica,F,100,9,0,9
Sherrise,F,100,9,0,9
Shilee,F,100,9,0,9
Shinea,F,100,9,0,9
Shinead,F,100,9,0,9
Shirely,F,100,9,0,9
Shirleyann,F,100,9,0,9
Shonice,F,100,9,0,9
Shonnette,F,100,9,0,9
Shuna,F,100,9,0,9
Siddhan,M,100,0,9,9
Sieda,F,100,9,0,9
Sisqo,M,100,0,9,9
Siva,M,100,0,9,9
Siyuan,M,100,0,9,9
Skylyr,F,100,9,0,9
Slader,M,100,0,9,9
Soane,M,100,0,9,9
Soctt,M,100,0,9,9
Sorrell,M,100,0,9,9
Sou,M,100,0,9,9
Sourish,M,100,0,9,9
Stephanieann,F,100,9,0,9
Stephanine,F,100,9,0,9
Stphanie,F,100,9,0,9
Stylez,M,100,0,9,9
Sujal,M,100,0,9,9
Sukhleen,F,100,9,0,9
Suley,F,100,9,0,9
Suniyah,F,100,9,0,9
Surai,F,100,9,0,9
Surveen,F,100,9,0,9
Sushant,M,100,0,9,9
Sydna,F,100,9,0,9
Taahira,F,100,9,0,9
Taevyn,M,100,0,9,9
Taheera,F,100,9,0,9
Tahliah,F,100,9,0,9
Taisa,F,100,9,0,9
Taiven,M,100,0,9,9
Tajanay,F,100,9,0,9
Takayuki,M,100,0,9,9
Takeila,F,100,9,0,9
Talah,F,100,9,0,9
Talent,M,100,0,9,9
Tameya,F,100,9,0,9
Tammela,F,100,9,0,9
Tancy,F,100,9,0,9
Tanganyika,F,100,9,0,9
Tanilah,F,100,9,0,9
Tanisi,F,100,9,0,9
Taraja,F,100,9,0,9
Tarajah,F,100,9,0,9
Tareka,F,100,9,0,9
Tarica,F,100,9,0,9
Tasheanna,F,100,9,0,9
Tasmia,F,100,9,0,9
Tavaughn,M,100,0,9,9
Tawona,F,100,9,0,9
Taziya,F,100,9,0,9
Teea,F,100,9,0,9
Tejah,F,100,9,0,9
Teliah,F,100,9,0,9
Temari,F,100,9,0,9
Teniesha,F,100,9,0,9
Teriyah,F,100,9,0,9
Terrylynn,F,100,9,0,9
Thaiz,F,100,9,0,9
Thaleia,F,100,9,0,9
Theresaann,F,100,9,0,9
Thyda,F,100,9,0,9
Tiajah,F,100,9,0,9
Ticia,F,100,9,0,9
Tieler,M,100,0,9,9
Tiffay,F,100,9,0,9
Tionnie,F,100,9,0,9
Tiran,M,100,0,9,9
Tiwanna,F,100,9,0,9
Tiyona,F,100,9,0,9
Toniqua,F,100,9,0,9
Tooba,F,100,9,0,9
Tramika,F,100,9,0,9
Traun,M,100,0,9,9
Tredarius,M,100,0,9,9
Treveion,M,100,0,9,9
Trew,M,100,0,9,9
Treyshaun,M,100,0,9,9
Tulip,F,100,9,0,9
Tyja,F,100,9,0,9
Tykel,M,100,0,9,9
Tykevious,M,100,0,9,9
Tykiera,F,100,9,0,9
Tymarion,M,100,0,9,9
Tyonia,F,100,9,0,9
Tyreak,M,100,0,9,9
Tyrei,M,100,0,9,9
Tyrhianna,F,100,9,0,9
Tyshanna,F,100,9,0,9
Tysheem,M,100,0,9,9
Tyten,M,100,0,9,9
Tywuan,M,100,0,9,9
Udy,F,100,9,0,9
Umeko,F,100,9,0,9
Urwa,F,100,9,0,9
Valeree,F,100,9,0,9
Vaniah,F,100,9,0,9
Varnell,M,100,0,9,9
Vedra,F,100,9,0,9
Vent,M,100,0,9,9
Veryl,M,100,0,9,9
Vicenzo,M,100,0,9,9
Victoriah,F,100,9,0,9
Videl,F,100,9,0,9
Vivyan,F,100,9,0,9
Vontre,M,100,0,9,9
Vyolet,F,100,9,0,9
Wakisha,F,100,9,0,9
Wendalyn,F,100,9,0,9
Weyland,M,100,0,9,9
Whittley,F,100,9,0,9
Willadean,F,100,9,0,9
Wise,M,100,0,9,9
Wyley,M,100,0,9,9
Yafa,F,100,9,0,9
Yahsir,M,100,0,9,9
Yaila,F,100,9,0,9
Yailenys,F,100,9,0,9
Yakisha,F,100,9,0,9
Yamia,F,100,9,0,9
Yamiled,F,100,9,0,9
Yanziel,M,100,0,9,9
Yarnell,F,100,9,0,9
Yashwanth,M,100,0,9,9
Yasmene,F,100,9,0,9
Yasseen,M,100,0,9,9
Yassen,M,100,0,9,9
Yazir,M,100,0,9,9
Yojan,M,100,0,9,9
Zaakirah,F,100,9,0,9
Zacharius,M,100,0,9,9
Zacherie,M,100,0,9,9
Zaelee,F,100,9,0,9
Zahar,M,100,0,9,9
Zahniyah,F,100,9,0,9
Zaidon,M,100,0,9,9
Zamarien,M,100,0,9,9
Zamyiah,F,100,9,0,9
Zanib,F,100,9,0,9
Zarra,F,100,9,0,9
Zaydie,F,100,9,0,9
Zaylia,F,100,9,0,9
Zayliana,F,100,9,0,9
Zellie,F,100,9,0,9
Zevon,M,100,0,9,9
Zhoie,F,100,9,0,9
Zienna,F,100,9,0,9
Zimal,F,100,9,0,9
Ziqi,F,100,9,0,9
Zoelynn,F,100,9,0,9
Zoeyjane,F,100,9,0,9
Zoli,F,100,9,0,9
Zong,M,100,0,9,9
Zuleica,F,100,9,0,9
Zyiere,M,100,0,9,9
Zyionna,F,100,9,0,9
Zykera,F,100,9,0,9
Zymari,M,100,0,9,9
Zyndall,M,100,0,9,9
Aavah,F,100,8,0,8
Aaven,M,100,0,8,8
Abba,M,100,0,8,8
Abdiqani,M,100,0,8,8
Abdulrehman,M,100,0,8,8
Abdurrehman,M,100,0,8,8
Abeera,F,100,8,0,8
Abhijeet,M,100,0,8,8
Abishek,M,100,0,8,8
Abou,M,100,0,8,8
Abriah,F,100,8,0,8
Abryl,F,100,8,0,8
Aceon,M,100,0,8,8
Aceton,M,100,0,8,8
Ackeem,M,100,0,8,8
Ackley,M,100,0,8,8
Adaja,F,100,8,0,8
Adaleen,F,100,8,0,8
Adaleyza,F,100,8,0,8
Adamina,F,100,8,0,8
Adayshia,F,100,8,0,8
Addai,M,100,0,8,8
Addalin,F,100,8,0,8
Adeja,F,100,8,0,8
Adhara,F,100,8,0,8
Adhemar,M,100,0,8,8
Adhrith,M,100,0,8,8
Adila,F,100,8,0,8
Adilah,F,100,8,0,8
Adrianno,M,100,0,8,8
Aedon,M,100,0,8,8
Aedric,M,100,0,8,8
Agrima,F,100,8,0,8
Ahmirah,F,100,8,0,8
Ahylin,F,100,8,0,8
Aidrik,M,100,0,8,8
Aimsley,F,100,8,0,8
Aisen,M,100,0,8,8
Aiyah,F,100,8,0,8
Ajamu,M,100,0,8,8
Ajournee,F,100,8,0,8
Akeel,M,100,0,8,8
Aketzaly,F,100,8,0,8
Akiria,F,100,8,0,8
Alaiyna,F,100,8,0,8
Alasiah,F,100,8,0,8
Alawna,F,100,8,0,8
Alenda,F,100,8,0,8
Alexanderjames,M,100,0,8,8
Aleysa,F,100,8,0,8
Aleyssa,F,100,8,0,8
Alieyah,F,100,8,0,8
Aliiyah,F,100,8,0,8
Alius,M,100,0,8,8
Allesha,F,100,8,0,8
Allyx,F,100,8,0,8
Almetta,F,100,8,0,8
Almonzo,M,100,0,8,8
Alphia,F,100,8,0,8
Alrik,M,100,0,8,8
Alxander,M,100,0,8,8
Alyha,F,100,8,0,8
Alyrica,F,100,8,0,8
Alyvea,F,100,8,0,8
Alzahra,F,100,8,0,8
Amabella,F,100,8,0,8
Amadu,M,100,0,8,8
Amarr,M,100,0,8,8
Amayrany,F,100,8,0,8
Amazyn,F,100,8,0,8
Ambreia,F,100,8,0,8
Amelina,F,100,8,0,8
Amica,F,100,8,0,8
Amielia,F,100,8,0,8
Amiliyah,F,100,8,0,8
Amillian,F,100,8,0,8
Amirykal,F,100,8,0,8
Amjed,M,100,0,8,8
Amron,M,100,0,8,8
Anacecilia,F,100,8,0,8
Anahia,F,100,8,0,8
Anairis,F,100,8,0,8
Analese,F,100,8,0,8
Anandi,F,100,8,0,8
Anar,M,100,0,8,8
Anddy,M,100,0,8,8
Andelynn,F,100,8,0,8
Andin,M,100,0,8,8
Andren,M,100,0,8,8
Andrewjohn,M,100,0,8,8
Anele,F,100,8,0,8
Anelisa,F,100,8,0,8
Anicka,F,100,8,0,8
Anistynn,F,100,8,0,8
Anjanae,F,100,8,0,8
Annaclara,F,100,8,0,8
Annaleia,F,100,8,0,8
Annaley,F,100,8,0,8
Anner,F,100,8,0,8
Annilee,F,100,8,0,8
Annye,F,100,8,0,8
Anqunette,F,100,8,0,8
Antoniya,F,100,8,0,8
Antrice,F,100,8,0,8
Anuraag,M,100,0,8,8
Anyeline,F,100,8,0,8
Aralee,F,100,8,0,8
Ardita,F,100,8,0,8
Areia,F,100,8,0,8
Arellys,F,100,8,0,8
Arij,F,100,8,0,8
Ariyelle,F,100,8,0,8
Arloa,F,100,8,0,8
Armard,M,100,0,8,8
Armita,F,100,8,0,8
Arnavi,F,100,8,0,8
Arnika,F,100,8,0,8
Aronda,F,100,8,0,8
Arooj,F,100,8,0,8
Arriah,F,100,8,0,8
Aryona,F,100,8,0,8
Asami,F,100,8,0,8
Ashara,F,100,8,0,8
Ashita,F,100,8,0,8
Astaria,F,100,8,0,8
Astella,F,100,8,0,8
Athalie,F,100,8,0,8
Athyna,F,100,8,0,8
Atsushi,M,100,0,8,8
Aubrianah,F,100,8,0,8
Audraya,F,100,8,0,8
Augus,M,100,0,8,8
Aulelei,F,100,8,0,8
Aurick,M,100,0,8,8
Australia,F,100,8,0,8
Avahlynn,F,100,8,0,8
Avalanna,F,100,8,0,8
Avaleen,F,100,8,0,8
Avaley,F,100,8,0,8
Avalin,F,100,8,0,8
Avamae,F,100,8,0,8
Averyonna,F,100,8,0,8
Avonta,M,100,0,8,8
Avra,F,100,8,0,8
Axil,M,100,0,8,8
Ayahna,F,100,8,0,8
Aybel,M,100,0,8,8
Aydeen,M,100,0,8,8
Ayoob,M,100,0,8,8
Aythen,M,100,0,8,8
Ayushman,M,100,0,8,8
Azella,F,100,8,0,8
Azuree,F,100,8,0,8
Baneza,F,100,8,0,8
Barbarella,F,100,8,0,8
Bariah,F,100,8,0,8
Baseemah,F,100,8,0,8
Bassem,M,100,0,8,8
Bautista,M,100,0,8,8
Bayardo,M,100,0,8,8
Beaumont,M,100,0,8,8
Beckum,M,100,0,8,8
Bellanie,F,100,8,0,8
Belvin,M,100,0,8,8
Benhur,M,100,0,8,8
Benna,F,100,8,0,8
Bennita,F,100,8,0,8
Bentlea,F,100,8,0,8
Berenda,F,100,8,0,8
Bexlee,F,100,8,0,8
Bharath,M,100,0,8,8
Bhavna,F,100,8,0,8
Biancha,F,100,8,0,8
Biran,M,100,0,8,8
Bisan,F,100,8,0,8
Bobbyjoe,M,100,0,8,8
Bojan,M,100,0,8,8
Boluwatife,F,100,8,0,8
Bonnee,F,100,8,0,8
Brace,M,100,0,8,8
Bradshaw,M,100,0,8,8
Bradynn,M,100,0,8,8
Braily,F,100,8,0,8
Brajon,M,100,0,8,8
Brawley,M,100,0,8,8
Breean,F,100,8,0,8
Brettney,F,100,8,0,8
Brexten,M,100,0,8,8
Briaja,F,100,8,0,8
Brigston,M,100,0,8,8
Brijette,F,100,8,0,8
Brinlynn,F,100,8,0,8
Britnei,F,100,8,0,8
Briyit,F,100,8,0,8
Brynja,F,100,8,0,8
Bryttni,F,100,8,0,8
Burtis,M,100,0,8,8
Bynum,M,100,0,8,8
Cadience,F,100,8,0,8
Caffrey,M,100,0,8,8
Caisley,F,100,8,0,8
Calandria,F,100,8,0,8
Calei,F,100,8,0,8
Calvina,F,100,8,0,8
Calvon,M,100,0,8,8
Camani,F,100,8,0,8
Camen,M,100,0,8,8
Canelo,M,100,0,8,8
Caragh,F,100,8,0,8
Cardae,M,100,0,8,8
Carilee,F,100,8,0,8
Carime,F,100,8,0,8
Carmeshia,F,100,8,0,8
Carnella,F,100,8,0,8
Caroleena,F,100,8,0,8
Catherene,F,100,8,0,8
Ceilidh,F,100,8,0,8
Celeny,F,100,8,0,8
Celissa,F,100,8,0,8
Centeria,F,100,8,0,8
Ceriyah,F,100,8,0,8
Cerone,M,100,0,8,8
Cessily,F,100,8,0,8
Cevon,M,100,0,8,8
Chakayla,F,100,8,0,8
Chalese,F,100,8,0,8
Chanette,F,100,8,0,8
Chantea,F,100,8,0,8
Chantol,F,100,8,0,8
Chaquana,F,100,8,0,8
Charell,F,100,8,0,8
Charito,F,100,8,0,8
Charlen,F,100,8,0,8
Charlse,M,100,0,8,8
Charmen,F,100,8,0,8
Chastelyn,F,100,8,0,8
Chaunda,F,100,8,0,8
Chaunta,F,100,8,0,8
Chedrick,M,100,0,8,8
Chelita,F,100,8,0,8
Chellie,F,100,8,0,8
Chelsay,F,100,8,0,8
Chenea,F,100,8,0,8
Chereen,F,100,8,0,8
Cherye,F,100,8,0,8
Cheyeanne,F,100,8,0,8
Cheyna,F,100,8,0,8
Chibuike,M,100,0,8,8
Chiron,M,100,0,8,8
Chrisley,F,100,8,0,8
Christinamarie,F,100,8,0,8
Christionna,F,100,8,0,8
Christyle,F,100,8,0,8
Chrystyna,F,100,8,0,8
Chuong,M,100,0,8,8
Chyane,F,100,8,0,8
Ciclali,F,100,8,0,8
Cimberly,F,100,8,0,8
Cindel,F,100,8,0,8
Citalli,F,100,8,0,8
Claxton,M,100,0,8,8
Clevester,M,100,0,8,8
Coden,M,100,0,8,8
Codye,M,100,0,8,8
Conn,M,100,0,8,8
Connye,F,100,8,0,8
Copelan,M,100,0,8,8
Cordarrel,M,100,0,8,8
Cordarrell,M,100,0,8,8
Corderius,M,100,0,8,8
Coreon,M,100,0,8,8
Coreyana,F,100,8,0,8
Corleen,F,100,8,0,8
Council,M,100,0,8,8
Creta,F,100,8,0,8
Cristol,F,100,8,0,8
Cruiz,M,100,0,8,8
Cylen,M,100,0,8,8
Cymphony,F,100,8,0,8
Cypher,M,100,0,8,8
Cyric,M,100,0,8,8
Daedric,M,100,0,8,8
Daeonna,F,100,8,0,8
Dajoun,M,100,0,8,8
Dalontae,M,100,0,8,8
Damber,F,100,8,0,8
Damel,M,100,0,8,8
Damerion,M,100,0,8,8
Damiel,M,100,0,8,8
Damondre,M,100,0,8,8
Damyla,F,100,8,0,8
Danaija,F,100,8,0,8
Danayja,F,100,8,0,8
Dangel,M,100,0,8,8
Dannett,F,100,8,0,8
Danuta,F,100,8,0,8
Danyl,M,100,0,8,8
Daquana,F,100,8,0,8
Darald,M,100,0,8,8
Dareck,M,100,0,8,8
Darica,F,100,8,0,8
Daritza,F,100,8,0,8
Darlisha,F,100,8,0,8
Darrett,M,100,0,8,8
Darria,F,100,8,0,8
Darrica,F,100,8,0,8
Darrill,M,100,0,8,8
Dashanay,F,100,8,0,8
Dashiya,F,100,8,0,8
Dasiya,F,100,8,0,8
Dasya,F,100,8,0,8
Dauda,M,100,0,8,8
Dauphine,F,100,8,0,8
Dausen,M,100,0,8,8
Davidmichael,M,100,0,8,8
Davielle,F,100,8,0,8
Davyan,M,100,0,8,8
Dayann,F,100,8,0,8
Daymar,M,100,0,8,8
Deangleo,M,100,0,8,8
Deaysia,F,100,8,0,8
Debaroh,F,100,8,0,8
Dechlan,M,100,0,8,8
Dedrea,F,100,8,0,8
Dejai,F,100,8,0,8
Dejha,F,100,8,0,8
Delontay,M,100,0,8,8
Demarien,M,100,0,8,8
Demmi,F,100,8,0,8
Dencil,M,100,0,8,8
Denman,M,100,0,8,8
Dennies,M,100,0,8,8
Dent,M,100,0,8,8
Deontez,M,100,0,8,8
Derec,M,100,0,8,8
Dereion,M,100,0,8,8
Derious,M,100,0,8,8
Derita,F,100,8,0,8
Deriyah,F,100,8,0,8
Derrianna,F,100,8,0,8
Desirre,F,100,8,0,8
Detricia,F,100,8,0,8
Deunte,M,100,0,8,8
Devarion,M,100,0,8,8
Devarsh,M,100,0,8,8
Dextin,M,100,0,8,8
Dezhane,F,100,8,0,8
Dezlyn,F,100,8,0,8
Dezmariah,F,100,8,0,8
Dharius,M,100,0,8,8
Dhyey,M,100,0,8,8
Diamone,F,100,8,0,8
Dianette,F,100,8,0,8
Diasha,F,100,8,0,8
Dieynaba,F,100,8,0,8
Diontre,M,100,0,8,8
Diovanni,M,100,0,8,8
Dixielynn,F,100,8,0,8
Djavan,M,100,0,8,8
Doha,F,100,8,0,8
Dokota,M,100,0,8,8
Domnik,M,100,0,8,8
Donicia,F,100,8,0,8
Donnica,F,100,8,0,8
Donyetta,F,100,8,0,8
Dorella,F,100,8,0,8
Doriana,F,100,8,0,8
Dorinne,F,100,8,0,8
Dovetta,F,100,8,0,8
Dozier,M,100,0,8,8
Drevin,M,100,0,8,8
Duard,M,100,0,8,8
Dyesha,F,100,8,0,8
Dylanger,M,100,0,8,8
Dyneshia,F,100,8,0,8
Dystiny,F,100,8,0,8
Eagle,M,100,0,8,8
Earlisha,F,100,8,0,8
Eather,F,100,8,0,8
Ebonnie,F,100,8,0,8
Edisson,M,100,0,8,8
Edwing,M,100,0,8,8
Eiljah,M,100,0,8,8
Eislee,F,100,8,0,8
Eissa,M,100,0,8,8
Elenie,F,100,8,0,8
Eliav,M,100,0,8,8
Elioenai,M,100,0,8,8
Elizabelle,F,100,8,0,8
Elizabeta,F,100,8,0,8
Elizabth,F,100,8,0,8
Elleni,F,100,8,0,8
Ellesyn,F,100,8,0,8
Elliza,F,100,8,0,8
Ellody,F,100,8,0,8
Ellsa,F,100,8,0,8
Ellyette,F,100,8,0,8
Eloni,F,100,8,0,8
Elsee,F,100,8,0,8
Elves,M,100,0,8,8
Emanda,F,100,8,0,8
Emanii,F,100,8,0,8
Emeal,M,100,0,8,8
Emerly,F,100,8,0,8
Emerlyn,F,100,8,0,8
Emeryn,F,100,8,0,8
Emmasofia,F,100,8,0,8
Emmiline,F,100,8,0,8
Emonte,M,100,0,8,8
Emuna,F,100,8,0,8
Enajiah,F,100,8,0,8
Enzio,M,100,0,8,8
Ericsson,M,100,0,8,8
Erienne,F,100,8,0,8
Eriqa,F,100,8,0,8
Erla,F,100,8,0,8
Erryn,F,100,8,0,8
Erubey,M,100,0,8,8
Essica,F,100,8,0,8
Estes,M,100,0,8,8
Ethann,M,100,0,8,8
Etheleen,F,100,8,0,8
Euell,M,100,0,8,8
Eugune,M,100,0,8,8
Eulice,M,100,0,8,8
Eveleigh,F,100,8,0,8
Evella,F,100,8,0,8
Evelynrose,F,100,8,0,8
Everdeen,F,100,8,0,8
Eyonna,F,100,8,0,8
Ezavier,M,100,0,8,8
Ezekio,M,100,0,8,8
Fabyan,M,100,0,8,8
Faison,M,100,0,8,8
Fantasy,F,100,8,0,8
Farran,F,100,8,0,8
Fawne,F,100,8,0,8
Fawzi,M,100,0,8,8
Faylinn,F,100,8,0,8
Feiga,F,100,8,0,8
Fidela,F,100,8,0,8
Fiera,F,100,8,0,8
Fion,F,100,8,0,8
Francys,F,100,8,0,8
Fynleigh,F,100,8,0,8
Gabryle,M,100,0,8,8
Galdino,M,100,0,8,8
Garson,M,100,0,8,8
Gatlynn,M,100,0,8,8
Genesha,F,100,8,0,8
Geonni,M,100,0,8,8
Geramiah,M,100,0,8,8
Ghalia,F,100,8,0,8
Giah,F,100,8,0,8
Gianno,M,100,0,8,8
Ginnifer,F,100,8,0,8
Gioni,M,100,0,8,8
Giovanie,M,100,0,8,8
Gizele,F,100,8,0,8
Gizell,F,100,8,0,8
Gladstone,M,100,0,8,8
Gleda,F,100,8,0,8
Goodluck,M,100,0,8,8
Gopal,M,100,0,8,8
Graclynn,F,100,8,0,8
Grantland,M,100,0,8,8
Graylyn,F,100,8,0,8
Greogry,M,100,0,8,8
Greylan,M,100,0,8,8
Greysin,M,100,0,8,8
Gursirat,F,100,8,0,8
Hadel,F,100,8,0,8
Hadelyn,F,100,8,0,8
Hailo,F,100,8,0,8
Haizel,F,100,8,0,8
Hakeen,M,100,0,8,8
Haki,M,100,0,8,8
Haleemah,F,100,8,0,8
Haoyu,M,100,0,8,8
Haron,M,100,0,8,8
Harveen,F,100,8,0,8
Hattan,M,100,0,8,8
Haunani,F,100,8,0,8
Hayvn,F,100,8,0,8
Hedda,F,100,8,0,8
Heddie,F,100,8,0,8
Heddy,F,100,8,0,8
Heela,F,100,8,0,8
Heldana,F,100,8,0,8
Herlene,F,100,8,0,8
Hidaya,F,100,8,0,8
Hiral,F,100,8,0,8
Ho,M,100,0,8,8
Hobbes,M,100,0,8,8
Holliday,F,100,8,0,8
Hydee,F,100,8,0,8
Hynlee,F,100,8,0,8
Iancarlo,M,100,0,8,8
Ibraham,M,100,0,8,8
Ijanae,F,100,8,0,8
Ikisha,F,100,8,0,8
Iliza,F,100,8,0,8
Ilyn,F,100,8,0,8
Ilynn,F,100,8,0,8
Inas,F,100,8,0,8
Indonesia,F,100,8,0,8
Inman,M,100,0,8,8
Irean,F,100,8,0,8
Ireanna,F,100,8,0,8
Irisha,F,100,8,0,8
Isabelly,F,100,8,0,8
Isatu,F,100,8,0,8
Isaya,M,100,0,8,8
Ishanth,M,100,0,8,8
Isibeal,F,100,8,0,8
Ismahan,F,100,8,0,8
Issacc,M,100,0,8,8
Itzayanna,F,100,8,0,8
Iuma,F,100,8,0,8
Ixzel,F,100,8,0,8
Izair,M,100,0,8,8
Izariah,F,100,8,0,8
Jaasir,M,100,0,8,8
Jaboa,F,100,8,0,8
Jaboris,M,100,0,8,8
Jabre,M,100,0,8,8
Jacarra,F,100,8,0,8
Jacianna,F,100,8,0,8
Jackman,M,100,0,8,8
Jacobee,M,100,0,8,8
Jacquarius,M,100,0,8,8
Jacqueleen,F,100,8,0,8
Jacquelen,F,100,8,0,8
Jadasha,F,100,8,0,8
Jadus,M,100,0,8,8
Jaecyon,M,100,0,8,8
Jaeley,F,100,8,0,8
Jaelie,F,100,8,0,8
Jaella,F,100,8,0,8
Jaevyn,M,100,0,8,8
Jago,M,100,0,8,8
Jahla,F,100,8,0,8
Jahmell,M,100,0,8,8
Jahmez,M,100,0,8,8
Jahmiere,M,100,0,8,8
Jahnyah,F,100,8,0,8
Jahzelle,F,100,8,0,8
Jaicyon,M,100,0,8,8
Jairden,M,100,0,8,8
Jaiyanna,F,100,8,0,8
Jakaylen,M,100,0,8,8
Jakir,M,100,0,8,8
Jamacia,F,100,8,0,8
Jamair,M,100,0,8,8
Jamaurie,M,100,0,8,8
Jamear,M,100,0,8,8
Jamerica,F,100,8,0,8
Jamicka,F,100,8,0,8
Jamiera,F,100,8,0,8
Jamilyah,F,100,8,0,8
Jamual,M,100,0,8,8
Janarius,M,100,0,8,8
Janiesha,F,100,8,0,8
Jaonte,M,100,0,8,8
Jaquail,M,100,0,8,8
Jaquante,M,100,0,8,8
Jaquaveon,M,100,0,8,8
Jaquaylon,M,100,0,8,8
Jaquori,M,100,0,8,8
Jarika,F,100,8,0,8
Jashawna,F,100,8,0,8
Jashira,F,100,8,0,8
Jasmene,F,100,8,0,8
Jatasia,F,100,8,0,8
Jateria,F,100,8,0,8
Jaterrion,M,100,0,8,8
Jatorian,M,100,0,8,8
Jaworski,M,100,0,8,8
Jaxlynn,F,100,8,0,8
Jaydrien,M,100,0,8,8
Jaylend,M,100,0,8,8
Jaylissa,F,100,8,0,8
Jaymien,M,100,0,8,8
Jayree,M,100,0,8,8
Jayrell,M,100,0,8,8
Jayriel,M,100,0,8,8
Jazmia,F,100,8,0,8
Jceion,M,100,0,8,8
Jeliyah,F,100,8,0,8
Jemario,M,100,0,8,8
Jemmah,F,100,8,0,8
Jenille,F,100,8,0,8
Jenin,F,100,8,0,8
Jennea,F,100,8,0,8
Jentzen,M,100,0,8,8
Jerahmy,M,100,0,8,8
Jeramine,M,100,0,8,8
Jerediah,M,100,0,8,8
Jerelene,F,100,8,0,8
Jerianne,F,100,8,0,8
Jericca,F,100,8,0,8
Jermicheal,M,100,0,8,8
Jermisha,F,100,8,0,8
Jerniya,F,100,8,0,8
Jerrah,F,100,8,0,8
Jerrelle,M,100,0,8,8
Jerrian,M,100,0,8,8
Jerud,M,100,0,8,8
Jesicca,F,100,8,0,8
Jessabelle,F,100,8,0,8
Jesselee,M,100,0,8,8
Jetty,F,100,8,0,8
Jetzael,M,100,0,8,8
Jeury,M,100,0,8,8
Jeylah,F,100,8,0,8
Jeyli,F,100,8,0,8
Jeyshangelise,F,100,8,0,8
Jhace,M,100,0,8,8
Jhalen,M,100,0,8,8
Jhenna,F,100,8,0,8
Jheremy,M,100,0,8,8
Jherika,F,100,8,0,8
Jiliana,F,100,8,0,8
Jilisa,F,100,8,0,8
Jillane,F,100,8,0,8
Jimmye,F,100,8,0,8
Jlee,F,100,8,0,8
Joakima,F,100,8,0,8
Joal,M,100,0,8,8
Jodilyn,F,100,8,0,8
Joevany,M,100,0,8,8
Johm,M,100,0,8,8
Johniqua,F,100,8,0,8
Jolon,M,100,0,8,8
Joneka,F,100,8,0,8
Jonier,F,100,8,0,8
Jordie,M,100,0,8,8
Josclyn,F,100,8,0,8
Joseenrique,M,100,0,8,8
Joselinne,F,100,8,0,8
Josheph,M,100,0,8,8
Joson,M,100,0,8,8
Jostyn,M,100,0,8,8
Joua,F,100,8,0,8
Journiee,F,100,8,0,8
Jovawn,M,100,0,8,8
Jovina,F,100,8,0,8
Joyel,F,100,8,0,8
Jsaon,M,100,0,8,8
Juanette,F,100,8,0,8
Juell,M,100,0,8,8
Juleus,M,100,0,8,8
Julias,M,100,0,8,8
Jully,F,100,8,0,8
Juman,F,100,8,0,8
Jusitn,M,100,0,8,8
Jutta,F,100,8,0,8
Jymere,M,100,0,8,8
Kaara,F,100,8,0,8
Kaarin,F,100,8,0,8
Kadaisha,F,100,8,0,8
Kadaja,F,100,8,0,8
Kadarrius,M,100,0,8,8
Kadira,F,100,8,0,8
Kaelea,F,100,8,0,8
Kaelum,M,100,0,8,8
Kaeveon,M,100,0,8,8
Kahlilah,F,100,8,0,8
Kaikoa,M,100,0,8,8
Kailand,F,100,8,0,8
Kainon,M,100,0,8,8
Kaleiyah,F,100,8,0,8
Kamarra,F,100,8,0,8
Kamica,F,100,8,0,8
Kamonte,M,100,0,8,8
Kamyria,F,100,8,0,8
Kanecia,F,100,8,0,8
Kanitra,F,100,8,0,8
Kanoelani,F,100,8,0,8
Karalyne,F,100,8,0,8
Kardell,M,100,0,8,8
Karil,F,100,8,0,8
Kasheem,M,100,0,8,8
Kashonna,F,100,8,0,8
Kashyap,M,100,0,8,8
Katelina,F,100,8,0,8
Katherleen,F,100,8,0,8
Kavis,M,100,0,8,8
Kayaan,M,100,0,8,8
Kayedence,F,100,8,0,8
Kaylanna,F,100,8,0,8
Kayslee,F,100,8,0,8
Kayzen,M,100,0,8,8
Kazen,M,100,0,8,8
Keairah,F,100,8,0,8
Keamber,F,100,8,0,8
Kearney,M,100,0,8,8
Keaunte,M,100,0,8,8
Keawe,M,100,0,8,8
Keegin,M,100,0,8,8
Keema,F,100,8,0,8
Keighly,F,100,8,0,8
Keiondre,M,100,0,8,8
Keishana,F,100,8,0,8
Keiyana,F,100,8,0,8
Kelten,M,100,0,8,8
Kemet,M,100,0,8,8
Kenlynn,F,100,8,0,8
Kenneisha,F,100,8,0,8
Kenniyah,F,100,8,0,8
Kenora,F,100,8,0,8
Kentarius,M,100,0,8,8
Kenyota,F,100,8,0,8
Keris,F,100,8,0,8
Kesten,M,100,0,8,8
Ketha,F,100,8,0,8
Kevante,M,100,0,8,8
Kevone,M,100,0,8,8
Keyaria,F,100,8,0,8
Keydy,F,100,8,0,8
Keyle,F,100,8,0,8
Keymarion,M,100,0,8,8
Keyonnie,F,100,8,0,8
Khadijatou,F,100,8,0,8
Khaleesia,F,100,8,0,8
Khalida,F,100,8,0,8
Khamaria,F,100,8,0,8
Khamaron,M,100,0,8,8
Khamoni,M,100,0,8,8
Khaylah,F,100,8,0,8
Khevin,M,100,0,8,8
Khonner,M,100,0,8,8
Khonor,M,100,0,8,8
Khrystyna,F,100,8,0,8
Kihanna,F,100,8,0,8
Kimbrely,F,100,8,0,8
Kindel,F,100,8,0,8
Kinli,F,100,8,0,8
Kinlynn,F,100,8,0,8
Kinsli,F,100,8,0,8
Kinzli,F,100,8,0,8
Kiondre,M,100,0,8,8
Kiralee,F,100,8,0,8
Kirklin,M,100,0,8,8
Klare,F,100,8,0,8
Klarity,F,100,8,0,8
Klohie,F,100,8,0,8
Knoelle,F,100,8,0,8
Knylah,F,100,8,0,8
Kohana,F,100,8,0,8
Kolben,M,100,0,8,8
Koldyn,M,100,0,8,8
Konesha,F,100,8,0,8
Kovin,M,100,0,8,8
Krishanda,F,100,8,0,8
Krishika,F,100,8,0,8
Kristye,F,100,8,0,8
Kruthi,F,100,8,0,8
Kydin,M,100,0,8,8
Kydon,M,100,0,8,8
Kyeem,M,100,0,8,8
Kyela,F,100,8,0,8
Kyheem,M,100,0,8,8
Kylian,M,100,0,8,8
Kylo,M,100,0,8,8
Kymarion,M,100,0,8,8
Kynnlee,F,100,8,0,8
Kyrion,M,100,0,8,8
Kyrsti,F,100,8,0,8
Labree,F,100,8,0,8
Ladacia,F,100,8,0,8
Laelle,F,100,8,0,8
Lailonie,F,100,8,0,8
Lakechia,F,100,8,0,8
Lakeda,F,100,8,0,8
Lakeema,F,100,8,0,8
Lakeisa,F,100,8,0,8
Lakeyshia,F,100,8,0,8
Lakeyta,F,100,8,0,8
Lakitha,F,100,8,0,8
Lamani,F,100,8,0,8
Lamariya,F,100,8,0,8
Lamarkus,M,100,0,8,8
Lameeka,F,100,8,0,8
Lamere,M,100,0,8,8
Lamyiah,F,100,8,0,8
Lanney,M,100,0,8,8
Laquila,F,100,8,0,8
Laquina,F,100,8,0,8
Laquitia,F,100,8,0,8
Lareesa,F,100,8,0,8
Larica,F,100,8,0,8
Larona,F,100,8,0,8
Larya,F,100,8,0,8
Lashanae,F,100,8,0,8
Lashuna,F,100,8,0,8
Latece,F,100,8,0,8
Laterika,F,100,8,0,8
Latica,F,100,8,0,8
Latiera,F,100,8,0,8
Latita,F,100,8,0,8
Latonna,F,100,8,0,8
Latoy,F,100,8,0,8
Laurenz,M,100,0,8,8
Lauriana,F,100,8,0,8
Laurna,F,100,8,0,8
Lautaro,M,100,0,8,8
Lavarr,M,100,0,8,8
Lavin,M,100,0,8,8
Lawrnce,M,100,0,8,8
Laylarose,F,100,8,0,8
Lealah,F,100,8,0,8
Leanard,M,100,0,8,8
Leartis,M,100,0,8,8
Lechelle,F,100,8,0,8
Ledarrius,M,100,0,8,8
Leddy,F,100,8,0,8
Legen,M,100,0,8,8
Leighlah,F,100,8,0,8
Leniel,M,100,0,8,8
Lenka,F,100,8,0,8
Lenzi,F,100,8,0,8
Leodegario,M,100,0,8,8
Leonitus,M,100,0,8,8
Leovanni,M,100,0,8,8
Leronda,F,100,8,0,8
Lesi,F,100,8,0,8
Lesleyanne,F,100,8,0,8
Lessia,F,100,8,0,8
Letishia,F,100,8,0,8
Lexany,F,100,8,0,8
Leyden,M,100,0,8,8
Leydy,F,100,8,0,8
Lieutenant,M,100,0,8,8
Lilyen,F,100,8,0,8
Lima,F,100,8,0,8
Linaya,F,100,8,0,8
Lisle,M,100,0,8,8
Lium,M,100,0,8,8
Livvie,F,100,8,0,8
Liyu,F,100,8,0,8
Lizel,F,100,8,0,8
Loay,M,100,0,8,8
Loie,F,100,8,0,8
Lorane,F,100,8,0,8
Lorrena,F,100,8,0,8
Lott,M,100,0,8,8
Louisiana,F,100,8,0,8
Lova,F,100,8,0,8
Lovann,F,100,8,0,8
Lovelynn,F,100,8,0,8
Loyalti,F,100,8,0,8
Ltonya,F,100,8,0,8
Lucresia,F,100,8,0,8
Lucyna,F,100,8,0,8
Luevenia,F,100,8,0,8
Lupie,F,100,8,0,8
Luzmarie,F,100,8,0,8
Lymon,M,100,0,8,8
Lynnon,F,100,8,0,8
Lyricc,F,100,8,0,8
Lysle,M,100,0,8,8
Maanasa,F,100,8,0,8
Mabelene,F,100,8,0,8
Macari,M,100,0,8,8
Mackennah,F,100,8,0,8
Macklen,M,100,0,8,8
Macksen,M,100,0,8,8
Madysn,F,100,8,0,8
Maeola,F,100,8,0,8
Mahagany,F,100,8,0,8
Mahalakshmi,F,100,8,0,8
Mahitha,F,100,8,0,8
Mahya,F,100,8,0,8
Maicon,M,100,0,8,8
Mairany,F,100,8,0,8
Maisley,F,100,8,0,8
Makaveli,M,100,0,8,8
Makina,F,100,8,0,8
Makini,F,100,8,0,8
Makyna,F,100,8,0,8
Makynlie,F,100,8,0,8
Malakia,F,100,8,0,8
Malakie,M,100,0,8,8
Malayja,F,100,8,0,8
Maleko,M,100,0,8,8
Maliik,M,100,0,8,8
Malikk,M,100,0,8,8
Malinalli,F,100,8,0,8
Manouchka,F,100,8,0,8
Maquita,F,100,8,0,8
Marcelles,M,100,0,8,8
Marchia,F,100,8,0,8
Marcinda,F,100,8,0,8
Marcius,M,100,0,8,8
Mardel,F,100,8,0,8
Mardella,F,100,8,0,8
Mareco,M,100,0,8,8
Marializ,F,100,8,0,8
Maricelda,F,100,8,0,8
Marieo,M,100,0,8,8
Mariesha,F,100,8,0,8
Marileysis,F,100,8,0,8
Marios,M,100,0,8,8
Marissah,F,100,8,0,8
Maritssa,F,100,8,0,8
Markai,M,100,0,8,8
Markesia,F,100,8,0,8
Markhi,M,100,0,8,8
Markon,M,100,0,8,8
Marnice,F,100,8,0,8
Marpessa,F,100,8,0,8
Marqueisha,F,100,8,0,8
Marquie,M,100,0,8,8
Marreo,M,100,0,8,8
Marrin,F,100,8,0,8
Marsella,F,100,8,0,8
Marticia,F,100,8,0,8
Martis,M,100,0,8,8
Maryalyce,F,100,8,0,8
Marykathleen,F,100,8,0,8
Maryla,F,100,8,0,8
Marylea,F,100,8,0,8
Maryln,F,100,8,0,8
Marypaz,F,100,8,0,8
Mataia,F,100,8,0,8
Matteson,F,100,8,0,8
Matthijs,M,100,0,8,8
Maudry,F,100,8,0,8
Mavryck,M,100,0,8,8
Mayetta,F,100,8,0,8
Maykayla,F,100,8,0,8
Maykel,M,100,0,8,8
Mayrim,F,100,8,0,8
Mayukh,M,100,0,8,8
Mckelle,F,100,8,0,8
Mckyla,F,100,8,0,8
Mckynleigh,F,100,8,0,8
Measia,F,100,8,0,8
Meirav,F,100,8,0,8
Meldrick,M,100,0,8,8
Melisia,F,100,8,0,8
Mell,M,100,0,8,8
Mellissia,F,100,8,0,8
Melo,M,100,0,8,8
Mely,F,100,8,0,8
Mennie,F,100,8,0,8
Merelin,F,100,8,0,8
Merredith,F,100,8,0,8
Merridith,F,100,8,0,8
Merwyn,M,100,0,8,8
Miani,F,100,8,0,8
Micajah,M,100,0,8,8
Michelee,F,100,8,0,8
Miechelle,F,100,8,0,8
Mihira,F,100,8,0,8
Mikaia,F,100,8,0,8
Mikaiya,F,100,8,0,8
Mikinzie,F,100,8,0,8
Milaina,F,100,8,0,8
Mileny,F,100,8,0,8
Milik,M,100,0,8,8
Minaya,F,100,8,0,8
Miquan,M,100,0,8,8
Mirari,F,100,8,0,8
Miray,F,100,8,0,8
Mison,M,100,0,8,8
Mit,M,100,0,8,8
Mitali,F,100,8,0,8
Mitt,M,100,0,8,8
Moayad,M,100,0,8,8
Monasia,F,100,8,0,8
Monday,F,100,8,0,8
Mondrell,M,100,0,8,8
Moneek,F,100,8,0,8
Montario,M,100,0,8,8
Montavis,M,100,0,8,8
Morene,F,100,8,0,8
Moxon,M,100,0,8,8
Munasar,M,100,0,8,8
Muniba,F,100,8,0,8
Murjani,F,100,8,0,8
Mycala,F,100,8,0,8
Mykhael,M,100,0,8,8
Mykhia,F,100,8,0,8
Mylz,M,100,0,8,8
Nadalynn,F,100,8,0,8
Nadilyn,F,100,8,0,8
Nagi,M,100,0,8,8
Nahima,F,100,8,0,8
Nahyan,M,100,0,8,8
Naiyla,F,100,8,0,8
Nakaila,F,100,8,0,8
Nalany,F,100,8,0,8
Namira,F,100,8,0,8
Namit,M,100,0,8,8
Naquasha,F,100,8,0,8
Nashali,F,100,8,0,8
Nashika,F,100,8,0,8
Nashoba,M,100,0,8,8
Nasiir,M,100,0,8,8
Natayla,F,100,8,0,8
Nateisha,F,100,8,0,8
Nathalye,F,100,8,0,8
Natsha,F,100,8,0,8
Natylee,F,100,8,0,8
Navee,F,100,8,0,8
Naviana,F,100,8,0,8
Nayia,F,100,8,0,8
Nazair,M,100,0,8,8
Nazeem,M,100,0,8,8
Ndea,F,100,8,0,8
Nechole,F,100,8,0,8
Neecy,F,100,8,0,8
Neyo,M,100,0,8,8
Ngun,F,100,8,0,8
Nhat,M,100,0,8,8
Nicha,F,100,8,0,8
Nichalous,M,100,0,8,8
Nichlous,M,100,0,8,8
Nikiesha,F,100,8,0,8
Nimrod,M,100,0,8,8
Ninos,M,100,0,8,8
Nio,M,100,0,8,8
Nirel,F,100,8,0,8
Nnaemeka,M,100,0,8,8
Nobie,F,100,8,0,8
Noire,F,100,8,0,8
Nolynn,F,100,8,0,8
Norely,F,100,8,0,8
Norlan,M,100,0,8,8
Nouman,M,100,0,8,8
Novelle,F,100,8,0,8
Numan,M,100,0,8,8
Nyila,F,100,8,0,8
Nyjae,F,100,8,0,8
Nykera,F,100,8,0,8
Nyrie,F,100,8,0,8
Oaklan,M,100,0,8,8
Oakli,F,100,8,0,8
Oberon,M,100,0,8,8
Obryant,M,100,0,8,8
Oda,F,100,8,0,8
Olajide,M,100,0,8,8
Ollen,M,100,0,8,8
Omolola,F,100,8,0,8
Oneka,F,100,8,0,8
Onyinye,F,100,8,0,8
Onyinyechi,F,100,8,0,8
Oprah,F,100,8,0,8
Orma,F,100,8,0,8
Orquidea,F,100,8,0,8
Osa,F,100,8,0,8
Osaze,M,100,0,8,8
Ozric,M,100,0,8,8
Paidyn,F,100,8,0,8
Pailey,F,100,8,0,8
Paislyn,F,100,8,0,8
Pars,M,100,0,8,8
Pasco,M,100,0,8,8
Pasqualina,F,100,8,0,8
Paulisha,F,100,8,0,8
Paysley,F,100,8,0,8
Paysli,F,100,8,0,8
Payzli,F,100,8,0,8
Pegah,F,100,8,0,8
Pegi,F,100,8,0,8
Peiton,F,100,8,0,8
Penley,F,100,8,0,8
Persephoni,F,100,8,0,8
Petal,F,100,8,0,8
Phallyn,F,100,8,0,8
Pharah,F,100,8,0,8
Phillp,M,100,0,8,8
Pierra,F,100,8,0,8
Pink,M,100,0,8,8
Polli,F,100,8,0,8
Poul,M,100,0,8,8
Poyraz,M,100,0,8,8
Prabhnoor,F,100,8,0,8
Prometheus,M,100,0,8,8
Psalms,M,100,0,8,8
Qirat,F,100,8,0,8
Quamane,M,100,0,8,8
Quamarion,M,100,0,8,8
Quame,M,100,0,8,8
Quaneesha,F,100,8,0,8
Quanique,F,100,8,0,8
Quasha,F,100,8,0,8
Quatisha,F,100,8,0,8
Quaylon,M,100,0,8,8
Quiniya,F,100,8,0,8
Quinston,M,100,0,8,8
Quintasha,F,100,8,0,8
Radlee,M,100,0,8,8
Raedean,F,100,8,0,8
Raely,F,100,8,0,8
Raime,F,100,8,0,8
Rajeeni,F,100,8,0,8
Rakita,F,100,8,0,8
Rakshan,M,100,0,8,8
Ramsha,F,100,8,0,8
Ranarda,F,100,8,0,8
Randyl,M,100,0,8,8
Randyn,M,100,0,8,8
Raneen,F,100,8,0,8
Rarity,F,100,8,0,8
Raschelle,F,100,8,0,8
Ravenne,F,100,8,0,8
Rayman,M,100,0,8,8
Rayneisha,F,100,8,0,8
Rayshonda,F,100,8,0,8
Ream,F,100,8,0,8
Rechell,F,100,8,0,8
Redina,F,100,8,0,8
Regenald,M,100,0,8,8
Regginae,F,100,8,0,8
Reik,M,100,0,8,8
Rekisha,F,100,8,0,8
Reneda,F,100,8,0,8
Renezmee,F,100,8,0,8
Renlee,F,100,8,0,8
Reston,M,100,0,8,8
Rexanna,F,100,8,0,8
Rexx,M,100,0,8,8
Reyah,F,100,8,0,8
Reylin,F,100,8,0,8
Reynoldo,M,100,0,8,8
Rhandi,F,100,8,0,8
Rhawnie,F,100,8,0,8
Rhyli,F,100,8,0,8
Ricca,F,100,8,0,8
Rickford,M,100,0,8,8
Rickson,M,100,0,8,8
Ridgely,M,100,0,8,8
Rigoverto,M,100,0,8,8
Rikia,F,100,8,0,8
Rikiya,F,100,8,0,8
Rilda,F,100,8,0,8
Rionna,F,100,8,0,8
Roald,M,100,0,8,8
Roanin,M,100,0,8,8
Rochester,M,100,0,8,8
Rockeem,M,100,0,8,8
Rodrica,F,100,8,0,8
Roha,F,100,8,0,8
Rolisha,F,100,8,0,8
Romio,M,100,0,8,8
Ronyn,M,100,0,8,8
Rosabell,F,100,8,0,8
Rosean,M,100,0,8,8
Roshandra,F,100,8,0,8
Roshun,M,100,0,8,8
Rossano,M,100,0,8,8
Rotasha,F,100,8,0,8
Royalti,F,100,8,0,8
Royd,M,100,0,8,8
Roze,F,100,8,0,8
Rozlin,F,100,8,0,8
Rucker,M,100,0,8,8
Ruckus,M,100,0,8,8
Ruvi,F,100,8,0,8
Ryanmichael,M,100,0,8,8
Ryannah,F,100,8,0,8
Ryant,M,100,0,8,8
Ryelyn,F,100,8,0,8
Rynesha,F,100,8,0,8
Ryze,M,100,0,8,8
Saagar,M,100,0,8,8
Saam,M,100,0,8,8
Sadarius,M,100,0,8,8
Sadieann,F,100,8,0,8
Safire,F,100,8,0,8
Saga,F,100,8,0,8
Sahanna,F,100,8,0,8
Sahari,F,100,8,0,8
Sahibdeep,M,100,0,8,8
Sahvannah,F,100,8,0,8
Sahwn,M,100,0,8,8
Saicharan,M,100,0,8,8
Saimon,M,100,0,8,8
Saish,M,100,0,8,8
Saivion,M,100,0,8,8
Salene,F,100,8,0,8
Samadhi,F,100,8,0,8
Samanthalee,F,100,8,0,8
Samanthan,F,100,8,0,8
Samariya,F,100,8,0,8
Samatar,M,100,0,8,8
Saminah,F,100,8,0,8
Samwise,M,100,0,8,8
Santiel,M,100,0,8,8
Sanvitha,F,100,8,0,8
Sanyi,F,100,8,0,8
Saphera,F,100,8,0,8
Saraelizabeth,F,100,8,0,8
Saraji,F,100,8,0,8
Sariel,M,100,0,8,8
Sarisha,F,100,8,0,8
Sashay,F,100,8,0,8
Savan,M,100,0,8,8
Savanha,F,100,8,0,8
Savaughn,M,100,0,8,8
Savreen,F,100,8,0,8
Schelly,F,100,8,0,8
Seddrick,M,100,0,8,8
Sehej,F,100,8,0,8
Sehrish,F,100,8,0,8
Semajah,F,100,8,0,8
Semeka,F,100,8,0,8
Sephina,F,100,8,0,8
Serana,F,100,8,0,8
Sesha,F,100,8,0,8
Sesley,F,100,8,0,8
Sethe,M,100,0,8,8
Severa,F,100,8,0,8
Shaconda,F,100,8,0,8
Shafin,M,100,0,8,8
Shahmir,M,100,0,8,8
Shakarra,F,100,8,0,8
Shakeva,F,100,8,0,8
Shakeyla,F,100,8,0,8
Shaleia,F,100,8,0,8
Shalva,F,100,8,0,8
Shambhavi,F,100,8,0,8
Shamela,F,100,8,0,8
Shamor,M,100,0,8,8
Shaneal,F,100,8,0,8
Shanera,F,100,8,0,8
Shaniquah,F,100,8,0,8
Shanira,F,100,8,0,8
Shannika,F,100,8,0,8
Shanquia,F,100,8,0,8
Shanteal,F,100,8,0,8
Shaolin,F,100,8,0,8
Shaquasha,F,100,8,0,8
Sharalee,F,100,8,0,8
Sharis,F,100,8,0,8
Sharlisa,F,100,8,0,8
Sharneka,F,100,8,0,8
Sharnese,F,100,8,0,8
Sharvon,F,100,8,0,8
Shatana,F,100,8,0,8
Shatasia,F,100,8,0,8
Shatiya,F,100,8,0,8
Shatona,F,100,8,0,8
Shaunetta,F,100,8,0,8
Shaunteria,F,100,8,0,8
Shavonia,F,100,8,0,8
Shawniqua,F,100,8,0,8
Shawntina,F,100,8,0,8
Sheeba,F,100,8,0,8
Shelsie,F,100,8,0,8
Shemecka,F,100,8,0,8
Shenel,F,100,8,0,8
Shentel,F,100,8,0,8
Sheradyn,F,100,8,0,8
Sheranda,F,100,8,0,8
Sheray,F,100,8,0,8
Sherby,F,100,8,0,8
Sherlock,M,100,0,8,8
Shernice,F,100,8,0,8
Sherrlyn,F,100,8,0,8
Sherrylyn,F,100,8,0,8
Sherrylynn,F,100,8,0,8
Shervon,F,100,8,0,8
Shevone,F,100,8,0,8
Sheyanna,F,100,8,0,8
Sheylin,F,100,8,0,8
Shikita,F,100,8,0,8
Shinae,F,100,8,0,8
Shireka,F,100,8,0,8
Shivesh,M,100,0,8,8
Shiyanne,F,100,8,0,8
Shonica,F,100,8,0,8
Shontina,F,100,8,0,8
Shrenik,M,100,0,8,8
Shunika,F,100,8,0,8
Shyree,F,100,8,0,8
Simmon,M,100,0,8,8
Simrit,F,100,8,0,8
Siriah,F,100,8,0,8
Sirina,F,100,8,0,8
Siris,M,100,0,8,8
Skylei,F,100,8,0,8
Skyra,F,100,8,0,8
Smaya,F,100,8,0,8
Soe,M,100,0,8,8
Sohrob,M,100,0,8,8
Somara,F,100,8,0,8
Soniyah,F,100,8,0,8
Sonta,F,100,8,0,8
Sopheya,F,100,8,0,8
Soyna,F,100,8,0,8
Srithik,M,100,0,8,8
Sruly,M,100,0,8,8
Sruti,F,100,8,0,8
Stanisha,F,100,8,0,8
Stanislaus,M,100,0,8,8
Staysha,F,100,8,0,8
Steed,M,100,0,8,8
Storme,F,100,8,0,8
Suezanne,F,100,8,0,8
Suly,F,100,8,0,8
Sunna,F,100,8,0,8
Suria,F,100,8,0,8
Suriel,M,100,0,8,8
Sushanth,M,100,0,8,8
Suszanne,F,100,8,0,8
Suttyn,F,100,8,0,8
Sybilla,F,100,8,0,8
Tabb,M,100,0,8,8
Tacuma,M,100,0,8,8
Taejah,F,100,8,0,8
Taejzon,M,100,0,8,8
Taeron,M,100,0,8,8
Taiquan,M,100,0,8,8
Taishima,F,100,8,0,8
Tajane,F,100,8,0,8
Takahiro,M,100,0,8,8
Takyia,F,100,8,0,8
Taleeah,F,100,8,0,8
Talhia,F,100,8,0,8
Taliesin,M,100,0,8,8
Tamaka,F,100,8,0,8
Tamatoa,M,100,0,8,8
Tamilyn,F,100,8,0,8
Tanekia,F,100,8,0,8
Tanette,F,100,8,0,8
Tanique,F,100,8,0,8
Tanitra,F,100,8,0,8
Tannaz,F,100,8,0,8
Tantanea,F,100,8,0,8
Tanuj,M,100,0,8,8
Taraoluwa,F,100,8,0,8
Tarijah,F,100,8,0,8
Tarla,F,100,8,0,8
Taryne,F,100,8,0,8
Tashunda,F,100,8,0,8
Tatyanah,F,100,8,0,8
Taunja,F,100,8,0,8
Tavarres,M,100,0,8,8
Tavonte,M,100,0,8,8
Tayjah,F,100,8,0,8
Teairah,F,100,8,0,8
Teaire,F,100,8,0,8
Tecumseh,M,100,0,8,8
Tegh,M,100,0,8,8
Teneika,F,100,8,0,8
Tenelle,F,100,8,0,8
Tennisha,F,100,8,0,8
Teontae,M,100,0,8,8
Teosha,F,100,8,0,8
Tersea,F,100,8,0,8
Thaliah,F,100,8,0,8
Thana,F,100,8,0,8
Theophile,M,100,0,8,8
Thomasjames,M,100,0,8,8
Tiaja,F,100,8,0,8
Tianda,F,100,8,0,8
Tiawanna,F,100,8,0,8
Tiina,F,100,8,0,8
Timari,M,100,0,8,8
Timberlynn,F,100,8,0,8
Timmey,M,100,0,8,8
Tiombe,F,100,8,0,8
Tiondra,F,100,8,0,8
Tionni,F,100,8,0,8
Tnia,F,100,8,0,8
Tobechi,M,100,0,8,8
Toccara,F,100,8,0,8
Tomaz,M,100,0,8,8
Tomothy,M,100,0,8,8
Tondelayo,F,100,8,0,8
Tood,M,100,0,8,8
Topher,M,100,0,8,8
Torii,F,100,8,0,8
Toshi,F,100,8,0,8
Traden,M,100,0,8,8
Traeh,F,100,8,0,8
Trager,M,100,0,8,8
Traneshia,F,100,8,0,8
Travez,M,100,0,8,8
Trayonna,F,100,8,0,8
Trejuan,M,100,0,8,8
Trejure,F,100,8,0,8
Tremar,M,100,0,8,8
Tressy,F,100,8,0,8
Trino,M,100,0,8,8
Trisia,F,100,8,0,8
Tristy,F,100,8,0,8
Trone,M,100,0,8,8
Troylynn,F,100,8,0,8
Tuwanda,F,100,8,0,8
Twanya,F,100,8,0,8
Tyaja,F,100,8,0,8
Tyashia,F,100,8,0,8
Tyjay,M,100,0,8,8
Tyking,M,100,0,8,8
Tylique,M,100,0,8,8
Tyreque,M,100,0,8,8
Tyse,M,100,0,8,8
Tyshan,M,100,0,8,8
Tyshika,F,100,8,0,8
Tytiona,F,100,8,0,8
Tytionna,F,100,8,0,8
Tywann,M,100,0,8,8
Ullanda,F,100,8,0,8
Ulrica,F,100,8,0,8
Ulyess,M,100,0,8,8
Umme,F,100,8,0,8
Usbaldo,M,100,0,8,8
Valdis,M,100,0,8,8
Valek,M,100,0,8,8
Vamsi,M,100,0,8,8
Venelope,F,100,8,0,8
Vennesa,F,100,8,0,8
Verenis,F,100,8,0,8
Vershawn,M,100,0,8,8
Vetta,F,100,8,0,8
Veya,F,100,8,0,8
Vicken,M,100,0,8,8
Vidhur,M,100,0,8,8
Vidia,F,100,8,0,8
Vika,F,100,8,0,8
Villa,F,100,8,0,8
Ville,M,100,0,8,8
Vilmarie,F,100,8,0,8
Vonte,M,100,0,8,8
Voris,M,100,0,8,8
Voss,M,100,0,8,8
Wa,M,100,0,8,8
Waldron,M,100,0,8,8
Wale,M,100,0,8,8
Waniya,F,100,8,0,8
Waqas,M,100,0,8,8
Warrior,M,100,0,8,8
Wataru,M,100,0,8,8
Watt,M,100,0,8,8
Waverley,F,100,8,0,8
Wendal,M,100,0,8,8
Whitton,M,100,0,8,8
Willoe,F,100,8,0,8
Willye,F,100,8,0,8
Xandar,M,100,0,8,8
Xang,M,100,0,8,8
Xaylee,F,100,8,0,8
Xiao,F,100,8,0,8
Xola,F,100,8,0,8
Xzariah,F,100,8,0,8
Yaara,F,100,8,0,8
Yaileny,F,100,8,0,8
Yaisa,F,100,8,0,8
Yama,M,100,0,8,8
Yannet,F,100,8,0,8
Yaresli,F,100,8,0,8
Yasenia,F,100,8,0,8
Yashas,M,100,0,8,8
Yasheka,F,100,8,0,8
Yaslynn,F,100,8,0,8
Yavette,F,100,8,0,8
Yelixa,F,100,8,0,8
Yenesis,F,100,8,0,8
Yerai,M,100,0,8,8
Yessika,F,100,8,0,8
Yia,M,100,0,8,8
Yian,M,100,0,8,8
Yimi,M,100,0,8,8
Yolandra,F,100,8,0,8
Yolaunda,F,100,8,0,8
Yomari,F,100,8,0,8
Yonael,M,100,0,8,8
Yoriel,M,100,0,8,8
Yosha,F,100,8,0,8
Yudelka,F,100,8,0,8
Yuika,F,100,8,0,8
Yulieth,F,100,8,0,8
Yuneisy,F,100,8,0,8
Yurianna,F,100,8,0,8
Yusha,M,100,0,8,8
Yutong,F,100,8,0,8
Yuxuan,M,100,0,8,8
Yzabel,F,100,8,0,8
Zabella,F,100,8,0,8
Zackarey,M,100,0,8,8
Zacorey,M,100,0,8,8
Zadarius,M,100,0,8,8
Zaedin,M,100,0,8,8
Zaeleigh,F,100,8,0,8
Zaelin,M,100,0,8,8
Zakyrah,F,100,8,0,8
Zakyria,F,100,8,0,8
Zalena,F,100,8,0,8
Zalie,F,100,8,0,8
Zamariya,F,100,8,0,8
Zamauri,M,100,0,8,8
Zamaurion,M,100,0,8,8
Zandyn,M,100,0,8,8
Zaniyha,F,100,8,0,8
Zanobia,F,100,8,0,8
Zantavious,M,100,0,8,8
Zareia,F,100,8,0,8
Zarrea,F,100,8,0,8
Zebulin,M,100,0,8,8
Zeddicus,M,100,0,8,8
Zelah,F,100,8,0,8
Zenani,F,100,8,0,8
Zepplin,M,100,0,8,8
Zevion,M,100,0,8,8
Zeyd,M,100,0,8,8
Zeyna,F,100,8,0,8
Zhania,F,100,8,0,8
Zierra,F,100,8,0,8
Zimir,M,100,0,8,8
Zimora,F,100,8,0,8
Zira,F,100,8,0,8
Znya,F,100,8,0,8
Zyannah,F,100,8,0,8
Zymeria,F,100,8,0,8
Aadvika,F,100,7,0,7
Aakilah,F,100,7,0,7
Aaleahya,F,100,7,0,7
Aaliyahrose,F,100,7,0,7
Aaliyiah,F,100,7,0,7
Aanaya,F,100,7,0,7
Aaqil,M,100,0,7,7
Aareona,F,100,7,0,7
Aarthi,F,100,7,0,7
Aason,M,100,0,7,7
Aava,F,100,7,0,7
Aavion,M,100,0,7,7
Aayaan,M,100,0,7,7
Abasi,M,100,0,7,7
Abbiegale,F,100,7,0,7
Abbriella,F,100,7,0,7
Abdelkarim,M,100,0,7,7
Abdulhamid,M,100,0,7,7
Abernathy,F,100,7,0,7
Abigahil,F,100,7,0,7
Abirami,F,100,7,0,7
Abish,F,100,7,0,7
Abundio,M,100,0,7,7
Ac,M,100,0,7,7
Adahir,M,100,0,7,7
Adalayde,F,100,7,0,7
Adaliene,F,100,7,0,7
Adayla,F,100,7,0,7
Addysun,F,100,7,0,7
Adelay,F,100,7,0,7
Adelicia,F,100,7,0,7
Adelinn,F,100,7,0,7
Adhvika,F,100,7,0,7
Adilena,F,100,7,0,7
Adoria,F,100,7,0,7
Adriah,F,100,7,0,7
Adriahna,F,100,7,0,7
Adrieana,F,100,7,0,7
Adrika,F,100,7,0,7
Ady,F,100,7,0,7
Aelynn,F,100,7,0,7
Afrin,F,100,7,0,7
Afshan,F,100,7,0,7
Aften,F,100,7,0,7
Agna,F,100,7,0,7
Ahadu,M,100,0,7,7
Ahmeir,M,100,0,7,7
Ahmina,F,100,7,0,7
Ahonesti,F,100,7,0,7
Ahzir,M,100,0,7,7
Ailisa,F,100,7,0,7
Ainhara,F,100,7,0,7
Airah,F,100,7,0,7
Aireon,M,100,0,7,7
Aires,M,100,0,7,7
Aisaiah,M,100,0,7,7
Aisatou,F,100,7,0,7
Aisla,F,100,7,0,7
Aitan,M,100,0,7,7
Ajeet,M,100,0,7,7
Akaila,F,100,7,0,7
Akaiyah,F,100,7,0,7
Akaya,F,100,7,0,7
Akeena,F,100,7,0,7
Akesha,F,100,7,0,7
Akima,F,100,7,0,7
Akito,M,100,0,7,7
Alaan,M,100,0,7,7
Alajia,F,100,7,0,7
Alajiah,F,100,7,0,7
Alameen,M,100,0,7,7
Alastor,M,100,0,7,7
Alauni,F,100,7,0,7
Aleacia,F,100,7,0,7
Aleathia,F,100,7,0,7
Aleene,F,100,7,0,7
Alejos,M,100,0,7,7
Alekai,M,100,0,7,7
Alette,F,100,7,0,7
Alexee,F,100,7,0,7
Alexeia,F,100,7,0,7
Alexsus,F,100,7,0,7
Alexyz,F,100,7,0,7
Aleyiah,F,100,7,0,7
Alezae,F,100,7,0,7
Aliaya,F,100,7,0,7
Aliciamarie,F,100,7,0,7
Aliece,F,100,7,0,7
Alijiah,M,100,0,7,7
Alisi,F,100,7,0,7
Alissha,F,100,7,0,7
Alizeah,F,100,7,0,7
Aljohara,F,100,7,0,7
Allecia,F,100,7,0,7
Allinson,F,100,7,0,7
Allizzon,F,100,7,0,7
Allyannah,F,100,7,0,7
Alman,M,100,0,7,7
Alper,M,100,0,7,7
Alprentice,M,100,0,7,7
Altamease,F,100,7,0,7
Aluel,F,100,7,0,7
Alvarez,M,100,0,7,7
Alveria,F,100,7,0,7
Alvetta,F,100,7,0,7
Alvey,M,100,0,7,7
Alyca,F,100,7,0,7
Alyxandrea,F,100,7,0,7
Amalee,F,100,7,0,7
Amandamarie,F,100,7,0,7
Amarea,F,100,7,0,7
Amareon,M,100,0,7,7
Amayla,F,100,7,0,7
Ambri,F,100,7,0,7
Ameyalli,F,100,7,0,7
Amierah,F,100,7,0,7
Amiliah,F,100,7,0,7
Amirjon,M,100,0,7,7
Amma,F,100,7,0,7
Amondo,M,100,0,7,7
Anaclara,F,100,7,0,7
Anajia,F,100,7,0,7
Analyz,F,100,7,0,7
Anan,M,100,0,7,7
Anarah,F,100,7,0,7
Anavae,F,100,7,0,7
Anavi,F,100,7,0,7
Andjela,F,100,7,0,7
Andrus,M,100,0,7,7
Anedra,F,100,7,0,7
Angalena,F,100,7,0,7
Angelamarie,F,100,7,0,7
Angeleia,F,100,7,0,7
Angeljesus,M,100,0,7,7
Anibelle,F,100,7,0,7
Aniiyah,F,100,7,0,7
Anijha,F,100,7,0,7
Anisty,F,100,7,0,7
Anjannette,F,100,7,0,7
Anjeliett,F,100,7,0,7
Anjulie,F,100,7,0,7
Annabellee,F,100,7,0,7
Annakaren,F,100,7,0,7
Annalayah,F,100,7,0,7
Annastazia,F,100,7,0,7
Anniesha,F,100,7,0,7
Annissia,F,100,7,0,7
Annzlee,F,100,7,0,7
Anothny,M,100,0,7,7
Anslea,F,100,7,0,7
Antanique,F,100,7,0,7
Antino,M,100,0,7,7
Antionetta,F,100,7,0,7
Antonin,M,100,0,7,7
Anvit,M,100,0,7,7
Anye,F,100,7,0,7
Anyliah,F,100,7,0,7
Anyston,F,100,7,0,7
Anzel,M,100,0,7,7
Appolonia,F,100,7,0,7
Apryle,F,100,7,0,7
Aquilino,M,100,0,7,7
Aquita,F,100,7,0,7
Araeya,F,100,7,0,7
Aralia,F,100,7,0,7
Arbaz,M,100,0,7,7
Arceli,F,100,7,0,7
Archan,M,100,0,7,7
Archivaldo,M,100,0,7,7
Ardiana,F,100,7,0,7
Ardin,M,100,0,7,7
Aremi,F,100,7,0,7
Argyle,M,100,0,7,7
Ariebella,F,100,7,0,7
Arieyana,F,100,7,0,7
Aristidis,M,100,0,7,7
Arkan,M,100,0,7,7
Arkham,M,100,0,7,7
Armanni,M,100,0,7,7
Armenta,F,100,7,0,7
Armentha,F,100,7,0,7
Armetta,F,100,7,0,7
Arn,M,100,0,7,7
Arnessa,F,100,7,0,7
Aroosh,F,100,7,0,7
Arriya,F,100,7,0,7
Arriyanna,F,100,7,0,7
Aryann,F,100,7,0,7
Aryash,M,100,0,7,7
Aryus,M,100,0,7,7
Asahi,M,100,0,7,7
Asalah,F,100,7,0,7
Ascension,M,100,0,7,7
Asees,F,100,7,0,7
Asena,F,100,7,0,7
Ashaley,F,100,7,0,7
Ashantii,F,100,7,0,7
Asheli,F,100,7,0,7
Ashelynn,F,100,7,0,7
Asherah,F,100,7,0,7
Ashir,M,100,0,7,7
Ashkii,M,100,0,7,7
Ashkon,M,100,0,7,7
Ashleylynn,F,100,7,0,7
Ashonda,F,100,7,0,7
Asijah,F,100,7,0,7
Assante,M,100,0,7,7
Asti,F,100,7,0,7
Astor,M,100,0,7,7
Atakan,M,100,0,7,7
Athenia,F,100,7,0,7
Attalia,F,100,7,0,7
Attison,F,100,7,0,7
Audreigh,F,100,7,0,7
Audrieanna,F,100,7,0,7
Aunah,F,100,7,0,7
Aunalee,F,100,7,0,7
Aung,M,100,0,7,7
Auren,M,100,0,7,7
Auriya,F,100,7,0,7
Auriyah,F,100,7,0,7
Ausencio,M,100,0,7,7
Austi,F,100,7,0,7
Austinmichael,M,100,0,7,7
Autherine,F,100,7,0,7
Auturo,M,100,0,7,7
Avalei,F,100,7,0,7
Avalena,F,100,7,0,7
Avanya,F,100,7,0,7
Avlynn,F,100,7,0,7
Avyonna,F,100,7,0,7
Axis,M,100,0,7,7
Ayalah,F,100,7,0,7
Aydriana,F,100,7,0,7
Ayeza,F,100,7,0,7
Ayleah,F,100,7,0,7
Ayli,F,100,7,0,7
Ayliah,F,100,7,0,7
Aylynn,F,100,7,0,7
Aymaan,M,100,0,7,7
Aynara,F,100,7,0,7
Ayren,M,100,0,7,7
Ayveri,F,100,7,0,7
Ayverie,F,100,7,0,7
Azaylee,F,100,7,0,7
Azeriah,F,100,7,0,7
Azita,F,100,7,0,7
Azori,F,100,7,0,7
Azreal,M,100,0,7,7
Bach,M,100,0,7,7
Badal,M,100,0,7,7
Baize,M,100,0,7,7
Baptiste,M,100,0,7,7
Barkim,M,100,0,7,7
Barnet,M,100,0,7,7
Bavly,M,100,0,7,7
Bayro,M,100,0,7,7
Beanna,F,100,7,0,7
Beige,F,100,7,0,7
Belisario,M,100,0,7,7
Belize,F,100,7,0,7
Belkys,F,100,7,0,7
Bellami,F,100,7,0,7
Benisha,F,100,7,0,7
Bereniz,F,100,7,0,7
Bernina,F,100,7,0,7
Bernis,M,100,0,7,7
Beryle,F,100,7,0,7
Besim,M,100,0,7,7
Beuford,M,100,0,7,7
Beyonka,F,100,7,0,7
Bhumika,F,100,7,0,7
Bhuvan,M,100,0,7,7
Bianco,F,100,7,0,7
Birt,M,100,0,7,7
Bismah,F,100,7,0,7
Bly,M,100,0,7,7
Bodyn,M,100,0,7,7
Bonanza,M,100,0,7,7
Bosie,M,100,0,7,7
Bostynn,F,100,7,0,7
Brackston,M,100,0,7,7
Braham,M,100,0,7,7
Braniah,F,100,7,0,7
Branten,M,100,0,7,7
Branwyn,F,100,7,0,7
Brayland,M,100,0,7,7
Breeauna,F,100,7,0,7
Breeleigh,F,100,7,0,7
Breighton,M,100,0,7,7
Brenay,F,100,7,0,7
Brenisha,F,100,7,0,7
Brenlynn,F,100,7,0,7
Brennley,F,100,7,0,7
Brezlynn,F,100,7,0,7
Brialle,F,100,7,0,7
Briante,F,100,7,0,7
Brichelle,F,100,7,0,7
Brig,M,100,0,7,7
Britleigh,F,100,7,0,7
Britthany,F,100,7,0,7
Brittiani,F,100,7,0,7
Brittinay,F,100,7,0,7
Brittinee,F,100,7,0,7
Britttany,F,100,7,0,7
Brnadon,M,100,0,7,7
Broly,M,100,0,7,7
Bryanda,F,100,7,0,7
Brycon,M,100,0,7,7
Bryhana,F,100,7,0,7
Bryland,M,100,0,7,7
Brynnli,F,100,7,0,7
Brytanie,F,100,7,0,7
Bukhari,M,100,0,7,7
Burgandy,F,100,7,0,7
Burklee,F,100,7,0,7
Cabrielle,F,100,7,0,7
Cadian,M,100,0,7,7
Caitlyne,F,100,7,0,7
Caiyah,F,100,7,0,7
Caleyah,F,100,7,0,7
Calianne,F,100,7,0,7
Calijah,M,100,0,7,7
Caliope,F,100,7,0,7
Calliah,F,100,7,0,7
Calliana,F,100,7,0,7
Callye,F,100,7,0,7
Callysta,F,100,7,0,7
Camaro,F,100,7,0,7
Camary,F,100,7,0,7
Cambreigh,F,100,7,0,7
Camdynn,F,100,7,0,7
Camee,F,100,7,0,7
Camera,F,100,7,0,7
Camerron,M,100,0,7,7
Candiace,F,100,7,0,7
Cania,F,100,7,0,7
Canice,F,100,7,0,7
Canishia,F,100,7,0,7
Canita,F,100,7,0,7
Cantrece,F,100,7,0,7
Caolan,M,100,0,7,7
Caran,F,100,7,0,7
Cardier,M,100,0,7,7
Carisha,F,100,7,0,7
Carlasia,F,100,7,0,7
Carriann,F,100,7,0,7
Carsynn,F,100,7,0,7
Cartavious,M,100,0,7,7
Cartney,F,100,7,0,7
Caryss,F,100,7,0,7
Cashay,F,100,7,0,7
Cashen,M,100,0,7,7
Cashtyn,M,100,0,7,7
Caslyn,F,100,7,0,7
Cassiana,F,100,7,0,7
Cataleah,F,100,7,0,7
Catalino,M,100,0,7,7
Catara,F,100,7,0,7
Catelaya,F,100,7,0,7
Cateleya,F,100,7,0,7
Caterin,F,100,7,0,7
Cathaleya,F,100,7,0,7
Catheleen,F,100,7,0,7
Cathia,F,100,7,0,7
Cathlin,F,100,7,0,7
Caulin,M,100,0,7,7
Cavanaugh,M,100,0,7,7
Caylea,F,100,7,0,7
Caylinn,F,100,7,0,7
Caynan,M,100,0,7,7
Cayvion,M,100,0,7,7
Cazzie,M,100,0,7,7
Cecelie,F,100,7,0,7
Cederic,M,100,0,7,7
Ceon,M,100,0,7,7
Cerria,F,100,7,0,7
Cerrone,M,100,0,7,7
Cesarina,F,100,7,0,7
Cesley,F,100,7,0,7
Cezanne,F,100,7,0,7
Chadly,M,100,0,7,7
Chakara,F,100,7,0,7
Chalea,F,100,7,0,7
Chamere,F,100,7,0,7
Chantina,F,100,7,0,7
Chantise,F,100,7,0,7
Charda,F,100,7,0,7
Charene,F,100,7,0,7
Charlia,F,100,7,0,7
Charlyze,F,100,7,0,7
Charnese,F,100,7,0,7
Charnika,F,100,7,0,7
Charny,F,100,7,0,7
Charrell,F,100,7,0,7
Charvette,F,100,7,0,7
Chaslynn,F,100,7,0,7
Chayenne,F,100,7,0,7
Chaysten,M,100,0,7,7
Chedva,F,100,7,0,7
Cheisea,F,100,7,0,7
Chelbi,F,100,7,0,7
Chelli,F,100,7,0,7
Chenay,F,100,7,0,7
Chenee,F,100,7,0,7
Cheray,F,100,7,0,7
Cherrise,F,100,7,0,7
Chervonne,F,100,7,0,7
Cheryllynn,F,100,7,0,7
Chestina,F,100,7,0,7
Chestine,F,100,7,0,7
Chilton,M,100,0,7,7
Chou,M,100,0,7,7
Chrishanna,F,100,7,0,7
Christianjoseph,M,100,0,7,7
Christianpaul,M,100,0,7,7
Christiyana,F,100,7,0,7
Christophermich,M,100,0,7,7
Chritian,M,100,0,7,7
Chrles,M,100,0,7,7
Chrsitina,F,100,7,0,7
Chu,M,100,0,7,7
Cici,F,100,7,0,7
Ciin,F,100,7,0,7
Ciniya,F,100,7,0,7
Cinzia,F,100,7,0,7
Clarabella,F,100,7,0,7
Claudinette,F,100,7,0,7
Claybon,M,100,0,7,7
Cleofas,M,100,0,7,7
Cleora,F,100,7,0,7
Cloria,F,100,7,0,7
Cnythia,F,100,7,0,7
Coast,M,100,0,7,7
Cobalt,M,100,0,7,7
Cobee,M,100,0,7,7
Cogan,M,100,0,7,7
Cohyn,M,100,0,7,7
Coit,M,100,0,7,7
Coleridge,M,100,0,7,7
Colesyn,M,100,0,7,7
Conal,M,100,0,7,7
Conesha,F,100,7,0,7
Coralyne,F,100,7,0,7
Cordasia,F,100,7,0,7
Cordelro,M,100,0,7,7
Cordia,F,100,7,0,7
Coriann,F,100,7,0,7
Corielle,F,100,7,0,7
Corlette,F,100,7,0,7
Cormari,M,100,0,7,7
Corrissa,F,100,7,0,7
Cortasia,F,100,7,0,7
Cortlan,M,100,0,7,7
Cortrell,M,100,0,7,7
Coua,F,100,7,0,7
Courney,F,100,7,0,7
Crash,M,100,0,7,7
Creedance,F,100,7,0,7
Creeden,M,100,0,7,7
Crescent,F,100,7,0,7
Crespin,M,100,0,7,7
Crisette,F,100,7,0,7
Cristalle,F,100,7,0,7
Crysten,F,100,7,0,7
Crystie,F,100,7,0,7
Cybill,F,100,7,0,7
Cyinthia,F,100,7,0,7
Cynthis,F,100,7,0,7
Daaiel,M,100,0,7,7
Daana,F,100,7,0,7
Daanya,F,100,7,0,7
Dabid,M,100,0,7,7
Dache,F,100,7,0,7
Dack,M,100,0,7,7
Daejuan,M,100,0,7,7
Daela,F,100,7,0,7
Daffne,F,100,7,0,7
Dafney,F,100,7,0,7
Dahlilah,F,100,7,0,7
Dahlyla,F,100,7,0,7
Dailah,F,100,7,0,7
Dailany,F,100,7,0,7
Daimarion,M,100,0,7,7
Dainel,M,100,0,7,7
Daishanae,F,100,7,0,7
Daizhaun,M,100,0,7,7
Dajanai,F,100,7,0,7
Dajsha,F,100,7,0,7
Dajun,M,100,0,7,7
Dakaria,F,100,7,0,7
Dakarri,M,100,0,7,7
Dakeem,M,100,0,7,7
Dakin,M,100,0,7,7
Dakira,F,100,7,0,7
Daleyah,F,100,7,0,7
Dalonda,F,100,7,0,7
Dam,M,100,0,7,7
Damarea,M,100,0,7,7
Damarria,F,100,7,0,7
Damaury,M,100,0,7,7
Danait,F,100,7,0,7
Danamarie,F,100,7,0,7
Danecia,F,100,7,0,7
Daneli,F,100,7,0,7
Dangello,M,100,0,7,7
Danieal,M,100,0,7,7
Dannaly,F,100,7,0,7
Dannial,M,100,0,7,7
Danniele,F,100,7,0,7
Danyette,F,100,7,0,7
Danyia,F,100,7,0,7
Danyiel,F,100,7,0,7
Daquisha,F,100,7,0,7
Daquita,F,100,7,0,7
Darain,M,100,0,7,7
Daraly,F,100,7,0,7
Darean,M,100,0,7,7
Darinka,F,100,7,0,7
Darrianna,F,100,7,0,7
Darrnell,M,100,0,7,7
Darshana,F,100,7,0,7
Darylann,F,100,7,0,7
Dashal,M,100,0,7,7
Dashanna,F,100,7,0,7
Dasmond,M,100,0,7,7
Datavia,F,100,7,0,7
Davelyn,F,100,7,0,7
Daviah,F,100,7,0,7
Davinity,F,100,7,0,7
Davondre,M,100,0,7,7
Dawnisha,F,100,7,0,7
Daxson,M,100,0,7,7
Daxter,M,100,0,7,7
Dayanis,F,100,7,0,7
Daydra,F,100,7,0,7
Daylany,F,100,7,0,7
Dayli,F,100,7,0,7
Daymi,F,100,7,0,7
Dayse,F,100,7,0,7
Dazah,F,100,7,0,7
Deangalo,M,100,0,7,7
Deantrae,M,100,0,7,7
Deaveon,M,100,0,7,7
Debbera,F,100,7,0,7
Debbye,F,100,7,0,7
Debooah,F,100,7,0,7
Dechelle,F,100,7,0,7
Deckard,M,100,0,7,7
Decoda,M,100,0,7,7
Dehja,F,100,7,0,7
Deidrick,M,100,0,7,7
Deighton,M,100,0,7,7
Deilyn,F,100,7,0,7
Deiona,F,100,7,0,7
Dejanna,F,100,7,0,7
Delaili,F,100,7,0,7
Delanda,F,100,7,0,7
Deletha,F,100,7,0,7
Demark,M,100,0,7,7
Demarri,M,100,0,7,7
Demeco,M,100,0,7,7
Demeko,M,100,0,7,7
Demire,M,100,0,7,7
Demonie,M,100,0,7,7
Deneane,F,100,7,0,7
Deniesha,F,100,7,0,7
Denille,F,100,7,0,7
Denique,F,100,7,0,7
Denishea,F,100,7,0,7
Dennine,F,100,7,0,7
Deo,M,100,0,7,7
Deonni,F,100,7,0,7
Deontai,M,100,0,7,7
Dequane,M,100,0,7,7
Deriah,F,100,7,0,7
Derrall,M,100,0,7,7
Derya,F,100,7,0,7
Deryan,M,100,0,7,7
Desireah,F,100,7,0,7
Dessiah,F,100,7,0,7
Desteney,F,100,7,0,7
Destinae,F,100,7,0,7
Desyree,F,100,7,0,7
Detravious,M,100,0,7,7
Detroy,M,100,0,7,7
Detta,F,100,7,0,7
Deucalion,M,100,0,7,7
Devaj,M,100,0,7,7
Deval,M,100,0,7,7
Develle,M,100,0,7,7
Deverick,M,100,0,7,7
Deveyon,M,100,0,7,7
Devinee,F,100,7,0,7
Devionne,M,100,0,7,7
Devionte,M,100,0,7,7
Devki,F,100,7,0,7
Devoiry,F,100,7,0,7
Devrick,M,100,0,7,7
Dewitte,M,100,0,7,7
Deyjah,F,100,7,0,7
Deymar,M,100,0,7,7
Dhatri,F,100,7,0,7
Dhylan,M,100,0,7,7
Diaja,F,100,7,0,7
Dianara,F,100,7,0,7
Dianthe,F,100,7,0,7
Diar,M,100,0,7,7
Diasy,F,100,7,0,7
Dibbie,F,100,7,0,7
Diland,M,100,0,7,7
Dimarcus,M,100,0,7,7
Dionisios,M,100,0,7,7
Divisha,F,100,7,0,7
Divon,M,100,0,7,7
Divyansh,M,100,0,7,7
Divyanshi,F,100,7,0,7
Dmarrion,M,100,0,7,7
Dnia,F,100,7,0,7
Domineke,M,100,0,7,7
Dominie,M,100,0,7,7
Dominiqua,F,100,7,0,7
Dondria,F,100,7,0,7
Donnivan,M,100,0,7,7
Dontrelle,M,100,0,7,7
Donvan,M,100,0,7,7
Doritha,F,100,7,0,7
Doss,M,100,0,7,7
Doty,F,100,7,0,7
Dradyn,M,100,0,7,7
Draedyn,M,100,0,7,7
Dree,F,100,7,0,7
Drelon,M,100,0,7,7
Dreson,M,100,0,7,7
Drexler,M,100,0,7,7
Dubraska,F,100,7,0,7
Dushan,M,100,0,7,7
Duvan,M,100,0,7,7
Dwayna,F,100,7,0,7
Dyanni,F,100,7,0,7
Dylanie,F,100,7,0,7
Dynah,F,100,7,0,7
Dysen,M,100,0,7,7
Earnstine,F,100,7,0,7
Eastan,M,100,0,7,7
Eathyn,M,100,0,7,7
Edilson,M,100,0,7,7
Edmanuel,M,100,0,7,7
Edrin,M,100,0,7,7
Efthimia,F,100,7,0,7
Egon,M,100,0,7,7
Eina,F,100,7,0,7
Eita,M,100,0,7,7
Ekamveer,M,100,0,7,7
Ekrem,M,100,0,7,7
Elaf,F,100,7,0,7
Elasha,F,100,7,0,7
Eleazer,M,100,0,7,7
Eleshia,F,100,7,0,7
Elianys,F,100,7,0,7
Eliijah,M,100,0,7,7
Eliona,F,100,7,0,7
Eliset,F,100,7,0,7
Elisheba,F,100,7,0,7
Eliyanna,F,100,7,0,7
Elizzabeth,F,100,7,0,7
Eljay,M,100,0,7,7
Ellawyn,F,100,7,0,7
Eller,F,100,7,0,7
Elliemay,F,100,7,0,7
Elliston,M,100,0,7,7
Ellye,F,100,7,0,7
Elovie,F,100,7,0,7
Elrey,M,100,0,7,7
Elsah,F,100,7,0,7
Elvan,M,100,0,7,7
Elverna,F,100,7,0,7
Elvert,M,100,0,7,7
Elyes,M,100,0,7,7
Elyshia,F,100,7,0,7
Emaad,M,100,0,7,7
Emariah,F,100,7,0,7
Emelinda,F,100,7,0,7
Emeral,F,100,7,0,7
Emerik,M,100,0,7,7
Emilygrace,F,100,7,0,7
Emmelynn,F,100,7,0,7
Emrah,M,100,0,7,7
Emyiah,F,100,7,0,7
Enaiya,F,100,7,0,7
Enda,F,100,7,0,7
Enderson,M,100,0,7,7
Enga,F,100,7,0,7
Eniah,F,100,7,0,7
Ennio,M,100,0,7,7
Enriquez,M,100,0,7,7
Ensar,M,100,0,7,7
Enso,M,100,0,7,7
Enzi,M,100,0,7,7
Eralynn,F,100,7,0,7
Ertha,F,100,7,0,7
Erven,M,100,0,7,7
Eryana,F,100,7,0,7
Eshana,F,100,7,0,7
Espyn,F,100,7,0,7
Esraa,F,100,7,0,7
Etheline,F,100,7,0,7
Ethlyn,F,100,7,0,7
Eunita,F,100,7,0,7
Evagelos,M,100,0,7,7
Evalet,F,100,7,0,7
Evalyne,F,100,7,0,7
Evea,F,100,7,0,7
Evelett,F,100,7,0,7
Everlean,F,100,7,0,7
Evodio,M,100,0,7,7
Evonnie,F,100,7,0,7
Evonte,M,100,0,7,7
Exton,M,100,0,7,7
Exzavior,M,100,0,7,7
Eyuel,M,100,0,7,7
Ezion,M,100,0,7,7
Ezperanza,F,100,7,0,7
Ezrie,F,100,7,0,7
Faaiz,M,100,0,7,7
Faaris,M,100,0,7,7
Faelan,M,100,0,7,7
Faheemah,F,100,7,0,7
Falana,F,100,7,0,7
Falco,M,100,0,7,7
Faline,F,100,7,0,7
Faraday,F,100,7,0,7
Fardowsa,F,100,7,0,7
Fariba,F,100,7,0,7
Fariza,F,100,7,0,7
Farrad,M,100,0,7,7
Faylin,F,100,7,0,7
Felcia,F,100,7,0,7
Felicite,F,100,7,0,7
Felipedejesus,M,100,0,7,7
Fenna,F,100,7,0,7
Ferna,F,100,7,0,7
Ferryn,F,100,7,0,7
Fher,M,100,0,7,7
Finch,M,100,0,7,7
Flash,M,100,0,7,7
Fleta,F,100,7,0,7
Forrestine,F,100,7,0,7
Frans,M,100,0,7,7
Franshesca,F,100,7,0,7
Freada,F,100,7,0,7
Fredirick,M,100,0,7,7
Freeland,M,100,0,7,7
Freesia,F,100,7,0,7
Gabbanelli,F,100,7,0,7
Gabel,M,100,0,7,7
Gabrael,M,100,0,7,7
Gabreille,F,100,7,0,7
Gabrieal,M,100,0,7,7
Gaea,F,100,7,0,7
Gagan,M,100,0,7,7
Galylea,F,100,7,0,7
Gannyn,M,100,0,7,7
Ganyn,M,100,0,7,7
Garick,M,100,0,7,7
Garris,M,100,0,7,7
Garyon,M,100,0,7,7
Gattlin,M,100,0,7,7
Gayane,F,100,7,0,7
Gayann,F,100,7,0,7
Gearlean,F,100,7,0,7
Geissie,F,100,7,0,7
Gen,M,100,0,7,7
Genella,F,100,7,0,7
Genesiss,F,100,7,0,7
Genet,F,100,7,0,7
Gennett,F,100,7,0,7
Gent,M,100,0,7,7
Geoggrey,M,100,0,7,7
Georgeana,F,100,7,0,7
Georjean,F,100,7,0,7
Gerarda,F,100,7,0,7
Gerardette,F,100,7,0,7
Gerie,F,100,7,0,7
Gerone,M,100,0,7,7
Ghadah,F,100,7,0,7
Ghina,F,100,7,0,7
Giamarie,F,100,7,0,7
Gianetta,F,100,7,0,7
Giannamarie,F,100,7,0,7
Gianncarlo,M,100,0,7,7
Giavona,F,100,7,0,7
Gibbs,M,100,0,7,7
Gift,F,100,7,0,7
Gionny,M,100,0,7,7
Giyanna,F,100,7,0,7
Gizzelle,F,100,7,0,7
Gjon,M,100,0,7,7
Glanda,F,100,7,0,7
Glendaliz,F,100,7,0,7
Glora,F,100,7,0,7
Gloris,F,100,7,0,7
Glynna,F,100,7,0,7
Goeffrey,M,100,0,7,7
Gor,M,100,0,7,7
Goran,M,100,0,7,7
Gradie,M,100,0,7,7
Grandville,M,100,0,7,7
Gretchin,F,100,7,0,7
Greyer,M,100,0,7,7
Greysyn,M,100,0,7,7
Guilian,M,100,0,7,7
Guilliana,F,100,7,0,7
Gunnarr,M,100,0,7,7
Gurneet,F,100,7,0,7
Gwendel,F,100,7,0,7
Gwenlyn,F,100,7,0,7
Gwinda,F,100,7,0,7
Gyzelle,F,100,7,0,7
Haani,F,100,7,0,7
Hadarah,F,100,7,0,7
Hadasah,F,100,7,0,7
Hadlyn,F,100,7,0,7
Haila,F,100,7,0,7
Hajun,M,100,0,7,7
Halaya,F,100,7,0,7
Hallelujah,F,100,7,0,7
Hallye,F,100,7,0,7
Halsten,M,100,0,7,7
Hamadi,M,100,0,7,7
Hanae,F,100,7,0,7
Hanford,M,100,0,7,7
Hannaha,F,100,7,0,7
Hannahrose,F,100,7,0,7
Hanzo,M,100,0,7,7
Happiness,F,100,7,0,7
Hargis,M,100,0,7,7
Harshit,M,100,0,7,7
Harshith,M,100,0,7,7
Hassell,M,100,0,7,7
Hayslee,F,100,7,0,7
Hayyan,M,100,0,7,7
Hazal,F,100,7,0,7
Hazim,M,100,0,7,7
Heavenli,F,100,7,0,7
Helix,M,100,0,7,7
Helon,F,100,7,0,7
Hema,F,100,7,0,7
Henesis,F,100,7,0,7
Henly,F,100,7,0,7
Herberto,M,100,0,7,7
Herma,F,100,7,0,7
Heshy,M,100,0,7,7
Hessie,F,100,7,0,7
Himanshu,M,100,0,7,7
Hinako,F,100,7,0,7
Hiroaki,M,100,0,7,7
Hoan,M,100,0,7,7
Hollan,F,100,7,0,7
Holliann,F,100,7,0,7
Hollice,M,100,0,7,7
Honi,F,100,7,0,7
Hooriya,F,100,7,0,7
Hovik,M,100,0,7,7
Hrishi,M,100,0,7,7
Hristina,F,100,7,0,7
Hser,F,100,7,0,7
Huan,M,100,0,7,7
Hughston,M,100,0,7,7
Hulan,M,100,0,7,7
Hulises,M,100,0,7,7
Hunberto,M,100,0,7,7
Husnain,M,100,0,7,7
Hutchison,M,100,0,7,7
Hyder,M,100,0,7,7
Hye,F,100,7,0,7
Ibukunoluwa,F,100,7,0,7
Icyss,F,100,7,0,7
Ihsaan,M,100,0,7,7
Ikeria,F,100,7,0,7
Ilay,M,100,0,7,7
Ilayah,F,100,7,0,7
Ilithya,F,100,7,0,7
Ilyaas,M,100,0,7,7
Ilyan,M,100,0,7,7
Imhotep,M,100,0,7,7
Indea,F,100,7,0,7
Indee,F,100,7,0,7
Inderpreet,M,100,0,7,7
Indika,F,100,7,0,7
Infantboy,M,100,0,7,7
Ingemar,M,100,0,7,7
Ingo,M,100,0,7,7
Inshirah,F,100,7,0,7
Iracema,F,100,7,0,7
Irany,F,100,7,0,7
Iremide,M,100,0,7,7
Iridiana,F,100,7,0,7
Irielle,F,100,7,0,7
Iryna,F,100,7,0,7
Isabelah,F,100,7,0,7
Ishawn,M,100,0,7,7
Ishea,F,100,7,0,7
Ishitha,F,100,7,0,7
Ishwari,F,100,7,0,7
Isolina,F,100,7,0,7
Israh,F,100,7,0,7
Itasha,F,100,7,0,7
Itaty,F,100,7,0,7
Itsuki,M,100,0,7,7
Itzuri,F,100,7,0,7
Ivah,F,100,7,0,7
Ivionna,F,100,7,0,7
Iwona,F,100,7,0,7
Ixchell,F,100,7,0,7
Izyck,M,100,0,7,7
Jabraylon,M,100,0,7,7
Jabrell,M,100,0,7,7
Jacarius,M,100,0,7,7
Jacian,M,100,0,7,7
Jackquelin,F,100,7,0,7
Jacon,M,100,0,7,7
Jacqualin,F,100,7,0,7
Jacquelle,F,100,7,0,7
Jacquelline,F,100,7,0,7
Jacquia,F,100,7,0,7
Jaculin,F,100,7,0,7
Jadarious,M,100,0,7,7
Jadd,M,100,0,7,7
Jadenn,M,100,0,7,7
Jaderion,M,100,0,7,7
Jadora,F,100,7,0,7
Jaewon,M,100,0,7,7
Jaffer,M,100,0,7,7
Jahfari,M,100,0,7,7
Jahida,F,100,7,0,7
Jahkye,M,100,0,7,7
Jahlaya,F,100,7,0,7
Jahleya,F,100,7,0,7
Jahliya,F,100,7,0,7
Jahmi,M,100,0,7,7
Jahmiyah,F,100,7,0,7
Jahniel,M,100,0,7,7
Jahsier,M,100,0,7,7
Jahzion,M,100,0,7,7
Jaicie,F,100,7,0,7
Jaileah,F,100,7,0,7
Jaily,F,100,7,0,7
Jairy,F,100,7,0,7
Jaivan,M,100,0,7,7
Jaivien,M,100,0,7,7
Jakaela,F,100,7,0,7
Jakaiyah,F,100,7,0,7
Jakarius,M,100,0,7,7
Jakea,F,100,7,0,7
Jakeil,M,100,0,7,7
Jakerra,F,100,7,0,7
Jakkar,M,100,0,7,7
Jalonte,M,100,0,7,7
Jalun,M,100,0,7,7
Jamariyon,M,100,0,7,7
Jamarley,M,100,0,7,7
Jamarra,F,100,7,0,7
Jamarreon,M,100,0,7,7
Jamayia,F,100,7,0,7
Jameira,F,100,7,0,7
Jamesanthony,M,100,0,7,7
Jamesjoseph,M,100,0,7,7
Jamms,M,100,0,7,7
Jamorion,M,100,0,7,7
Jamuel,M,100,0,7,7
Janaisa,F,100,7,0,7
Janaisia,F,100,7,0,7
Janala,F,100,7,0,7
Janashia,F,100,7,0,7
Janavi,F,100,7,0,7
Janelie,F,100,7,0,7
Janelyn,F,100,7,0,7
Janenne,F,100,7,0,7
Janeyah,F,100,7,0,7
Janhavi,F,100,7,0,7
Janiris,F,100,7,0,7
Jansyn,F,100,7,0,7
Januari,F,100,7,0,7
Janyssa,F,100,7,0,7
Japonica,F,100,7,0,7
Jaquelline,F,100,7,0,7
Jaqueria,F,100,7,0,7
Jaquill,M,100,0,7,7
Jaquinn,M,100,0,7,7
Jarick,M,100,0,7,7
Jaroslaw,M,100,0,7,7
Jasalynn,F,100,7,0,7
Jasek,M,100,0,7,7
Jaser,M,100,0,7,7
Jashanti,F,100,7,0,7
Jashauna,F,100,7,0,7
Jasmere,F,100,7,0,7
Jasten,M,100,0,7,7
Jatanna,F,100,7,0,7
Jatava,F,100,7,0,7
Jathniel,M,100,0,7,7
Jatyra,F,100,7,0,7
Javario,M,100,0,7,7
Javontez,M,100,0,7,7
Jawaad,M,100,0,7,7
Jaxxton,M,100,0,7,7
Jayceyon,M,100,0,7,7
Jaycin,M,100,0,7,7
Jaydean,M,100,0,7,7
Jaydeep,M,100,0,7,7
Jaydeliz,F,100,7,0,7
Jaylany,F,100,7,0,7
Jaylarose,F,100,7,0,7
Jayleanna,F,100,7,0,7
Jaylinne,F,100,7,0,7
Jaylyne,F,100,7,0,7
Jaymier,M,100,0,7,7
Jayvonne,M,100,0,7,7
Jayzeon,M,100,0,7,7
Jayzin,M,100,0,7,7
Jazahria,F,100,7,0,7
Jazarion,M,100,0,7,7
Jazariya,F,100,7,0,7
Jazelynn,F,100,7,0,7
Jazia,F,100,7,0,7
Jazilynn,F,100,7,0,7
Jazma,F,100,7,0,7
Jazmariah,F,100,7,0,7
Jazminne,F,100,7,0,7
Jazzilyn,F,100,7,0,7
Jazzlynne,F,100,7,0,7
Jazzma,F,100,7,0,7
Jeanifer,F,100,7,0,7
Jeanmichel,M,100,0,7,7
Jebron,M,100,0,7,7
Jefren,M,100,0,7,7
Jehoshua,M,100,0,7,7
Jeimmy,F,100,7,0,7
Jelecia,F,100,7,0,7
Jelen,M,100,0,7,7
Jelitza,F,100,7,0,7
Jemir,M,100,0,7,7
Jenasys,F,100,7,0,7
Jenisys,F,100,7,0,7
Jenivieve,F,100,7,0,7
Jenniver,F,100,7,0,7
Jennye,F,100,7,0,7
Jeray,M,100,0,7,7
Jeree,F,100,7,0,7
Jeremian,M,100,0,7,7
Jeremiha,M,100,0,7,7
Jeremya,M,100,0,7,7
Jerikka,F,100,7,0,7
Jerissa,F,100,7,0,7
Jerlisha,F,100,7,0,7
Jermecia,F,100,7,0,7
Jerriah,F,100,7,0,7
Jersain,M,100,0,7,7
Jesmine,F,100,7,0,7
Jessabella,F,100,7,0,7
Jessalee,F,100,7,0,7
Jessamae,F,100,7,0,7
Jessimae,F,100,7,0,7
Jesslin,F,100,7,0,7
Jesstina,F,100,7,0,7
Jesusmanuel,M,100,0,7,7
Jewelya,F,100,7,0,7
Jeysen,M,100,0,7,7
Jherica,F,100,7,0,7
Jhournee,F,100,7,0,7
Jigna,F,100,7,0,7
Jimel,M,100,0,7,7
Jimesha,F,100,7,0,7
Jing,F,100,7,0,7
Jlisa,F,100,7,0,7
Jniah,F,100,7,0,7
Joanell,F,100,7,0,7
Jobanny,M,100,0,7,7
Jocellyn,F,100,7,0,7
Jodeane,F,100,7,0,7
Joeb,M,100,0,7,7
Joeray,M,100,0,7,7
Jofiel,M,100,0,7,7
Johnedward,M,100,0,7,7
Johniyah,F,100,7,0,7
Johntay,M,100,0,7,7
Joleena,F,100,7,0,7
Jonanthan,M,100,0,7,7
Jonathin,M,100,0,7,7
Jonattan,M,100,0,7,7
Jonaya,F,100,7,0,7
Joneshia,F,100,7,0,7
Jonet,F,100,7,0,7
Jonibek,M,100,0,7,7
Jontre,M,100,0,7,7
Josabeth,F,100,7,0,7
Josede,M,100,0,7,7
Joseroberto,M,100,0,7,7
Josgar,M,100,0,7,7
Jossalynn,F,100,7,0,7
Josy,F,100,7,0,7
Jovanne,M,100,0,7,7
Jovia,F,100,7,0,7
Jozilyn,F,100,7,0,7
Jrew,M,100,0,7,7
Juanell,F,100,7,0,7
Juanisha,F,100,7,0,7
Jubei,M,100,0,7,7
Judye,F,100,7,0,7
Julieonna,F,100,7,0,7
Julisha,F,100,7,0,7
Juliyan,M,100,0,7,7
Jullia,F,100,7,0,7
Julyen,M,100,0,7,7
Juneau,F,100,7,0,7
Jurline,F,100,7,0,7
Justinn,M,100,0,7,7
Jvontae,M,100,0,7,7
Jwuan,M,100,0,7,7
Jyana,F,100,7,0,7
Jyla,F,100,7,0,7
Jyler,M,100,0,7,7
Kaamil,M,100,0,7,7
Kaamilya,F,100,7,0,7
Kaare,M,100,0,7,7
Kaashvi,F,100,7,0,7
Kacelynn,F,100,7,0,7
Kaceton,M,100,0,7,7
Kadarian,M,100,0,7,7
Kader,M,100,0,7,7
Kadisha,F,100,7,0,7
Kadriana,F,100,7,0,7
Kaeleah,F,100,7,0,7
Kaelly,F,100,7,0,7
Kaeto,M,100,0,7,7
Kahil,M,100,0,7,7
Kahlie,F,100,7,0,7
Kailiana,F,100,7,0,7
Kailiyah,F,100,7,0,7
Kailob,M,100,0,7,7
Kaitlain,F,100,7,0,7
Kaivion,M,100,0,7,7
Kajol,F,100,7,0,7
Kalanie,F,100,7,0,7
Kalashia,F,100,7,0,7
Kaleea,F,100,7,0,7
Kaleek,M,100,0,7,7
Kaleila,F,100,7,0,7
Kaleth,M,100,0,7,7
Kalief,M,100,0,7,7
Kaliyanei,F,100,7,0,7
Kaliyha,F,100,7,0,7
Kalmen,M,100,0,7,7
Kalup,M,100,0,7,7
Kalyana,F,100,7,0,7
Kalyiah,F,100,7,0,7
Kamdan,M,100,0,7,7
Kamdynn,F,100,7,0,7
Kamina,F,100,7,0,7
Kampbell,F,100,7,0,7
Kamra,F,100,7,0,7
Kamy,F,100,7,0,7
Kanasia,F,100,7,0,7
Kanessa,F,100,7,0,7
Kanishia,F,100,7,0,7
Kanoe,F,100,7,0,7
Kaos,M,100,0,7,7
Kapree,F,100,7,0,7
Kaptain,M,100,0,7,7
Karcynn,F,100,7,0,7
Karell,M,100,0,7,7
Karlito,M,100,0,7,7
Karlyne,F,100,7,0,7
Karonda,F,100,7,0,7
Kartikeya,M,100,0,7,7
Kaselynn,F,100,7,0,7
Kasidi,F,100,7,0,7
Kassiah,F,100,7,0,7
Kassidey,F,100,7,0,7
Katalynna,F,100,7,0,7
Kately,F,100,7,0,7
Katen,F,100,7,0,7
Katrese,F,100,7,0,7
Kaveri,F,100,7,0,7
Kaybri,F,100,7,0,7
Kayeleigh,F,100,7,0,7
Kaylis,F,100,7,0,7
Kaylnn,F,100,7,0,7
Kaylonie,F,100,7,0,7
Kaynin,M,100,0,7,7
Kaysa,F,100,7,0,7
Ke,M,100,0,7,7
Kealyn,F,100,7,0,7
Keaun,M,100,0,7,7
Keaunna,F,100,7,0,7
Keavon,M,100,0,7,7
Keben,M,100,0,7,7
Keden,M,100,0,7,7
Keeden,M,100,0,7,7
Keeshon,M,100,0,7,7
Keffer,M,100,0,7,7
Kehila,F,100,7,0,7
Keiasha,F,100,7,0,7
Keif,M,100,0,7,7
Keimari,M,100,0,7,7
Keitra,F,100,7,0,7
Keivin,M,100,0,7,7
Kejon,M,100,0,7,7
Kejuana,F,100,7,0,7
Kelena,F,100,7,0,7
Keliana,F,100,7,0,7
Kelvina,F,100,7,0,7
Kemarie,F,100,7,0,7
Kemond,M,100,0,7,7
Kemoria,F,100,7,0,7
Kemyia,F,100,7,0,7
Keneesha,F,100,7,0,7
Kenet,M,100,0,7,7
Kenetha,F,100,7,0,7
Kengston,M,100,0,7,7
Kenika,F,100,7,0,7
Kenjiro,M,100,0,7,7
Kennede,F,100,7,0,7
Kensen,M,100,0,7,7
Kenye,M,100,0,7,7
Keontai,M,100,0,7,7
Keragan,F,100,7,0,7
Keriyah,F,100,7,0,7
Kerlin,F,100,7,0,7
Kermitt,M,100,0,7,7
Kerston,F,100,7,0,7
Keshawnna,F,100,7,0,7
Keshay,F,100,7,0,7
Kess,F,100,7,0,7
Ketrick,M,100,0,7,7
Ketrina,F,100,7,0,7
Keval,M,100,0,7,7
Kevonne,M,100,0,7,7
Keyah,F,100,7,0,7
Keydra,F,100,7,0,7
Keyia,F,100,7,0,7
Keylli,F,100,7,0,7
Keyonce,F,100,7,0,7
Khadeem,M,100,0,7,7
Khadidiatou,F,100,7,0,7
Khalis,F,100,7,0,7
Khalisi,F,100,7,0,7
Khamauri,M,100,0,7,7
Khamren,M,100,0,7,7
Kharlee,F,100,7,0,7
Khason,M,100,0,7,7
Khiri,M,100,0,7,7
Khrystyn,F,100,7,0,7
Khyir,M,100,0,7,7
Kielynn,F,100,7,0,7
Kieonna,F,100,7,0,7
Kiing,M,100,0,7,7
Kilei,F,100,7,0,7
Kimar,M,100,0,7,7
Kimberl,F,100,7,0,7
Kimberlei,F,100,7,0,7
Kimberlyanne,F,100,7,0,7
Kimberlye,F,100,7,0,7
Kimimela,F,100,7,0,7
Kimoria,F,100,7,0,7
Kingmichael,M,100,0,7,7
Kinlei,F,100,7,0,7
Kinnedy,F,100,7,0,7
Kipten,M,100,0,7,7
Kiptin,M,100,0,7,7
Kiristen,F,100,7,0,7
Kirtland,M,100,0,7,7
Kishun,M,100,0,7,7
Kistin,F,100,7,0,7
Kizzi,F,100,7,0,7
Kjon,M,100,0,7,7
Klani,F,100,7,0,7
Kleo,F,100,7,0,7
Kmiyah,F,100,7,0,7
Knighton,M,100,0,7,7
Knut,M,100,0,7,7
Koko,F,100,7,0,7
Kolie,F,100,7,0,7
Kolvin,M,100,0,7,7
Kongpheng,M,100,0,7,7
Konisha,F,100,7,0,7
Korion,M,100,0,7,7
Koua,M,100,0,7,7
Kreindy,F,100,7,0,7
Krikor,M,100,0,7,7
Krishaan,M,100,0,7,7
Kristilyn,F,100,7,0,7
Kristyl,F,100,7,0,7
Kriz,M,100,0,7,7
Kroix,M,100,0,7,7
Krysteena,F,100,7,0,7
Ksean,M,100,0,7,7
Kura,F,100,7,0,7
Kurtus,M,100,0,7,7
Kushtrim,M,100,0,7,7
Kwanita,F,100,7,0,7
Kween,F,100,7,0,7
Kyauna,F,100,7,0,7
Kyell,M,100,0,7,7
Kyeon,M,100,0,7,7
Kyl,M,100,0,7,7
Kylil,M,100,0,7,7
Kylina,F,100,7,0,7
Kymier,M,100,0,7,7
Kynia,F,100,7,0,7
Kynisha,F,100,7,0,7
Kyreece,M,100,0,7,7
Kyshon,M,100,0,7,7
Lacara,F,100,7,0,7
Lachae,F,100,7,0,7
Lachaka,F,100,7,0,7
Lachlyn,F,100,7,0,7
Lachon,F,100,7,0,7
Ladajah,F,100,7,0,7
Ladina,F,100,7,0,7
Ladrena,F,100,7,0,7
Laiklynn,F,100,7,0,7
Laionna,F,100,7,0,7
Lajuanna,F,100,7,0,7
Lakaila,F,100,7,0,7
Lakara,F,100,7,0,7
Lakashia,F,100,7,0,7
Lakeitra,F,100,7,0,7
Lakesh,F,100,7,0,7
Lakhi,M,100,0,7,7
Lakiea,F,100,7,0,7
Lakiva,F,100,7,0,7
Lakyia,F,100,7,0,7
Laneah,F,100,7,0,7
Laneesha,F,100,7,0,7
Lanija,F,100,7,0,7
Lanisa,F,100,7,0,7
Lanissa,F,100,7,0,7
Laquandria,F,100,7,0,7
Laquashia,F,100,7,0,7
Laquaysha,F,100,7,0,7
Laquida,F,100,7,0,7
Laquishia,F,100,7,0,7
Lareka,F,100,7,0,7
Laryiah,F,100,7,0,7
Lasharon,F,100,7,0,7
Lashaune,F,100,7,0,7
Lashica,F,100,7,0,7
Lashonte,F,100,7,0,7
Lashyia,F,100,7,0,7
Lastar,F,100,7,0,7
Lastarr,F,100,7,0,7
Lataunya,F,100,7,0,7
Lateasa,F,100,7,0,7
Latish,F,100,7,0,7
Lativia,F,100,7,0,7
Latori,F,100,7,0,7
Latrevion,M,100,0,7,7
Latrista,F,100,7,0,7
Latrivia,F,100,7,0,7
Latunja,F,100,7,0,7
Launi,F,100,7,0,7
Laureli,F,100,7,0,7
Laurelin,F,100,7,0,7
Lauron,F,100,7,0,7
Lavanna,F,100,7,0,7
Lavelda,F,100,7,0,7
Laverda,F,100,7,0,7
Lavor,M,100,0,7,7
Layci,F,100,7,0,7
Laylan,F,100,7,0,7
Laylla,F,100,7,0,7
Laylynn,F,100,7,0,7
Lazaya,F,100,7,0,7
Leahla,F,100,7,0,7
Leahnna,F,100,7,0,7
Lealan,M,100,0,7,7
Learah,F,100,7,0,7
Leather,F,100,7,0,7
Leean,F,100,7,0,7
Leellen,F,100,7,0,7
Leelu,F,100,7,0,7
Leilahni,F,100,7,0,7
Leilynn,F,100,7,0,7
Leksi,F,100,7,0,7
Leldon,M,100,0,7,7
Lelyn,M,100,0,7,7
Lemark,M,100,0,7,7
Lenden,M,100,0,7,7
Leniah,F,100,7,0,7
Lenis,M,100,0,7,7
Lennell,M,100,0,7,7
Leshell,F,100,7,0,7
Leslei,F,100,7,0,7
Leveda,F,100,7,0,7
Lexxis,F,100,7,0,7
Liamgabriel,M,100,0,7,7
Liammatthew,M,100,0,7,7
Liammichael,M,100,0,7,7
Liannah,F,100,7,0,7
Lidija,F,100,7,0,7
Ligaya,F,100,7,0,7
Liliany,F,100,7,0,7
Liliyana,F,100,7,0,7
Lillard,M,100,0,7,7
Lillieana,F,100,7,0,7
Lilliemae,F,100,7,0,7
Lillienne,F,100,7,0,7
Lillybelle,F,100,7,0,7
Linard,M,100,0,7,7
Linleigh,F,100,7,0,7
Lismary,F,100,7,0,7
Lisvet,F,100,7,0,7
Lititia,F,100,7,0,7
Lizmari,F,100,7,0,7
Lorainne,F,100,7,0,7
Lorese,F,100,7,0,7
Lorice,F,100,7,0,7
Lorieann,F,100,7,0,7
Lorijean,F,100,7,0,7
Lorijo,F,100,7,0,7
Lotte,F,100,7,0,7
Louay,M,100,0,7,7
Louri,F,100,7,0,7
Lovelyn,F,100,7,0,7
Loyda,F,100,7,0,7
Lucresha,F,100,7,0,7
Lucyanna,F,100,7,0,7
Ludger,M,100,0,7,7
Luisjose,M,100,0,7,7
Lukka,M,100,0,7,7
Lulani,F,100,7,0,7
Luma,F,100,7,0,7
Luxi,F,100,7,0,7
Luzia,F,100,7,0,7
Lyall,M,100,0,7,7
Lyden,M,100,0,7,7
Lydie,F,100,7,0,7
Lyndan,F,100,7,0,7
Lyndin,F,100,7,0,7
Lyneah,F,100,7,0,7
Lynford,M,100,0,7,7
Lyniyah,F,100,7,0,7
Lynmarie,F,100,7,0,7
Lynnel,F,100,7,0,7
Lynnley,F,100,7,0,7
Lynnzee,F,100,7,0,7
Lynsee,F,100,7,0,7
Lynthia,F,100,7,0,7
Lytonya,F,100,7,0,7
Mabree,F,100,7,0,7
Macady,F,100,7,0,7
Macilynn,F,100,7,0,7
Mackinnon,M,100,0,7,7
Macky,M,100,0,7,7
Madalina,F,100,7,0,7
Madasen,F,100,7,0,7
Maddielynn,F,100,7,0,7
Madelena,F,100,7,0,7
Madux,M,100,0,7,7
Maedot,F,100,7,0,7
Maghen,F,100,7,0,7
Magie,F,100,7,0,7
Mahak,F,100,7,0,7
Mahniya,F,100,7,0,7
Mahrukh,F,100,7,0,7
Maikayla,F,100,7,0,7
Mairah,F,100,7,0,7
Maitte,F,100,7,0,7
Majayla,F,100,7,0,7
Maka,F,100,7,0,7
Makensley,F,100,7,0,7
Makhala,F,100,7,0,7
Makii,M,100,0,7,7
Malacki,M,100,0,7,7
Malaney,F,100,7,0,7
Maliky,M,100,0,7,7
Malillani,F,100,7,0,7
Malita,F,100,7,0,7
Malkah,F,100,7,0,7
Malli,F,100,7,0,7
Malyn,F,100,7,0,7
Manaf,M,100,0,7,7
Manami,F,100,7,0,7
Manbir,M,100,0,7,7
Mande,F,100,7,0,7
Mandra,F,100,7,0,7
Manik,M,100,0,7,7
Maquela,F,100,7,0,7
Marai,F,100,7,0,7
Marayla,F,100,7,0,7
Marcita,F,100,7,0,7
Marcous,M,100,0,7,7
Marcuz,M,100,0,7,7
Mardarius,M,100,0,7,7
Marelly,F,100,7,0,7
Margrit,F,100,7,0,7
Margueritte,F,100,7,0,7
Marguette,M,100,0,7,7
Margurette,F,100,7,0,7
Marianah,F,100,7,0,7
Maridith,F,100,7,0,7
Marieann,F,100,7,0,7
Mariessa,F,100,7,0,7
Maritess,F,100,7,0,7
Mariusz,M,100,0,7,7
Markasia,F,100,7,0,7
Markea,F,100,7,0,7
Markeil,M,100,0,7,7
Markes,M,100,0,7,7
Marleana,F,100,7,0,7
Marlia,F,100,7,0,7
Marliss,F,100,7,0,7
Maronica,F,100,7,0,7
Marquece,M,100,0,7,7
Marquinn,M,100,0,7,7
Marshaye,F,100,7,0,7
Marvelyn,F,100,7,0,7
Marylisa,F,100,7,0,7
Maryruth,F,100,7,0,7
Marytheresa,F,100,7,0,7
Marz,M,100,0,7,7
Maseo,M,100,0,7,7
Maslah,M,100,0,7,7
Matiana,F,100,7,0,7
Matisyn,F,100,7,0,7
Matrix,M,100,0,7,7
Mattan,M,100,0,7,7
Maty,F,100,7,0,7
Mauer,M,100,0,7,7
Mauriyah,F,100,7,0,7
Mavel,F,100,7,0,7
Mavi,F,100,7,0,7
Maxence,M,100,0,7,7
Maximas,M,100,0,7,7
Maxsen,M,100,0,7,7
Mayari,F,100,7,0,7
Mayreli,F,100,7,0,7
Mayssa,F,100,7,0,7
Mcayla,F,100,7,0,7
Mckailey,F,100,7,0,7
Mckenah,F,100,7,0,7
Mckenzii,F,100,7,0,7
Mckeyla,F,100,7,0,7
Mckyle,M,100,0,7,7
Mckynley,F,100,7,0,7
Measha,F,100,7,0,7
Meca,F,100,7,0,7
Mecha,F,100,7,0,7
Meeko,M,100,0,7,7
Meelad,M,100,0,7,7
Mehjabeen,F,100,7,0,7
Mehmed,M,100,0,7,7
Melbourne,M,100,0,7,7
Meldoy,F,100,7,0,7
Melesio,M,100,0,7,7
Melvern,M,100,0,7,7
Mensah,M,100,0,7,7
Merceda,F,100,7,0,7
Mercedee,F,100,7,0,7
Mercedita,F,100,7,0,7
Merdis,F,100,7,0,7
Mergim,M,100,0,7,7
Merian,F,100,7,0,7
Meritxell,F,100,7,0,7
Merve,F,100,7,0,7
Meryam,F,100,7,0,7
Messai,M,100,0,7,7
Messina,F,100,7,0,7
Meuy,F,100,7,0,7
Meyli,F,100,7,0,7
Mich,M,100,0,7,7
Michaeal,M,100,0,7,7
Michealle,F,100,7,0,7
Michelin,F,100,7,0,7
Michellee,F,100,7,0,7
Michielle,F,100,7,0,7
Mickelle,F,100,7,0,7
Miel,F,100,7,0,7
Mikahla,F,100,7,0,7
Mikaili,F,100,7,0,7
Mikayle,F,100,7,0,7
Mikera,F,100,7,0,7
Mikinley,F,100,7,0,7
Mikira,F,100,7,0,7
Milaan,F,100,7,0,7
Milaysia,F,100,7,0,7
Milei,F,100,7,0,7
Milira,F,100,7,0,7
Millenium,F,100,7,0,7
Milt,M,100,0,7,7
Minato,M,100,0,7,7
Minela,F,100,7,0,7
Minsa,F,100,7,0,7
Mirac,M,100,0,7,7
Mirium,F,100,7,0,7
Mixtli,F,100,7,0,7
Moayed,M,100,0,7,7
Mohamedali,M,100,0,7,7
Monquez,M,100,0,7,7
Monse,F,100,7,0,7
Monterrio,M,100,0,7,7
Montse,F,100,7,0,7
Monyetta,F,100,7,0,7
Monzeratt,F,100,7,0,7
Moyosoreoluwa,F,100,7,0,7
Munisa,F,100,7,0,7
Muriah,F,100,7,0,7
Murriel,F,100,7,0,7
Muslima,F,100,7,0,7
Mutaz,M,100,0,7,7
Myasiah,F,100,7,0,7
Mychala,F,100,7,0,7
Myeasha,F,100,7,0,7
Myella,F,100,7,0,7
Mykea,F,100,7,0,7
Mystica,F,100,7,0,7
Mysty,F,100,7,0,7
Mythias,M,100,0,7,7
Mytrell,M,100,0,7,7
Naavah,F,100,7,0,7
Nabilah,F,100,7,0,7
Nadeja,F,100,7,0,7
Naeomi,F,100,7,0,7
Naitik,M,100,0,7,7
Nakaiya,F,100,7,0,7
Nakasia,F,100,7,0,7
Nakedra,F,100,7,0,7
Nakiea,F,100,7,0,7
Nalayna,F,100,7,0,7
Naledi,F,100,7,0,7
Nalijah,F,100,7,0,7
Nalyah,F,100,7,0,7
Namia,F,100,7,0,7
Namita,F,100,7,0,7
Nanako,F,100,7,0,7
Nanita,F,100,7,0,7
Naoh,M,100,0,7,7
Narain,M,100,0,7,7
Nareg,M,100,0,7,7
Narjes,F,100,7,0,7
Nashana,F,100,7,0,7
Nasheed,M,100,0,7,7
Nasheem,M,100,0,7,7
Nasheka,F,100,7,0,7
Nashiya,F,100,7,0,7
Nashyra,F,100,7,0,7
Natassja,F,100,7,0,7
Natesa,F,100,7,0,7
Nathina,F,100,7,0,7
Natoria,F,100,7,0,7
Nattaly,F,100,7,0,7
Naun,M,100,0,7,7
Nautia,F,100,7,0,7
Naydia,F,100,7,0,7
Nayomee,F,100,7,0,7
Nayquan,M,100,0,7,7
Nayvadius,M,100,0,7,7
Nazanin,F,100,7,0,7
Nazyah,F,100,7,0,7
Nealon,M,100,0,7,7
Neasha,F,100,7,0,7
Necalli,M,100,0,7,7
Nechy,F,100,7,0,7
Neelie,F,100,7,0,7
Neetu,F,100,7,0,7
Nehamiah,M,100,0,7,7
Nehimiah,M,100,0,7,7
Nehir,F,100,7,0,7
Neils,M,100,0,7,7
Nekole,F,100,7,0,7
Neldon,M,100,0,7,7
Neliyah,F,100,7,0,7
Nema,F,100,7,0,7
Neneh,F,100,7,0,7
Nesia,F,100,7,0,7
Nesochi,F,100,7,0,7
Netha,F,100,7,0,7
Neviyah,F,100,7,0,7
Nguyet,F,100,7,0,7
Nhyira,F,100,7,0,7
Niamya,F,100,7,0,7
Nichell,F,100,7,0,7
Nichoals,M,100,0,7,7
Nichoel,F,100,7,0,7
Nickisha,F,100,7,0,7
Nicolemarie,F,100,7,0,7
Nicoya,F,100,7,0,7
Nieisha,F,100,7,0,7
Nikalus,M,100,0,7,7
Nikash,M,100,0,7,7
Nikelle,F,100,7,0,7
Nikkoli,M,100,0,7,7
Nikkos,M,100,0,7,7
Nilaja,F,100,7,0,7
Nineveh,F,100,7,0,7
Niquan,M,100,0,7,7
Nir,M,100,0,7,7
Nisi,F,100,7,0,7
Nivedh,M,100,0,7,7
Nivedita,F,100,7,0,7
Nixson,M,100,0,7,7
Niyelle,F,100,7,0,7
Noaah,M,100,0,7,7
Noelan,M,100,0,7,7
Noelly,F,100,7,0,7
Noey,M,100,0,7,7
Nofer,M,100,0,7,7
Nokomis,F,100,7,0,7
Noreene,F,100,7,0,7
Norielle,F,100,7,0,7
Norlene,F,100,7,0,7
Norva,F,100,7,0,7
Nouf,F,100,7,0,7
Novaly,F,100,7,0,7
Nozomi,F,100,7,0,7
Nyairah,F,100,7,0,7
Nyaisa,F,100,7,0,7
Nycere,M,100,0,7,7
Nyemah,F,100,7,0,7
Nykeem,M,100,0,7,7
Nylaa,F,100,7,0,7
Nyleigh,F,100,7,0,7
Nyzair,M,100,0,7,7
Nyzere,M,100,0,7,7
Octabio,M,100,0,7,7
Octayvia,F,100,7,0,7
Oday,M,100,0,7,7
Olanna,F,100,7,0,7
Oli,M,100,0,7,7
Olisa,F,100,7,0,7
Olita,F,100,7,0,7
Olu,M,100,0,7,7
Olubunmi,F,100,7,0,7
Oluwatimileyin,M,100,0,7,7
Omelia,F,100,7,0,7
Onaje,M,100,0,7,7
Oneisha,F,100,7,0,7
Oniya,F,100,7,0,7
Onofrio,M,100,0,7,7
Orasio,M,100,0,7,7
Orenda,F,100,7,0,7
Orielle,F,100,7,0,7
Orlie,M,100,0,7,7
Osbourne,M,100,0,7,7
Oshyn,F,100,7,0,7
Osiah,M,100,0,7,7
Ossama,M,100,0,7,7
Otniel,M,100,0,7,7
Ottilie,F,100,7,0,7
Ottoniel,M,100,0,7,7
Paesyn,F,100,7,0,7
Paetynn,F,100,7,0,7
Pagie,F,100,7,0,7
Pamale,F,100,7,0,7
Pami,F,100,7,0,7
Panfilo,M,100,0,7,7
Parissa,F,100,7,0,7
Patricha,F,100,7,0,7
Pavani,F,100,7,0,7
Pavielle,F,100,7,0,7
Paytn,F,100,7,0,7
Peer,M,100,0,7,7
Pendleton,M,100,0,7,7
Penisimani,M,100,0,7,7
Pepsi,F,100,7,0,7
Persephony,F,100,7,0,7
Philmore,M,100,0,7,7
Phoenicia,F,100,7,0,7
Porchae,F,100,7,0,7
Portland,F,100,7,0,7
Pragna,F,100,7,0,7
Pragyan,M,100,0,7,7
Pranish,M,100,0,7,7
Prayer,F,100,7,0,7
Prema,F,100,7,0,7
Presious,F,100,7,0,7
Prezlee,F,100,7,0,7
Princetyn,M,100,0,7,7
Prish,M,100,0,7,7
Prissila,F,100,7,0,7
Promisse,F,100,7,0,7
Pryncess,F,100,7,0,7
Pualani,F,100,7,0,7
Punit,M,100,0,7,7
Qassam,M,100,0,7,7
Quadrell,M,100,0,7,7
Quamari,M,100,0,7,7
Quashia,F,100,7,0,7
Quason,M,100,0,7,7
Quendarius,M,100,0,7,7
Quentel,M,100,0,7,7
Quevon,M,100,0,7,7
Quinnleigh,F,100,7,0,7
Quintaya,F,100,7,0,7
Quinterious,M,100,0,7,7
Quishawn,M,100,0,7,7
Raavi,F,100,7,0,7
Rad,M,100,0,7,7
Raetta,F,100,7,0,7
Rahat,M,100,0,7,7
Rahja,M,100,0,7,7
Rahmon,M,100,0,7,7
Raimondo,M,100,0,7,7
Raiquan,M,100,0,7,7
Rajab,M,100,0,7,7
Rakem,M,100,0,7,7
Rakiem,M,100,0,7,7
Rakin,M,100,0,7,7
Ralphie,M,100,0,7,7
Ramesha,F,100,7,0,7
Ramsie,F,100,7,0,7
Ramsses,M,100,0,7,7
Ramyia,F,100,7,0,7
Ranezmae,F,100,7,0,7
Ranezmay,F,100,7,0,7
Ranim,F,100,7,0,7
Ranyla,F,100,7,0,7
Rasa,F,100,7,0,7
Raschel,F,100,7,0,7
Rashawd,M,100,0,7,7
Rasheeta,F,100,7,0,7
Rashita,F,100,7,0,7
Rathana,M,100,0,7,7
Ravynn,F,100,7,0,7
Rawlins,M,100,0,7,7
Raycen,M,100,0,7,7
Raydan,M,100,0,7,7
Rayjohn,M,100,0,7,7
Raykwon,M,100,0,7,7
Raylei,F,100,7,0,7
Rayniya,F,100,7,0,7
Reace,M,100,0,7,7
Redd,M,100,0,7,7
Rediet,F,100,7,0,7
Regnia,F,100,7,0,7
Reighn,F,100,7,0,7
Reileigh,F,100,7,0,7
Rejoyce,F,100,7,0,7
Rekesha,F,100,7,0,7
Remberto,M,100,0,7,7
Remini,F,100,7,0,7
Renai,F,100,7,0,7
Reneasha,F,100,7,0,7
Renesmay,F,100,7,0,7
Renold,M,100,0,7,7
Revis,M,100,0,7,7
Revyn,M,100,0,7,7
Reyann,F,100,7,0,7
Reynah,F,100,7,0,7
Reynaliz,F,100,7,0,7
Reynol,M,100,0,7,7
Rhealyn,F,100,7,0,7
Rheann,F,100,7,0,7
Rhon,M,100,0,7,7
Rhonan,M,100,0,7,7
Rhylea,F,100,7,0,7
Richael,F,100,7,0,7
Richarda,F,100,7,0,7
Rickardo,M,100,0,7,7
Rickeshia,F,100,7,0,7
Rickeya,F,100,7,0,7
Riddhima,F,100,7,0,7
Rigina,F,100,7,0,7
Rithvika,F,100,7,0,7
Riverlynn,F,100,7,0,7
Riza,F,100,7,0,7
Robertt,M,100,0,7,7
Robinn,F,100,7,0,7
Rocklynn,F,100,7,0,7
Rockney,M,100,0,7,7
Roko,M,100,0,7,7
Rolena,F,100,7,0,7
Rolunda,F,100,7,0,7
Romanda,F,100,7,0,7
Romond,M,100,0,7,7
Romonica,F,100,7,0,7
Ronecia,F,100,7,0,7
Ronnett,F,100,7,0,7
Rooke,M,100,0,7,7
Roony,M,100,0,7,7
Roopa,F,100,7,0,7
Roquel,F,100,7,0,7
Rosaelena,F,100,7,0,7
Rosealynn,F,100,7,0,7
Rosebella,F,100,7,0,7
Roseland,F,100,7,0,7
Roselyne,F,100,7,0,7
Roshani,F,100,7,0,7
Rowell,M,100,0,7,7
Rubylynn,F,100,7,0,7
Ruchoma,F,100,7,0,7
Rudean,F,100,7,0,7
Ruoxi,F,100,7,0,7
Rusell,M,100,0,7,7
Rustam,M,100,0,7,7
Ryer,M,100,0,7,7
Ryilee,F,100,7,0,7
Rynell,M,100,0,7,7
Ryunosuke,M,100,0,7,7
Saabir,M,100,0,7,7
Saahas,M,100,0,7,7
Sabdiel,M,100,0,7,7
Sabriyya,F,100,7,0,7
Sachet,F,100,7,0,7
Sadam,M,100,0,7,7
Sadiki,M,100,0,7,7
Sadiyyah,F,100,7,0,7
Sahel,M,100,0,7,7
Sahmiyah,F,100,7,0,7
Saikrishna,M,100,0,7,7
Saila,F,100,7,0,7
Sailer,F,100,7,0,7
Saily,F,100,7,0,7
Saindhavi,F,100,7,0,7
Sakhi,M,100,0,7,7
Saksham,M,100,0,7,7
Saleemah,F,100,7,0,7
Salema,F,100,7,0,7
Sallyanne,F,100,7,0,7
Salote,F,100,7,0,7
Samala,F,100,7,0,7
Samanthagrace,F,100,7,0,7
Samarrah,F,100,7,0,7
Samauria,F,100,7,0,7
Sameko,F,100,7,0,7
Samica,F,100,7,0,7
Samrah,F,100,7,0,7
Samreet,F,100,7,0,7
Sanantha,F,100,7,0,7
Sanat,M,100,0,7,7
Sanisha,F,100,7,0,7
Sanny,M,100,0,7,7
Santario,M,100,0,7,7
Santigo,M,100,0,7,7
Santy,M,100,0,7,7
Sapir,F,100,7,0,7
Saquana,F,100,7,0,7
Sarvin,M,100,0,7,7
Satanya,F,100,7,0,7
Satasha,F,100,7,0,7
Savage,M,100,0,7,7
Sayri,F,100,7,0,7
Schaun,M,100,0,7,7
Seandra,F,100,7,0,7
Searcy,M,100,0,7,7
Searria,F,100,7,0,7
Seina,F,100,7,0,7
Selamawit,F,100,7,0,7
Selestino,M,100,0,7,7
Selica,F,100,7,0,7
Semico,F,100,7,0,7
Seniah,F,100,7,0,7
Senika,F,100,7,0,7
Senovia,F,100,7,0,7
Sephiroth,M,100,0,7,7
Sepideh,F,100,7,0,7
Serrita,F,100,7,0,7
Sesilia,F,100,7,0,7
Setayesh,F,100,7,0,7
Sethan,M,100,0,7,7
Seton,M,100,0,7,7
Shadajah,F,100,7,0,7
Shadrack,M,100,0,7,7
Shadreka,F,100,7,0,7
Shaelynne,F,100,7,0,7
Shaemus,M,100,0,7,7
Shaianna,F,100,7,0,7
Shakai,M,100,0,7,7
Shakeshia,F,100,7,0,7
Shakyah,F,100,7,0,7
Shalai,F,100,7,0,7
Shamarra,F,100,7,0,7
Shambra,F,100,7,0,7
Shamekka,F,100,7,0,7
Shamelle,F,100,7,0,7
Shametria,F,100,7,0,7
Shamik,M,100,0,7,7
Shanade,F,100,7,0,7
Shanaiya,F,100,7,0,7
Shanann,F,100,7,0,7
Shandrell,F,100,7,0,7
Shaneiqua,F,100,7,0,7
Shaneisha,F,100,7,0,7
Shanija,F,100,7,0,7
Shannay,F,100,7,0,7
Shannie,F,100,7,0,7
Shanreka,F,100,7,0,7
Shantall,F,100,7,0,7
Shanterra,F,100,7,0,7
Shao,M,100,0,7,7
Shaon,M,100,0,7,7
Shaqunna,F,100,7,0,7
Shaquona,F,100,7,0,7
Shaquonna,F,100,7,0,7
Sharad,M,100,0,7,7
Sharain,F,100,7,0,7
Shardell,F,100,7,0,7
Sharesse,F,100,7,0,7
Sharmeka,F,100,7,0,7
Sharvil,M,100,0,7,7
Sharyah,F,100,7,0,7
Sharyne,F,100,7,0,7
Sharyon,F,100,7,0,7
Shashana,F,100,7,0,7
Shataria,F,100,7,0,7
Shaterrica,F,100,7,0,7
Shaunia,F,100,7,0,7
Shaunika,F,100,7,0,7
Shauri,F,100,7,0,7
Shavaun,F,100,7,0,7
Shavondra,F,100,7,0,7
Shawnah,F,100,7,0,7
Shawndreka,F,100,7,0,7
Shawnese,F,100,7,0,7
Shaymus,M,100,0,7,7
Shayquan,M,100,0,7,7
Shekela,F,100,7,0,7
Shekeria,F,100,7,0,7
Shekila,F,100,7,0,7
Shelaine,F,100,7,0,7
Shelane,F,100,7,0,7
Shelbea,F,100,7,0,7
Shene,F,100,7,0,7
Shenetra,F,100,7,0,7
Sherah,F,100,7,0,7
Sherlie,F,100,7,0,7
Sherridan,F,100,7,0,7
Sherryn,F,100,7,0,7
Shikhar,M,100,0,7,7
Shinece,F,100,7,0,7
Shirita,F,100,7,0,7
Shonell,F,100,7,0,7
Shonika,F,100,7,0,7
Shoniqua,F,100,7,0,7
Shonnon,F,100,7,0,7
Shrikar,M,100,0,7,7
Shriley,F,100,7,0,7
Shron,F,100,7,0,7
Shundreka,F,100,7,0,7
Siclali,F,100,7,0,7
Silia,F,100,7,0,7
Silis,M,100,0,7,7
Silvanna,F,100,7,0,7
Silvie,F,100,7,0,7
Simeko,F,100,7,0,7
Simrun,F,100,7,0,7
Sinea,F,100,7,0,7
Sinia,F,100,7,0,7
Sinya,F,100,7,0,7
Sirat,F,100,7,0,7
Siren,F,100,7,0,7
Sivi,F,100,7,0,7
Skeet,M,100,0,7,7
Skilyn,F,100,7,0,7
Skyden,M,100,0,7,7
Skylette,F,100,7,0,7
Slaten,M,100,0,7,7
Sly,M,100,0,7,7
Sofian,M,100,0,7,7
Solai,F,100,7,0,7
Soliel,F,100,7,0,7
Solita,F,100,7,0,7
Sophialynn,F,100,7,0,7
Soroush,M,100,0,7,7
Sorrel,F,100,7,0,7
Sorsha,F,100,7,0,7
Soumaya,F,100,7,0,7
Sreeram,M,100,0,7,7
Sriman,M,100,0,7,7
Stamatios,M,100,0,7,7
Starlina,F,100,7,0,7
Stashia,F,100,7,0,7
Stefane,F,100,7,0,7
Stefone,M,100,0,7,7
Stephina,F,100,7,0,7
Stian,M,100,0,7,7
Stosh,M,100,0,7,7
Sudhir,M,100,0,7,7
Suezette,F,100,7,0,7
Sukhdeep,M,100,0,7,7
Sumeko,F,100,7,0,7
Sundiata,M,100,0,7,7
Sundie,F,100,7,0,7
Sundy,F,100,7,0,7
Sunnye,F,100,7,0,7
Sunrise,F,100,7,0,7
Suzeth,F,100,7,0,7
Suzon,F,100,7,0,7
Swarit,M,100,0,7,7
Swastik,M,100,0,7,7
Syd,M,100,0,7,7
Sylvestre,M,100,0,7,7
Symia,F,100,7,0,7
Symirah,F,100,7,0,7
Synceer,M,100,0,7,7
Synetra,F,100,7,0,7
Syri,F,100,7,0,7
Taahirah,F,100,7,0,7
Taara,F,100,7,0,7
Taboris,M,100,0,7,7
Tachina,F,100,7,0,7
Taea,F,100,7,0,7
Taelin,M,100,0,7,7
Tahitia,F,100,7,0,7
Tahniya,F,100,7,0,7
Tahtiana,F,100,7,0,7
Taige,F,100,7,0,7
Taiyah,F,100,7,0,7
Tajahnae,F,100,7,0,7
Tajanee,F,100,7,0,7
Tajiana,F,100,7,0,7
Takaya,F,100,7,0,7
Takeema,F,100,7,0,7
Takirra,F,100,7,0,7
Taleeya,F,100,7,0,7
Talesa,F,100,7,0,7
Talonda,F,100,7,0,7
Talvin,M,100,0,7,7
Tamakia,F,100,7,0,7
Tamarian,M,100,0,7,7
Tamarick,M,100,0,7,7
Tameia,F,100,7,0,7
Tamekka,F,100,7,0,7
Tamilia,F,100,7,0,7
Tamilla,F,100,7,0,7
Tamishia,F,100,7,0,7
Tammia,F,100,7,0,7
Tammika,F,100,7,0,7
Tamorah,F,100,7,0,7
Tamre,F,100,7,0,7
Tanaisa,F,100,7,0,7
Taneyah,F,100,7,0,7
Tangella,F,100,7,0,7
Tanicia,F,100,7,0,7
Taniel,F,100,7,0,7
Taniyla,F,100,7,0,7
Tannika,F,100,7,0,7
Taquanda,F,100,7,0,7
Tarae,F,100,7,0,7
Taraj,M,100,0,7,7
Tarea,F,100,7,0,7
Tario,M,100,0,7,7
Tasherra,F,100,7,0,7
Tashieka,F,100,7,0,7
Tasmine,F,100,7,0,7
Tateum,M,100,0,7,7
Tationa,F,100,7,0,7
Tatyania,F,100,7,0,7
Taurian,M,100,0,7,7
Tawfik,M,100,0,7,7
Tawyna,F,100,7,0,7
Tayzha,F,100,7,0,7
Tayzlee,F,100,7,0,7
Teagun,M,100,0,7,7
Tehillah,F,100,7,0,7
Tekayla,F,100,7,0,7
Temeca,F,100,7,0,7
Temeshia,F,100,7,0,7
Tenielle,F,100,7,0,7
Tenlie,F,100,7,0,7
Tennley,F,100,7,0,7
Teodulo,M,100,0,7,7
Tereatha,F,100,7,0,7
Teressia,F,100,7,0,7
Terone,M,100,0,7,7
Teshara,F,100,7,0,7
Tesneem,F,100,7,0,7
Teuila,F,100,7,0,7
Tevaughn,M,100,0,7,7
Tevian,M,100,0,7,7
Texie,F,100,7,0,7
Thacher,M,100,0,7,7
Tharen,M,100,0,7,7
Theodus,M,100,0,7,7
Theus,M,100,0,7,7
Thomisha,F,100,7,0,7
Thomos,M,100,0,7,7
Thresia,F,100,7,0,7
Tiahja,F,100,7,0,7
Tiane,F,100,7,0,7
Tiburcio,M,100,0,7,7
Tieraney,F,100,7,0,7
Tifanny,F,100,7,0,7
Tiffanyann,F,100,7,0,7
Tiffny,F,100,7,0,7
Tijana,F,100,7,0,7
Tijuanna,F,100,7,0,7
Timberland,M,100,0,7,7
Timekia,F,100,7,0,7
Timica,F,100,7,0,7
Timora,F,100,7,0,7
Timthoy,M,100,0,7,7
Timyah,F,100,7,0,7
Tippi,F,100,7,0,7
Tiquana,F,100,7,0,7
Tirzo,M,100,0,7,7
Tisheena,F,100,7,0,7
Tishonda,F,100,7,0,7
Tiso,M,100,0,7,7
Titilayo,F,100,7,0,7
Tniyah,F,100,7,0,7
Tomeca,F,100,7,0,7
Tomicka,F,100,7,0,7
Tomieka,F,100,7,0,7
Tomiya,F,100,7,0,7
Tomma,F,100,7,0,7
Tommey,M,100,0,7,7
Tommia,F,100,7,0,7
Tondalayo,F,100,7,0,7
Tone,F,100,7,0,7
Toneisha,F,100,7,0,7
Toneshia,F,100,7,0,7
Tonesia,F,100,7,0,7
Toniette,F,100,7,0,7
Toniyah,F,100,7,0,7
Torence,M,100,0,7,7
Toriah,F,100,7,0,7
Tracina,F,100,7,0,7
Traedyn,M,100,0,7,7
Traegan,M,100,0,7,7
Traigh,M,100,0,7,7
Trajon,M,100,0,7,7
Tramond,M,100,0,7,7
Tramya,F,100,7,0,7
Tranice,F,100,7,0,7
Traviss,M,100,0,7,7
Travor,M,100,0,7,7
Trax,M,100,0,7,7
Treigh,M,100,0,7,7
Treighton,M,100,0,7,7
Tremont,M,100,0,7,7
Trenecia,F,100,7,0,7
Trenita,F,100,7,0,7
Treshun,M,100,0,7,7
Trezdon,M,100,0,7,7
Tricha,F,100,7,0,7
Trinidi,F,100,7,0,7
Trinitey,F,100,7,0,7
Trishana,F,100,7,0,7
Tristion,M,100,0,7,7
Triumph,M,100,0,7,7
Tronda,F,100,7,0,7
Trupti,F,100,7,0,7
Tryna,F,100,7,0,7
Tryon,M,100,0,7,7
Tshombe,M,100,0,7,7
Tulani,F,100,7,0,7
Tundra,F,100,7,0,7
Tunja,F,100,7,0,7
Turkessa,F,100,7,0,7
Twisha,F,100,7,0,7
Tyelor,M,100,0,7,7
Tyfani,F,100,7,0,7
Tyjuana,F,100,7,0,7
Tykese,M,100,0,7,7
Tyle,M,100,0,7,7
Tylil,M,100,0,7,7
Tynishia,F,100,7,0,7
Tynley,F,100,7,0,7
Tyrance,M,100,0,7,7
Tyrann,M,100,0,7,7
Tyreisha,F,100,7,0,7
Tyrene,F,100,7,0,7
Tyres,M,100,0,7,7
Tyreshia,F,100,7,0,7
Tyricka,F,100,7,0,7
Tyrike,M,100,0,7,7
Tyrionna,F,100,7,0,7
Tyshai,F,100,7,0,7
Tyshana,F,100,7,0,7
Tyvan,M,100,0,7,7
Tywain,M,100,0,7,7
Tyyanna,F,100,7,0,7
Ubaid,M,100,0,7,7
Uliana,F,100,7,0,7
Umayah,F,100,7,0,7
Umika,F,100,7,0,7
Uzoma,M,100,0,7,7
Valeire,F,100,7,0,7
Valenica,F,100,7,0,7
Valeriya,F,100,7,0,7
Valma,F,100,7,0,7
Valynn,F,100,7,0,7
Vanny,F,100,7,0,7
Vardaan,M,100,0,7,7
Vassie,F,100,7,0,7
Vaugh,M,100,0,7,7
Vearl,M,100,0,7,7
Veida,F,100,7,0,7
Veleda,F,100,7,0,7
Veleria,F,100,7,0,7
Velvette,F,100,7,0,7
Verah,F,100,7,0,7
Verlan,M,100,0,7,7
Vernee,F,100,7,0,7
Vernida,F,100,7,0,7
Vessie,F,100,7,0,7
Viann,F,100,7,0,7
Vibhu,M,100,0,7,7
Vitus,M,100,0,7,7
Vivie,F,100,7,0,7
Viviene,F,100,7,0,7
Vonya,F,100,7,0,7
Vyas,M,100,0,7,7
Vyctoria,F,100,7,0,7
Vyla,F,100,7,0,7
Vyshonne,M,100,0,7,7
Wadie,M,100,0,7,7
Wakely,F,100,7,0,7
Wallene,F,100,7,0,7
Wandalyn,F,100,7,0,7
Wang,M,100,0,7,7
Wannette,F,100,7,0,7
Wanona,F,100,7,0,7
Wardah,F,100,7,0,7
Warden,M,100,0,7,7
Warith,M,100,0,7,7
Waylynn,F,100,7,0,7
Waynetta,F,100,7,0,7
Wendye,F,100,7,0,7
Wilmary,F,100,7,0,7
Windel,M,100,0,7,7
Wlliam,M,100,0,7,7
Wrenna,F,100,7,0,7
Wyler,M,100,0,7,7
Wynde,F,100,7,0,7
Wynonia,F,100,7,0,7
Xania,F,100,7,0,7
Xanti,M,100,0,7,7
Xao,M,100,0,7,7
Xariyah,F,100,7,0,7
Xaviel,M,100,0,7,7
Xaylen,M,100,0,7,7
Xeryus,M,100,0,7,7
Xiclaly,F,100,7,0,7
Xinyue,F,100,7,0,7
Xsavior,M,100,0,7,7
Xyaire,M,100,0,7,7
Xzaviar,M,100,0,7,7
Yacov,M,100,0,7,7
Yadrian,M,100,0,7,7
Yailynn,F,100,7,0,7
Yairis,F,100,7,0,7
Yakeline,F,100,7,0,7
Yaksh,M,100,0,7,7
Yalini,F,100,7,0,7
Yamani,F,100,7,0,7
Yamiah,F,100,7,0,7
Yamilee,F,100,7,0,7
Yamina,F,100,7,0,7
Yanaira,F,100,7,0,7
Yanetzi,F,100,7,0,7
Yanexi,F,100,7,0,7
Yanika,F,100,7,0,7
Yanilen,F,100,7,0,7
Yannely,F,100,7,0,7
Yanzel,M,100,0,7,7
Yaret,F,100,7,0,7
Yarexy,F,100,7,0,7
Yasirah,F,100,7,0,7
Yasna,F,100,7,0,7
Yatzel,F,100,7,0,7
Yavuz,M,100,0,7,7
Yazhini,F,100,7,0,7
Yegor,M,100,0,7,7
Yeico,M,100,0,7,7
Yeniel,M,100,0,7,7
Yessel,F,100,7,0,7
Yeudiel,M,100,0,7,7
Yicheng,M,100,0,7,7
Yin,F,100,7,0,7
Yiovanni,M,100,0,7,7
Ylan,F,100,7,0,7
Yoeli,F,100,7,0,7
Yohaan,M,100,0,7,7
Yolette,F,100,7,0,7
Yoo,F,100,7,0,7
Yoselynn,F,100,7,0,7
Yoskar,M,100,0,7,7
Yosuf,M,100,0,7,7
Yuleisy,F,100,7,0,7
Yulie,F,100,7,0,7
Yuvraaj,M,100,0,7,7
Zacharay,M,100,0,7,7
Zacheus,M,100,0,7,7
Zadaya,F,100,7,0,7
Zady,F,100,7,0,7
Zaelon,M,100,0,7,7
Zaharia,F,100,7,0,7
Zaharra,F,100,7,0,7
Zahier,M,100,0,7,7
Zahnya,F,100,7,0,7
Zahyra,F,100,7,0,7
Zaima,F,100,7,0,7
Zaiven,M,100,0,7,7
Zaivion,M,100,0,7,7
Zaiyon,M,100,0,7,7
Zale,M,100,0,7,7
Zamarah,F,100,7,0,7
Zameir,M,100,0,7,7
Zamuel,M,100,0,7,7
Zanab,F,100,7,0,7
Zanaiyah,F,100,7,0,7
Zaniylah,F,100,7,0,7
Zariaha,F,100,7,0,7
Zarious,M,100,0,7,7
Zathan,M,100,0,7,7
Zavin,M,100,0,7,7
Zavyon,M,100,0,7,7
Zaydenn,M,100,0,7,7
Zayliah,F,100,7,0,7
Zeah,F,100,7,0,7
Zelaya,F,100,7,0,7
Zenya,F,100,7,0,7
Zeplin,M,100,0,7,7
Zerlina,F,100,7,0,7
Zethan,M,100,0,7,7
Zevulun,M,100,0,7,7
Zevyn,M,100,0,7,7
Zhanee,F,100,7,0,7
Zi,M,100,0,7,7
Ziasia,F,100,7,0,7
Ziel,M,100,0,7,7
Zigmund,M,100,0,7,7
Ziham,F,100,7,0,7
Zinab,F,100,7,0,7
Zinedine,M,100,0,7,7
Ziquan,M,100,0,7,7
Zohan,M,100,0,7,7
Zohara,F,100,7,0,7
Zorie,F,100,7,0,7
Zorria,F,100,7,0,7
Zriah,F,100,7,0,7
Zykayla,F,100,7,0,7
Zykeith,M,100,0,7,7
Zykirah,F,100,7,0,7
Zykiria,F,100,7,0,7
Zyleigh,F,100,7,0,7
Zylon,M,100,0,7,7
Zynah,F,100,7,0,7
Zyniyah,F,100,7,0,7
Zytaveon,M,100,0,7,7
Aaishah,F,100,6,0,6
Aalaiyah,F,100,6,0,6
Aalana,F,100,6,0,6
Aalanah,F,100,6,0,6
Aalap,M,100,0,6,6
Aaleiyah,F,100,6,0,6
Aaleya,F,100,6,0,6
Aaliyahmarie,F,100,6,0,6
Aamil,M,100,0,6,6
Aaradhana,F,100,6,0,6
Aaraiz,M,100,0,6,6
Aaro,M,100,0,6,6
Aaronette,F,100,6,0,6
Aaronisha,F,100,6,0,6
Aashay,M,100,0,6,6
Aavyn,M,100,0,6,6
Abbiegayle,F,100,6,0,6
Abbylynn,F,100,6,0,6
Abd,M,100,0,6,6
Abdelrhman,M,100,0,6,6
Abdikarim,M,100,0,6,6
Abdoulie,M,100,0,6,6
Abduallah,M,100,0,6,6
Abdulloh,M,100,0,6,6
Abdulrhman,M,100,0,6,6
Abela,F,100,6,0,6
Abia,F,100,6,0,6
Abigailgrace,F,100,6,0,6
Abigaille,F,100,6,0,6
Abigailrose,F,100,6,0,6
Abigayil,F,100,6,0,6
Abihail,F,100,6,0,6
Abilynn,F,100,6,0,6
Abla,F,100,6,0,6
Aboubakar,M,100,0,6,6
Abrahem,M,100,0,6,6
Abryella,F,100,6,0,6
Acamas,M,100,0,6,6
Acea,M,100,0,6,6
Acesyn,M,100,0,6,6
Achante,F,100,6,0,6
Achillies,M,100,0,6,6
Achol,F,100,6,0,6
Achyuth,M,100,0,6,6
Adaijah,F,100,6,0,6
Adaire,F,100,6,0,6
Adaleya,F,100,6,0,6
Adammichael,M,100,0,6,6
Adarious,M,100,0,6,6
Adashia,F,100,6,0,6
Adaugo,F,100,6,0,6
Addaley,F,100,6,0,6
Addiel,M,100,0,6,6
Addiley,F,100,6,0,6
Addisin,F,100,6,0,6
Addysan,F,100,6,0,6
Addysn,F,100,6,0,6
Adedeji,M,100,0,6,6
Adelayne,F,100,6,0,6
Adelinah,F,100,6,0,6
Adeliz,F,100,6,0,6
Ademar,M,100,0,6,6
Adhiraj,M,100,0,6,6
Adileigh,F,100,6,0,6
Adileni,F,100,6,0,6
Adileny,F,100,6,0,6
Adilson,M,100,0,6,6
Adiyan,M,100,0,6,6
Adly,F,100,6,0,6
Adonus,M,100,0,6,6
Adraya,F,100,6,0,6
Adriean,M,100,0,6,6
Adrija,F,100,6,0,6
Adrine,F,100,6,0,6
Adrith,M,100,0,6,6
Adriyan,M,100,0,6,6
Adriyel,M,100,0,6,6
Advita,F,100,6,0,6
Adyanna,F,100,6,0,6
Adyleigh,F,100,6,0,6
Aeja,F,100,6,0,6
Aemilia,F,100,6,0,6
Aeriella,F,100,6,0,6
Aerowyn,F,100,6,0,6
Aeyla,F,100,6,0,6
Afi,F,100,6,0,6
Afsaneh,F,100,6,0,6
Ahanu,M,100,0,6,6
Ahian,M,100,0,6,6
Ahleena,F,100,6,0,6
Ahley,F,100,6,0,6
Ahlivia,F,100,6,0,6
Ahliya,F,100,6,0,6
Ahman,M,100,0,6,6
Ahmarion,M,100,0,6,6
Ahmiracle,F,100,6,0,6
Ahmoni,F,100,6,0,6
Ahnalise,F,100,6,0,6
Ahnia,F,100,6,0,6
Ahnisty,F,100,6,0,6
Ahnylah,F,100,6,0,6
Ahriah,F,100,6,0,6
Aidalyn,F,100,6,0,6
Aidanjames,M,100,0,6,6
Aideliz,F,100,6,0,6
Aidrian,M,100,0,6,6
Aidrick,M,100,0,6,6
Ailaina,F,100,6,0,6
Aile,F,100,6,0,6
Airabelle,F,100,6,0,6
Aiyan,M,100,0,6,6
Aiyani,F,100,6,0,6
Aiydan,M,100,0,6,6
Aizayah,M,100,0,6,6
Ajanee,F,100,6,0,6
Ajanique,F,100,6,0,6
Ajavion,M,100,0,6,6
Akaela,F,100,6,0,6
Akaisha,F,100,6,0,6
Akansha,F,100,6,0,6
Akaylia,F,100,6,0,6
Akenzie,F,100,6,0,6
Akheem,M,100,0,6,6
Akhia,F,100,6,0,6
Akiela,F,100,6,0,6
Akihiro,M,100,0,6,6
Akishia,F,100,6,0,6
Akshata,F,100,6,0,6
Akwasi,M,100,0,6,6
Akyrah,F,100,6,0,6
Akyria,F,100,6,0,6
Alai,M,100,0,6,6
Alakay,M,100,0,6,6
Alannys,F,100,6,0,6
Alanta,F,100,6,0,6
Alaster,M,100,0,6,6
Alaunna,F,100,6,0,6
Alayasia,F,100,6,0,6
Alaynnah,F,100,6,0,6
Alaysa,F,100,6,0,6
Alaza,F,100,6,0,6
Alaziah,F,100,6,0,6
Alcario,M,100,0,6,6
Aldina,F,100,6,0,6
Alecxa,F,100,6,0,6
Alecxander,M,100,0,6,6
Aleema,F,100,6,0,6
Aleemah,F,100,6,0,6
Aleeshia,F,100,6,0,6
Aleise,F,100,6,0,6
Aletse,F,100,6,0,6
Alexismarie,F,100,6,0,6
Alexxandra,F,100,6,0,6
Alexyia,F,100,6,0,6
Alezandro,M,100,0,6,6
Alfornia,M,100,0,6,6
Aliciya,F,100,6,0,6
Aliesa,F,100,6,0,6
Alieza,F,100,6,0,6
Alii,M,100,0,6,6
Alinson,F,100,6,0,6
Alionna,F,100,6,0,6
Alisynn,F,100,6,0,6
Aliveah,F,100,6,0,6
Alivianna,F,100,6,0,6
Aliyannah,F,100,6,0,6
Alizander,M,100,0,6,6
Aljawhara,F,100,6,0,6
Alkeem,M,100,0,6,6
Allanmichael,M,100,0,6,6
Alleya,F,100,6,0,6
Allieanna,F,100,6,0,6
Alliemae,F,100,6,0,6
Allisandra,F,100,6,0,6
Allise,F,100,6,0,6
Allistair,M,100,0,6,6
Allyne,F,100,6,0,6
Allyshia,F,100,6,0,6
Almedina,F,100,6,0,6
Alnisha,F,100,6,0,6
Alohilani,F,100,6,0,6
Alondrea,F,100,6,0,6
Alperen,M,100,0,6,6
Alphonsus,M,100,0,6,6
Alson,M,100,0,6,6
Altay,M,100,0,6,6
Altheia,F,100,6,0,6
Alvon,M,100,0,6,6
Alxis,F,100,6,0,6
Alyasia,F,100,6,0,6
Alyka,F,100,6,0,6
Alyonna,F,100,6,0,6
Alyssea,F,100,6,0,6
Alyster,M,100,0,6,6
Alythia,F,100,6,0,6
Alyzia,F,100,6,0,6
Amaad,M,100,0,6,6
Amaliah,F,100,6,0,6
Amandajean,F,100,6,0,6
Amarielle,F,100,6,0,6
Amartya,M,100,0,6,6
Amauriah,F,100,6,0,6
Amauris,M,100,0,6,6
Amayra,F,100,6,0,6
Amberdawn,F,100,6,0,6
Amberli,F,100,6,0,6
Ambi,F,100,6,0,6
Amechi,M,100,0,6,6
Amed,M,100,0,6,6
Ameina,F,100,6,0,6
Amida,F,100,6,0,6
Amillio,M,100,0,6,6
Aminatou,F,100,6,0,6
Amisa,F,100,6,0,6
Amishi,F,100,6,0,6
Amnah,F,100,6,0,6
Amondre,M,100,0,6,6
Amose,M,100,0,6,6
Amoz,M,100,0,6,6
Amybeth,F,100,6,0,6
Amyliah,F,100,6,0,6
Amymarie,F,100,6,0,6
Anadalay,F,100,6,0,6
Anaiza,F,100,6,0,6
Analeiah,F,100,6,0,6
Analuz,F,100,6,0,6
Analys,F,100,6,0,6
Anamaris,F,100,6,0,6
Ananshi,F,100,6,0,6
Anarie,F,100,6,0,6
Anatolia,F,100,6,0,6
Anaum,F,100,6,0,6
Anayelli,F,100,6,0,6
Ancelmo,M,100,0,6,6
Anchita,F,100,6,0,6
Andia,F,100,6,0,6
Andony,M,100,0,6,6
Andraea,F,100,6,0,6
Andreo,M,100,0,6,6
Andreonna,F,100,6,0,6
Andretti,M,100,0,6,6
Andriena,F,100,6,0,6
Andrijana,F,100,6,0,6
Aneas,M,100,0,6,6
Aneeka,F,100,6,0,6
Aneeqa,F,100,6,0,6
Anegla,F,100,6,0,6
Anfisa,F,100,6,0,6
Anganette,F,100,6,0,6
Angeliese,F,100,6,0,6
Angelinna,F,100,6,0,6
Angeliza,F,100,6,0,6
Angelize,F,100,6,0,6
Angellena,F,100,6,0,6
Anglina,F,100,6,0,6
Anglique,F,100,6,0,6
Anhelica,F,100,6,0,6
Aniiya,F,100,6,0,6
Anilu,F,100,6,0,6
Aniqua,F,100,6,0,6
Anisjon,M,100,0,6,6
Anitia,F,100,6,0,6
Anitta,F,100,6,0,6
Anjalina,F,100,6,0,6
Anjie,F,100,6,0,6
Anleigh,F,100,6,0,6
Annabele,F,100,6,0,6
Annacatherine,F,100,6,0,6
Annaelle,F,100,6,0,6
Annajo,F,100,6,0,6
Annalecia,F,100,6,0,6
Annaleece,F,100,6,0,6
Annalys,F,100,6,0,6
Annam,F,100,6,0,6
Annapaula,F,100,6,0,6
Annasia,F,100,6,0,6
Annastin,F,100,6,0,6
Anneliesa,F,100,6,0,6
Annelis,F,100,6,0,6
Annely,F,100,6,0,6
Annesha,F,100,6,0,6
Anney,F,100,6,0,6
Anokhi,F,100,6,0,6
Anona,F,100,6,0,6
Anonda,F,100,6,0,6
Anselma,F,100,6,0,6
Anta,F,100,6,0,6
Antanae,F,100,6,0,6
Antanasia,F,100,6,0,6
Antaniyah,F,100,6,0,6
Antinio,M,100,0,6,6
Antiwan,M,100,0,6,6
Antoan,M,100,0,6,6
Antonea,F,100,6,0,6
Antonett,F,100,6,0,6
Antonitte,F,100,6,0,6
Antwanne,M,100,0,6,6
Antwinette,F,100,6,0,6
Antwun,M,100,0,6,6
Anyi,F,100,6,0,6
Anyieth,F,100,6,0,6
Aparajita,F,100,6,0,6
Aprel,F,100,6,0,6
Aprilmarie,F,100,6,0,6
Aqil,M,100,0,6,6
Aquira,F,100,6,0,6
Arabellah,F,100,6,0,6
Aramus,M,100,0,6,6
Aranya,F,100,6,0,6
Arbrielle,F,100,6,0,6
Arcella,F,100,6,0,6
Arcely,F,100,6,0,6
Architha,F,100,6,0,6
Ardeen,F,100,6,0,6
Areah,F,100,6,0,6
Areille,F,100,6,0,6
Aretzi,F,100,6,0,6
Areyon,F,100,6,0,6
Areyona,F,100,6,0,6
Arezo,F,100,6,0,6
Arfan,M,100,0,6,6
Arhaam,M,100,0,6,6
Arhiana,F,100,6,0,6
Ariadny,F,100,6,0,6
Ariahana,F,100,6,0,6
Ariarose,F,100,6,0,6
Arieli,F,100,6,0,6
Arihan,M,100,0,6,6
Arijah,F,100,6,0,6
Arinna,F,100,6,0,6
Aritzel,F,100,6,0,6
Ariyeh,M,100,0,6,6
Ariyunna,F,100,6,0,6
Arlander,M,100,0,6,6
Arlandria,F,100,6,0,6
Arlenis,F,100,6,0,6
Arlow,M,100,0,6,6
Armad,M,100,0,6,6
Armahn,M,100,0,6,6
Armanee,F,100,6,0,6
Armeen,M,100,0,6,6
Armontae,M,100,0,6,6
Army,F,100,6,0,6
Arnab,M,100,0,6,6
Arnasia,F,100,6,0,6
Arnesh,M,100,0,6,6
Arneta,F,100,6,0,6
Aro,M,100,0,6,6
Arona,M,100,0,6,6
Arrica,F,100,6,0,6
Arryn,F,100,6,0,6
Arshaan,M,100,0,6,6
Arshaun,M,100,0,6,6
Arson,M,100,0,6,6
Artorius,M,100,0,6,6
Aruba,F,100,6,0,6
Aryal,F,100,6,0,6
Aryaveer,M,100,0,6,6
Asadbek,M,100,0,6,6
Asenat,F,100,6,0,6
Ashaan,M,100,0,6,6
Ashai,M,100,0,6,6
Ashaki,F,100,6,0,6
Ashaunte,F,100,6,0,6
Ashay,M,100,0,6,6
Ashdyn,M,100,0,6,6
Ashiley,F,100,6,0,6
Ashka,F,100,6,0,6
Ashlay,F,100,6,0,6
Ashot,M,100,0,6,6
Ashrita,F,100,6,0,6
Ashtun,M,100,0,6,6
Ashunte,F,100,6,0,6
Ashutosh,M,100,0,6,6
Ashvika,F,100,6,0,6
Asialyn,F,100,6,0,6
Asier,M,100,0,6,6
Asija,F,100,6,0,6
Asly,F,100,6,0,6
Assa,F,100,6,0,6
Assael,M,100,0,6,6
Assaf,M,100,0,6,6
Asteria,F,100,6,0,6
Asyiah,F,100,6,0,6
Atiksh,M,100,0,6,6
Atlai,M,100,0,6,6
Attalie,F,100,6,0,6
Aubrieana,F,100,6,0,6
Aubriela,F,100,6,0,6
Audiel,M,100,0,6,6
Audrei,F,100,6,0,6
Audriel,F,100,6,0,6
Aungelique,F,100,6,0,6
Aunisty,F,100,6,0,6
Aurion,M,100,0,6,6
Autmn,F,100,6,0,6
Auviana,F,100,6,0,6
Avaia,F,100,6,0,6
Avajane,F,100,6,0,6
Avaleena,F,100,6,0,6
Avalyse,F,100,6,0,6
Avanicole,F,100,6,0,6
Avash,M,100,0,6,6
Avayla,F,100,6,0,6
Avelia,F,100,6,0,6
Avella,F,100,6,0,6
Avenleigh,F,100,6,0,6
Aveona,F,100,6,0,6
Avera,F,100,6,0,6
Averett,M,100,0,6,6
Avetis,M,100,0,6,6
Aveyon,M,100,0,6,6
Avieon,M,100,0,6,6
Avilene,F,100,6,0,6
Avilynn,F,100,6,0,6
Avimael,M,100,0,6,6
Avira,F,100,6,0,6
Avisha,F,100,6,0,6
Avishi,F,100,6,0,6
Avita,F,100,6,0,6
Avonne,F,100,6,0,6
Avontay,M,100,0,6,6
Avrumi,M,100,0,6,6
Avrumy,M,100,0,6,6
Axal,M,100,0,6,6
Ayati,F,100,6,0,6
Aydree,F,100,6,0,6
Aydren,M,100,0,6,6
Aydric,M,100,0,6,6
Ayerim,F,100,6,0,6
Ayia,F,100,6,0,6
Ayliana,F,100,6,0,6
Aylisha,F,100,6,0,6
Aymeric,M,100,0,6,6
Ayotunde,M,100,0,6,6
Ayram,F,100,6,0,6
Ayvan,M,100,0,6,6
Ayveon,M,100,0,6,6
Ayvin,M,100,0,6,6
Azahel,M,100,0,6,6
Azaila,F,100,6,0,6
Azaira,F,100,6,0,6
Azaleia,F,100,6,0,6
Azaleya,F,100,6,0,6
Azar,M,100,0,6,6
Azarious,M,100,0,6,6
Azden,M,100,0,6,6
Azeez,M,100,0,6,6
Azelyn,F,100,6,0,6
Azera,F,100,6,0,6
Aziana,F,100,6,0,6
Azilee,F,100,6,0,6
Azimjon,M,100,0,6,6
Azja,F,100,6,0,6
Azyra,F,100,6,0,6
Azzaria,F,100,6,0,6
Babbi,F,100,6,0,6
Babita,F,100,6,0,6
Baelie,F,100,6,0,6
Bahati,F,100,6,0,6
Bailasan,F,100,6,0,6
Bailley,F,100,6,0,6
Bailly,F,100,6,0,6
Baler,M,100,0,6,6
Bandi,F,100,6,0,6
Baotran,F,100,6,0,6
Barabra,F,100,6,0,6
Barara,F,100,6,0,6
Barin,M,100,0,6,6
Barkot,F,100,6,0,6
Barnell,M,100,0,6,6
Bashawn,M,100,0,6,6
Baudel,M,100,0,6,6
Bayze,M,100,0,6,6
Beacher,M,100,0,6,6
Bearl,M,100,0,6,6
Beasia,F,100,6,0,6
Bedelia,F,100,6,0,6
Behnam,M,100,0,6,6
Behruz,M,100,0,6,6
Bellasophia,F,100,6,0,6
Benedicto,M,100,0,6,6
Benette,F,100,6,0,6
Bentyn,M,100,0,6,6
Beowulf,M,100,0,6,6
Berea,F,100,6,0,6
Berle,M,100,0,6,6
Berline,F,100,6,0,6
Bernadene,F,100,6,0,6
Berni,F,100,6,0,6
Bernida,F,100,6,0,6
Bethanni,F,100,6,0,6
Beto,M,100,0,6,6
Bettyjane,F,100,6,0,6
Beunca,F,100,6,0,6
Beverlyann,F,100,6,0,6
Bevery,F,100,6,0,6
Bevis,M,100,0,6,6
Bexton,M,100,0,6,6
Beyan,M,100,0,6,6
Bezalel,M,100,0,6,6
Bhavika,F,100,6,0,6
Bijon,M,100,0,6,6
Bijoux,F,100,6,0,6
Billiejoe,F,100,6,0,6
Binti,F,100,6,0,6
Bjay,M,100,0,6,6
Blandy,F,100,6,0,6
Blaydin,M,100,0,6,6
Blayn,M,100,0,6,6
Blease,M,100,0,6,6
Blithe,F,100,6,0,6
Bodhin,M,100,0,6,6
Bopha,F,100,6,0,6
Bowdrie,M,100,0,6,6
Bracy,M,100,0,6,6
Braela,F,100,6,0,6
Braijon,M,100,0,6,6
Bralin,M,100,0,6,6
Brandasia,F,100,6,0,6
Branddon,M,100,0,6,6
Brandlyn,F,100,6,0,6
Brandylee,F,100,6,0,6
Branford,M,100,0,6,6
Brantlie,F,100,6,0,6
Brashaun,M,100,0,6,6
Bravo,M,100,0,6,6
Braxtan,M,100,0,6,6
Breda,F,100,6,0,6
Breeahna,F,100,6,0,6
Breelee,F,100,6,0,6
Breina,F,100,6,0,6
Breionna,F,100,6,0,6
Brekin,M,100,0,6,6
Brekkin,M,100,0,6,6
Brelee,F,100,6,0,6
Brendaly,F,100,6,0,6
Brendetta,F,100,6,0,6
Brenlie,F,100,6,0,6
Brenndan,M,100,0,6,6
Brennden,M,100,0,6,6
Breno,M,100,0,6,6
Brentson,M,100,0,6,6
Breonica,F,100,6,0,6
Breonne,F,100,6,0,6
Breontae,M,100,0,6,6
Breonte,M,100,0,6,6
Breshae,F,100,6,0,6
Breydin,M,100,0,6,6
Briamarie,F,100,6,0,6
Briawna,F,100,6,0,6
Bric,M,100,0,6,6
Brieona,F,100,6,0,6
Brihany,F,100,6,0,6
Brijae,F,100,6,0,6
Brijido,M,100,0,6,6
Brilliant,M,100,0,6,6
Brinli,F,100,6,0,6
Brint,M,100,0,6,6
Briteny,F,100,6,0,6
Brithny,F,100,6,0,6
Brittana,F,100,6,0,6
Brittanica,F,100,6,0,6
Brittay,F,100,6,0,6
Brittnye,F,100,6,0,6
Brixtyn,F,100,6,0,6
Briyon,M,100,0,6,6
Broderik,M,100,0,6,6
Brodix,M,100,0,6,6
Brookann,F,100,6,0,6
Brutus,M,100,0,6,6
Bryianna,F,100,6,0,6
Brylinn,F,100,6,0,6
Brynae,F,100,6,0,6
Brynner,M,100,0,6,6
Brysun,M,100,0,6,6
Brytani,F,100,6,0,6
Brytany,F,100,6,0,6
Bryxton,M,100,0,6,6
Buelah,F,100,6,0,6
Bulut,M,100,0,6,6
Burleigh,M,100,0,6,6
Byard,M,100,0,6,6
Cadillac,M,100,0,6,6
Cadince,F,100,6,0,6
Cadrian,M,100,0,6,6
Caedin,M,100,0,6,6
Caelie,F,100,6,0,6
Caelix,M,100,0,6,6
Caetlin,F,100,6,0,6
Caetlyn,F,100,6,0,6
Cahlia,F,100,6,0,6
Caiah,F,100,6,0,6
Caidynce,F,100,6,0,6
Caili,F,100,6,0,6
Caiyden,M,100,0,6,6
Cajuan,M,100,0,6,6
Calayah,F,100,6,0,6
Callandra,F,100,6,0,6
Callianne,F,100,6,0,6
Callieann,F,100,6,0,6
Callison,F,100,6,0,6
Calon,M,100,0,6,6
Calyb,M,100,0,6,6
Camala,F,100,6,0,6
Camerina,F,100,6,0,6
Camerino,M,100,0,6,6
Camerynn,F,100,6,0,6
Camily,F,100,6,0,6
Camiren,M,100,0,6,6
Camiryn,F,100,6,0,6
Camyia,F,100,6,0,6
Camyrn,F,100,6,0,6
Canary,F,100,6,0,6
Caniesha,F,100,6,0,6
Caoilinn,F,100,6,0,6
Caprica,F,100,6,0,6
Caragan,F,100,6,0,6
Careese,F,100,6,0,6
Careli,F,100,6,0,6
Carington,F,100,6,0,6
Caritina,F,100,6,0,6
Carleene,F,100,6,0,6
Carlester,M,100,0,6,6
Carlett,F,100,6,0,6
Carliana,F,100,6,0,6
Carliee,F,100,6,0,6
Carlinda,F,100,6,0,6
Carlosantonio,M,100,0,6,6
Carlotte,F,100,6,0,6
Carnel,M,100,0,6,6
Carolette,F,100,6,0,6
Carollyn,F,100,6,0,6
Carolos,M,100,0,6,6
Carrel,M,100,0,6,6
Carressa,F,100,6,0,6
Carrey,M,100,0,6,6
Carryn,F,100,6,0,6
Carvel,M,100,0,6,6
Cas,M,100,0,6,6
Casden,M,100,0,6,6
Caseton,M,100,0,6,6
Cashae,F,100,6,0,6
Cashawn,M,100,0,6,6
Cashe,M,100,0,6,6
Cashious,M,100,0,6,6
Cashon,M,100,0,6,6
Casonya,F,100,6,0,6
Cassara,F,100,6,0,6
Cassiah,F,100,6,0,6
Cassin,M,100,0,6,6
Catalya,F,100,6,0,6
Catana,F,100,6,0,6
Catha,F,100,6,0,6
Cathalene,F,100,6,0,6
Cathyjo,F,100,6,0,6
Cathyrn,F,100,6,0,6
Catonya,F,100,6,0,6
Catrece,F,100,6,0,6
Catrisha,F,100,6,0,6
Caylub,M,100,0,6,6
Cayn,M,100,0,6,6
Cayse,M,100,0,6,6
Ceazar,M,100,0,6,6
Cedarius,M,100,0,6,6
Cee,F,100,6,0,6
Ceiara,F,100,6,0,6
Celerina,F,100,6,0,6
Cequan,M,100,0,6,6
Ceres,F,100,6,0,6
Ceriah,F,100,6,0,6
Cesareo,M,100,0,6,6
Cetera,F,100,6,0,6
Chadi,M,100,0,6,6
Chadwyck,M,100,0,6,6
Chaelyn,F,100,6,0,6
Chaelynn,F,100,6,0,6
Chaketa,F,100,6,0,6
Chalei,F,100,6,0,6
Chalen,M,100,0,6,6
Challen,M,100,0,6,6
Chalonda,F,100,6,0,6
Champaine,F,100,6,0,6
Chandley,F,100,6,0,6
Chanella,F,100,6,0,6
Changa,M,100,0,6,6
Chaniah,F,100,6,0,6
Chaning,M,100,0,6,6
Chantaye,F,100,6,0,6
Chanteal,F,100,6,0,6
Chaquan,M,100,0,6,6
Chardasia,F,100,6,0,6
Charels,M,100,0,6,6
Charia,F,100,6,0,6
Charissma,F,100,6,0,6
Charlanne,F,100,6,0,6
Charlcie,F,100,6,0,6
Charleeann,F,100,6,0,6
Charlonda,F,100,6,0,6
Charlsea,F,100,6,0,6
Charlston,M,100,0,6,6
Charlyse,F,100,6,0,6
Charmica,F,100,6,0,6
Charnai,F,100,6,0,6
Charneice,F,100,6,0,6
Charney,F,100,6,0,6
Charol,F,100,6,0,6
Charolet,F,100,6,0,6
Charquita,F,100,6,0,6
Chasadee,F,100,6,0,6
Chasitee,F,100,6,0,6
Chastelin,F,100,6,0,6
Chasty,F,100,6,0,6
Chasya,F,100,6,0,6
Chatia,F,100,6,0,6
Chaunce,M,100,0,6,6
Chauntay,F,100,6,0,6
Chavela,F,100,6,0,6
Chavelle,F,100,6,0,6
Chaviva,F,100,6,0,6
Chavonna,F,100,6,0,6
Chayan,M,100,0,6,6
Chaylen,F,100,6,0,6
Chaylene,F,100,6,0,6
Chayten,M,100,0,6,6
Chazmin,F,100,6,0,6
Chealsie,F,100,6,0,6
Chekesha,F,100,6,0,6
Chelan,F,100,6,0,6
Chelseaann,F,100,6,0,6
Chereese,F,100,6,0,6
Chereka,F,100,6,0,6
Cheriece,F,100,6,0,6
Cherra,F,100,6,0,6
Cheryllyn,F,100,6,0,6
Cheska,F,100,6,0,6
Cheslea,F,100,6,0,6
Chesleigh,F,100,6,0,6
Chesna,F,100,6,0,6
Chevette,F,100,6,0,6
Chey,M,100,0,6,6
Cheyrl,F,100,6,0,6
Chezkel,M,100,0,6,6
Chiaki,F,100,6,0,6
Chigozirim,M,100,0,6,6
Chijioke,M,100,0,6,6
Childnotnamed,F,100,6,0,6
Chinwendu,F,100,6,0,6
Chistine,F,100,6,0,6
Chiya,F,100,6,0,6
Chizitelu,F,100,6,0,6
Chloemarie,F,100,6,0,6
Chloye,F,100,6,0,6
Chord,M,100,0,6,6
Chrishayla,F,100,6,0,6
Chrishell,F,100,6,0,6
Chrisoula,F,100,6,0,6
Christanna,F,100,6,0,6
Christhoper,M,100,0,6,6
Christianah,F,100,6,0,6
Christieann,F,100,6,0,6
Christlyn,F,100,6,0,6
Christoff,M,100,0,6,6
Chrystan,F,100,6,0,6
Chrysti,F,100,6,0,6
Chrystiana,F,100,6,0,6
Chrystin,F,100,6,0,6
Chukwubuikem,M,100,0,6,6
Chundra,F,100,6,0,6
Cia,F,100,6,0,6
Cieran,M,100,0,6,6
Cimarron,M,100,0,6,6
Cinamon,F,100,6,0,6
Ciri,F,100,6,0,6
Cithlaly,F,100,6,0,6
Clarese,F,100,6,0,6
Claribelle,F,100,6,0,6
Clarissia,F,100,6,0,6
Clemence,F,100,6,0,6
Clementeen,F,100,6,0,6
Clerissa,F,100,6,0,6
Cliford,M,100,0,6,6
Clintin,M,100,0,6,6
Clutch,M,100,0,6,6
Colleene,F,100,6,0,6
Collett,F,100,6,0,6
Columbia,F,100,6,0,6
Colwyn,M,100,0,6,6
Comekia,F,100,6,0,6
Conita,F,100,6,0,6
Conna,F,100,6,0,6
Connall,M,100,0,6,6
Coolidge,M,100,0,6,6
Coralia,F,100,6,0,6
Coralin,F,100,6,0,6
Coralline,F,100,6,0,6
Coreyanna,F,100,6,0,6
Coreyion,M,100,0,6,6
Corionna,F,100,6,0,6
Cornelieus,M,100,0,6,6
Cornelle,M,100,0,6,6
Corolyn,F,100,6,0,6
Corson,M,100,0,6,6
Cortne,F,100,6,0,6
Corvus,M,100,0,6,6
Corvyn,M,100,0,6,6
Coryell,M,100,0,6,6
Costa,M,100,0,6,6
Coti,M,100,0,6,6
Cotrina,F,100,6,0,6
Cottrell,M,100,0,6,6
Countess,F,100,6,0,6
Couy,M,100,0,6,6
Covin,M,100,0,6,6
Coyer,M,100,0,6,6
Cramer,M,100,0,6,6
Cranford,M,100,0,6,6
Crecencio,M,100,0,6,6
Cresenciano,M,100,0,6,6
Cressa,F,100,6,0,6
Crichton,M,100,0,6,6
Crimsyn,F,100,6,0,6
Cristabella,F,100,6,0,6
Cristhofer,M,100,0,6,6
Cristianna,F,100,6,0,6
Cruize,M,100,0,6,6
Cuba,F,100,6,0,6
Curstin,F,100,6,0,6
Curtina,F,100,6,0,6
Cutberto,M,100,0,6,6
Cyani,F,100,6,0,6
Cyasia,F,100,6,0,6
Cye,M,100,0,6,6
Cynthina,F,100,6,0,6
Cyonna,F,100,6,0,6
Cyprus,M,100,0,6,6
Cyrilla,F,100,6,0,6
Cyrina,F,100,6,0,6
Daanish,M,100,0,6,6
Dacotah,M,100,0,6,6
Daden,M,100,0,6,6
Daejha,F,100,6,0,6
Daequon,M,100,0,6,6
Daesia,F,100,6,0,6
Daeun,F,100,6,0,6
Daevin,M,100,0,6,6
Dafnee,F,100,6,0,6
Dagim,M,100,0,6,6
Dahabo,F,100,6,0,6
Dahja,F,100,6,0,6
Daidrian,M,100,0,6,6
Daigan,M,100,0,6,6
Daijana,F,100,6,0,6
Daimeon,M,100,0,6,6
Daiven,M,100,0,6,6
Daiyana,F,100,6,0,6
Daiyon,M,100,0,6,6
Daizah,F,100,6,0,6
Dajahnae,F,100,6,0,6
Dajean,M,100,0,6,6
Dajhon,M,100,0,6,6
Dajonae,F,100,6,0,6
Dajuana,F,100,6,0,6
Dakar,M,100,0,6,6
Dakarii,M,100,0,6,6
Dakeria,F,100,6,0,6
Dakhi,M,100,0,6,6
Dalaila,F,100,6,0,6
Daler,M,100,0,6,6
Dalery,F,100,6,0,6
Dalian,M,100,0,6,6
Dalida,F,100,6,0,6
Daliya,F,100,6,0,6
Dalonta,M,100,0,6,6
Damariyon,M,100,0,6,6
Damarques,M,100,0,6,6
Damarquis,M,100,0,6,6
Dametra,F,100,6,0,6
Dameyon,M,100,0,6,6
Damitri,M,100,0,6,6
Damyn,M,100,0,6,6
Danaca,F,100,6,0,6
Danahi,F,100,6,0,6
Danaijah,F,100,6,0,6
Danan,M,100,0,6,6
Daney,F,100,6,0,6
Danijela,F,100,6,0,6
Danilee,F,100,6,0,6
Danina,F,100,6,0,6
Dannaka,F,100,6,0,6
Dannalee,F,100,6,0,6
Dannely,F,100,6,0,6
Dannielynn,F,100,6,0,6
Dannyel,M,100,0,6,6
Dantavius,M,100,0,6,6
Dantez,M,100,0,6,6
Danyne,F,100,6,0,6
Daphny,F,100,6,0,6
Daquain,M,100,0,6,6
Daquez,M,100,0,6,6
Daquion,M,100,0,6,6
Daqwon,M,100,0,6,6
Darae,M,100,0,6,6
Darchelle,F,100,6,0,6
Darelyn,F,100,6,0,6
Darena,F,100,6,0,6
Dariane,F,100,6,0,6
Darise,F,100,6,0,6
Dariush,M,100,0,6,6
Dariyan,M,100,0,6,6
Dariyana,F,100,6,0,6
Darmon,M,100,0,6,6
Daronda,F,100,6,0,6
Darreck,M,100,0,6,6
Darreyl,M,100,0,6,6
Darshanna,F,100,6,0,6
Dart,M,100,0,6,6
Dartha,F,100,6,0,6
Darvel,M,100,0,6,6
Daryen,M,100,0,6,6
Dasael,M,100,0,6,6
Dashelle,F,100,6,0,6
Dashley,F,100,6,0,6
Dashone,M,100,0,6,6
Dasiyah,F,100,6,0,6
Dasmine,M,100,0,6,6
Dauntae,M,100,0,6,6
Daureen,F,100,6,0,6
Davayah,F,100,6,0,6
Daveen,F,100,6,0,6
Daveonte,M,100,0,6,6
Davidjohn,M,100,0,6,6
Davyd,M,100,0,6,6
Dawniel,F,100,6,0,6
Dayamy,F,100,6,0,6
Dayanah,F,100,6,0,6
Daykota,M,100,0,6,6
Daymin,M,100,0,6,6
Dayren,M,100,0,6,6
Dayvin,M,100,0,6,6
Daz,M,100,0,6,6
Dazhon,M,100,0,6,6
Dazire,F,100,6,0,6
Dazya,F,100,6,0,6
Deago,M,100,0,6,6
Deanca,F,100,6,0,6
Deanda,F,100,6,0,6
Deandrick,M,100,0,6,6
Deangelio,M,100,0,6,6
Deanine,F,100,6,0,6
Deanta,M,100,0,6,6
Deaudra,F,100,6,0,6
Deaun,F,100,6,0,6
Deauna,F,100,6,0,6
Deaundria,F,100,6,0,6
Deaunta,M,100,0,6,6
Deauntae,M,100,0,6,6
Deavionne,F,100,6,0,6
Deayra,F,100,6,0,6
Deazia,F,100,6,0,6
Debony,F,100,6,0,6
Deboria,F,100,6,0,6
Debroha,F,100,6,0,6
Decarter,M,100,0,6,6
Declen,M,100,0,6,6
Decola,F,100,6,0,6
Dedorah,F,100,6,0,6
Deea,F,100,6,0,6
Deeandra,F,100,6,0,6
Deericka,F,100,6,0,6
Deesha,F,100,6,0,6
Deiontay,M,100,0,6,6
Deivin,M,100,0,6,6
Dejanea,F,100,6,0,6
Dekevion,M,100,0,6,6
Dekiya,F,100,6,0,6
Delaiah,F,100,6,0,6
Delajah,F,100,6,0,6
Delesa,F,100,6,0,6
Delfa,F,100,6,0,6
Delilha,F,100,6,0,6
Dellanira,F,100,6,0,6
Delphinia,F,100,6,0,6
Delson,M,100,0,6,6
Delvion,M,100,0,6,6
Delyn,F,100,6,0,6
Delyza,F,100,6,0,6
Demacio,M,100,0,6,6
Demajae,M,100,0,6,6
Demaje,M,100,0,6,6
Demauria,F,100,6,0,6
Demaurion,M,100,0,6,6
Demetriona,F,100,6,0,6
Demontrae,M,100,0,6,6
Demorea,M,100,0,6,6
Demyiah,F,100,6,0,6
Denashia,F,100,6,0,6
Denaysia,F,100,6,0,6
Denesa,F,100,6,0,6
Denie,F,100,6,0,6
Deniel,M,100,0,6,6
Denilah,F,100,6,0,6
Denora,F,100,6,0,6
Denotra,F,100,6,0,6
Dentrell,M,100,0,6,6
Deonka,F,100,6,0,6
Deonsha,F,100,6,0,6
Depaul,M,100,0,6,6
Dequann,M,100,0,6,6
Dequantae,M,100,0,6,6
Dequavion,M,100,0,6,6
Deral,M,100,0,6,6
Derena,F,100,6,0,6
Derien,M,100,0,6,6
Desarey,F,100,6,0,6
Deserai,F,100,6,0,6
Deseri,F,100,6,0,6
Deshira,F,100,6,0,6
Deshown,M,100,0,6,6
Desiraye,F,100,6,0,6
Desiya,F,100,6,0,6
Desra,F,100,6,0,6
Dessarae,F,100,6,0,6
Dessence,F,100,6,0,6
Desten,M,100,0,6,6
Destery,M,100,0,6,6
Destinay,F,100,6,0,6
Destinyrose,F,100,6,0,6
Deterrion,M,100,0,6,6
Detravion,M,100,0,6,6
Detrell,M,100,0,6,6
Detzani,F,100,6,0,6
Deuntae,M,100,0,6,6
Deuntray,M,100,0,6,6
Deus,M,100,0,6,6
Devam,M,100,0,6,6
Devang,M,100,0,6,6
Devanne,F,100,6,0,6
Devantae,M,100,0,6,6
Devindra,M,100,0,6,6
Devonia,F,100,6,0,6
Devonie,F,100,6,0,6
Devonya,F,100,6,0,6
Devoris,M,100,0,6,6
Dewell,M,100,0,6,6
Deya,F,100,6,0,6
Deyci,F,100,6,0,6
Deyonce,F,100,6,0,6
Dezha,F,100,6,0,6
Dezra,F,100,6,0,6
Dhana,F,100,6,0,6
Dhyaan,M,100,0,6,6
Diahanna,F,100,6,0,6
Diajah,F,100,6,0,6
Diamondnique,F,100,6,0,6
Dianetta,F,100,6,0,6
Diba,F,100,6,0,6
Dileydi,F,100,6,0,6
Dilyla,F,100,6,0,6
Dimitar,M,100,0,6,6
Dimitriy,M,100,0,6,6
Dimon,F,100,6,0,6
Din,M,100,0,6,6
Dinamarie,F,100,6,0,6
Dinnis,M,100,0,6,6
Diomar,M,100,0,6,6
Dionis,M,100,0,6,6
Dionysia,F,100,6,0,6
Dioselin,F,100,6,0,6
Dioselina,F,100,6,0,6
Dipali,F,100,6,0,6
Dishan,M,100,0,6,6
Dishita,F,100,6,0,6
Divia,F,100,6,0,6
Diyala,F,100,6,0,6
Diyan,M,100,0,6,6
Djay,M,100,0,6,6
Dmauri,M,100,0,6,6
Dmia,F,100,6,0,6
Dnya,F,100,6,0,6
Doan,M,100,0,6,6
Doanld,M,100,0,6,6
Dobbie,M,100,0,6,6
Dohn,M,100,0,6,6
Domico,M,100,0,6,6
Dominisha,F,100,6,0,6
Domynic,M,100,0,6,6
Donahue,M,100,0,6,6
Doneka,F,100,6,0,6
Doniyah,F,100,6,0,6
Donja,F,100,6,0,6
Donje,M,100,0,6,6
Donnaven,M,100,0,6,6
Donnett,F,100,6,0,6
Donnielle,F,100,6,0,6
Donterio,M,100,0,6,6
Dontra,M,100,0,6,6
Doraine,F,100,6,0,6
Doralyn,F,100,6,0,6
Doranne,F,100,6,0,6
Dorcia,F,100,6,0,6
Doresa,F,100,6,0,6
Dorisann,F,100,6,0,6
Dorrion,M,100,0,6,6
Dorthia,F,100,6,0,6
Dorthula,F,100,6,0,6
Doruk,M,100,0,6,6
Dovion,F,100,6,0,6
Dowell,M,100,0,6,6
Dracy,M,100,0,6,6
Draelyn,M,100,0,6,6
Drashti,F,100,6,0,6
Draylan,M,100,0,6,6
Drelan,M,100,0,6,6
Drennan,M,100,0,6,6
Dresean,M,100,0,6,6
Drevan,M,100,0,6,6
Dreven,M,100,0,6,6
Drevyn,M,100,0,6,6
Dreyah,F,100,6,0,6
Dreydin,M,100,0,6,6
Driggs,M,100,0,6,6
Drucella,F,100,6,0,6
Drucie,F,100,6,0,6
Dubois,M,100,0,6,6
Duel,M,100,0,6,6
Dulcy,F,100,6,0,6
Dunte,M,100,0,6,6
Durane,M,100,0,6,6
Durriyah,F,100,6,0,6
Duvall,M,100,0,6,6
Dvaughn,M,100,0,6,6
Dvontae,M,100,0,6,6
Dvyne,F,100,6,0,6
Dylilah,F,100,6,0,6
Dyman,F,100,6,0,6
Dymone,F,100,6,0,6
Dynisty,F,100,6,0,6
Dywayne,M,100,0,6,6
Dzyre,F,100,6,0,6
Eabha,F,100,6,0,6
Eann,M,100,0,6,6
Earlyne,F,100,6,0,6
Earmon,M,100,0,6,6
Earnesteen,F,100,6,0,6
Eathon,M,100,0,6,6
Ebb,M,100,0,6,6
Ebby,F,100,6,0,6
Ebecca,F,100,6,0,6
Ebelia,F,100,6,0,6
Ebunoluwa,F,100,6,0,6
Ecko,F,100,6,0,6
Edessa,F,100,6,0,6
Edman,M,100,0,6,6
Ednita,F,100,6,0,6
Edriel,M,100,0,6,6
Edwinn,M,100,0,6,6
Eean,M,100,0,6,6
Eevie,F,100,6,0,6
Efrayim,M,100,0,6,6
Eichael,M,100,0,6,6
Eilynn,F,100,6,0,6
Eimile,F,100,6,0,6
Einin,F,100,6,0,6
Eino,M,100,0,6,6
Eirc,M,100,0,6,6
Eizabella,F,100,6,0,6
Elaia,F,100,6,0,6
Elannah,F,100,6,0,6
Elanore,F,100,6,0,6
Elante,M,100,0,6,6
Eldwin,M,100,0,6,6
Eleesia,F,100,6,0,6
Elfredia,F,100,6,0,6
Elfrieda,F,100,6,0,6
Eliahna,F,100,6,0,6
Eliason,M,100,0,6,6
Elibeth,F,100,6,0,6
Elic,M,100,0,6,6
Elide,F,100,6,0,6
Elieen,F,100,6,0,6
Elijahjohn,M,100,0,6,6
Elijuah,M,100,0,6,6
Elinora,F,100,6,0,6
Elionna,F,100,6,0,6
Elisama,F,100,6,0,6
Elisebeth,F,100,6,0,6
Elisiana,F,100,6,0,6
Elisio,M,100,0,6,6
Eliut,M,100,0,6,6
Eliyjah,M,100,0,6,6
Elkan,M,100,0,6,6
Ellaine,F,100,6,0,6
Elleen,F,100,6,0,6
Ellenora,F,100,6,0,6
Elliahna,F,100,6,0,6
Ellierose,F,100,6,0,6
Elloree,F,100,6,0,6
Ellyott,F,100,6,0,6
Ellysia,F,100,6,0,6
Elmir,M,100,0,6,6
Elmyra,F,100,6,0,6
Elnaz,F,100,6,0,6
Elshaddai,M,100,0,6,6
Elzy,M,100,0,6,6
Emahni,F,100,6,0,6
Emaley,F,100,6,0,6
Emalyne,F,100,6,0,6
Emanee,F,100,6,0,6
Embra,F,100,6,0,6
Eme,F,100,6,0,6
Emel,F,100,6,0,6
Emellia,F,100,6,0,6
Emelya,F,100,6,0,6
Emelyne,F,100,6,0,6
Emer,F,100,6,0,6
Emercyn,F,100,6,0,6
Emerey,F,100,6,0,6
Emerii,F,100,6,0,6
Emerlee,F,100,6,0,6
Emirah,F,100,6,0,6
Emlynn,F,100,6,0,6
Emmaley,F,100,6,0,6
Emmanuell,M,100,0,6,6
Emmasophia,F,100,6,0,6
Emmelin,F,100,6,0,6
Emmelyne,F,100,6,0,6
Emmielou,F,100,6,0,6
Emmytt,M,100,0,6,6
Emone,F,100,6,0,6
Empris,F,100,6,0,6
Enalina,F,100,6,0,6
Enara,F,100,6,0,6
Endiya,F,100,6,0,6
Enia,F,100,6,0,6
Enrica,F,100,6,0,6
Enslie,F,100,6,0,6
Envee,F,100,6,0,6
Enzlee,F,100,6,0,6
Enzlie,F,100,6,0,6
Eragon,M,100,0,6,6
Eralyn,F,100,6,0,6
Erec,M,100,0,6,6
Ereny,F,100,6,0,6
Erianah,F,100,6,0,6
Erianne,F,100,6,0,6
Ericmichael,M,100,0,6,6
Eriksen,M,100,0,6,6
Eril,M,100,0,6,6
Eriverto,M,100,0,6,6
Erleen,F,100,6,0,6
Ernesha,F,100,6,0,6
Errik,M,100,0,6,6
Esben,M,100,0,6,6
Eshika,F,100,6,0,6
Esmi,F,100,6,0,6
Esmie,F,100,6,0,6
Esosa,F,100,6,0,6
Estanislado,M,100,0,6,6
Estin,M,100,0,6,6
Ethanjohn,M,100,0,6,6
Ethanpaul,M,100,0,6,6
Ethelda,F,100,6,0,6
Ethne,F,100,6,0,6
Ethridge,M,100,0,6,6
Etoya,F,100,6,0,6
Eulah,F,100,6,0,6
Eurijah,M,100,0,6,6
Eustolia,F,100,6,0,6
Evaan,M,100,0,6,6
Evalyse,F,100,6,0,6
Evamae,F,100,6,0,6
Evangel,M,100,0,6,6
Evaya,F,100,6,0,6
Everick,M,100,0,6,6
Evern,F,100,6,0,6
Evienne,F,100,6,0,6
Evina,F,100,6,0,6
Evyanna,F,100,6,0,6
Eyasu,M,100,0,6,6
Eymen,M,100,0,6,6
Eyona,F,100,6,0,6
Eze,M,100,0,6,6
Ezekeial,M,100,0,6,6
Ezekiah,M,100,0,6,6
Ezella,F,100,6,0,6
Ezgi,F,100,6,0,6
Ezmie,F,100,6,0,6
Eztli,F,100,6,0,6
Facundo,M,100,0,6,6
Fadila,F,100,6,0,6
Faiha,F,100,6,0,6
Faithanne,F,100,6,0,6
Falena,F,100,6,0,6
Faleshia,F,100,6,0,6
Falishia,F,100,6,0,6
Fanuel,M,100,0,6,6
Faraj,M,100,0,6,6
Farouq,M,100,0,6,6
Farrin,F,100,6,0,6
Farshad,M,100,0,6,6
Farzona,F,100,6,0,6
Fateha,F,100,6,0,6
Fatimatou,F,100,6,0,6
Fatouma,F,100,6,0,6
Faya,F,100,6,0,6
Faylee,F,100,6,0,6
Feige,F,100,6,0,6
Feigy,F,100,6,0,6
Felechia,F,100,6,0,6
Felisity,F,100,6,0,6
Fenet,F,100,6,0,6
Ferdy,M,100,0,6,6
Ferrari,F,100,6,0,6
Festus,M,100,0,6,6
Field,M,100,0,6,6
Fierra,F,100,6,0,6
Fifi,F,100,6,0,6
Filsan,F,100,6,0,6
Finau,M,100,0,6,6
Finnean,M,100,0,6,6
Fiorela,F,100,6,0,6
Fitzwilliam,M,100,0,6,6
Floreen,F,100,6,0,6
Florenda,F,100,6,0,6
Fotima,F,100,6,0,6
Francessca,F,100,6,0,6
Francise,F,100,6,0,6
Frania,F,100,6,0,6
Frankin,M,100,0,6,6
Free,F,100,6,0,6
Fremont,M,100,0,6,6
Freyah,F,100,6,0,6
Frosty,M,100,0,6,6
Fynnlee,F,100,6,0,6
Fynnley,F,100,6,0,6
Gabbi,F,100,6,0,6
Gaege,M,100,0,6,6
Gaelyn,F,100,6,0,6
Gailene,F,100,6,0,6
Ganiyah,F,100,6,0,6
Gaonou,F,100,6,0,6
Garlon,M,100,0,6,6
Garlund,M,100,0,6,6
Garrion,M,100,0,6,6
Geancarlo,M,100,0,6,6
Gearl,M,100,0,6,6
Gearline,F,100,6,0,6
Gee,F,100,6,0,6
Gela,F,100,6,0,6
Gelene,F,100,6,0,6
Gelina,F,100,6,0,6
Gelisha,F,100,6,0,6
Genasis,F,100,6,0,6
Genaya,F,100,6,0,6
Genesia,F,100,6,0,6
Genieve,F,100,6,0,6
Genina,F,100,6,0,6
Geniva,F,100,6,0,6
Genuine,M,100,0,6,6
Genysis,F,100,6,0,6
Geordi,M,100,0,6,6
Geordyn,F,100,6,0,6
Gera,F,100,6,0,6
Geric,M,100,0,6,6
Gerid,M,100,0,6,6
Gerilynn,F,100,6,0,6
Gerlean,F,100,6,0,6
Gerlene,F,100,6,0,6
Geroldine,F,100,6,0,6
Gerre,F,100,6,0,6
Gersain,M,100,0,6,6
Gervais,M,100,0,6,6
Gessel,F,100,6,0,6
Getzemani,F,100,6,0,6
Gevin,M,100,0,6,6
Ghadeer,F,100,6,0,6
Ghala,F,100,6,0,6
Ghaleb,M,100,0,6,6
Ghianna,F,100,6,0,6
Gianelly,F,100,6,0,6
Giann,M,100,0,6,6
Gihanna,F,100,6,0,6
Gilverto,M,100,0,6,6
Giuliette,F,100,6,0,6
Gladies,F,100,6,0,6
Glendi,F,100,6,0,6
Glenora,F,100,6,0,6
Gloriajean,F,100,6,0,6
Glorietta,F,100,6,0,6
Glorine,F,100,6,0,6
Godswill,M,100,0,6,6
Govani,M,100,0,6,6
Graciee,F,100,6,0,6
Gralyn,M,100,0,6,6
Gratia,F,100,6,0,6
Graycelyn,F,100,6,0,6
Graydin,M,100,0,6,6
Graylan,M,100,0,6,6
Gregori,M,100,0,6,6
Gregorie,M,100,0,6,6
Grisham,M,100,0,6,6
Guadelupe,F,100,6,0,6
Gurshawn,M,100,0,6,6
Guye,M,100,0,6,6
Gwendell,F,100,6,0,6
Gwendola,F,100,6,0,6
Gwendolin,F,100,6,0,6
Gwendoline,F,100,6,0,6
Gwendolynne,F,100,6,0,6
Gwennette,F,100,6,0,6
Gwin,F,100,6,0,6
Haaheo,M,100,0,6,6
Haddley,F,100,6,0,6
Hadin,M,100,0,6,6
Hadly,F,100,6,0,6
Hadlynn,F,100,6,0,6
Hager,F,100,6,0,6
Haidon,M,100,0,6,6
Haik,M,100,0,6,6
Haileymarie,F,100,6,0,6
Haillee,F,100,6,0,6
Haizen,M,100,0,6,6
Hajj,M,100,0,6,6
Hakiem,M,100,0,6,6
Haleigha,F,100,6,0,6
Haleyann,F,100,6,0,6
Halford,M,100,0,6,6
Haliana,F,100,6,0,6
Halid,M,100,0,6,6
Hamim,M,100,0,6,6
Handsome,M,100,0,6,6
Hannie,F,100,6,0,6
Haoran,M,100,0,6,6
Haowen,M,100,0,6,6
Harbin,M,100,0,6,6
Hardik,M,100,0,6,6
Harfateh,M,100,0,6,6
Harless,M,100,0,6,6
Haroldine,F,100,6,0,6
Harrie,M,100,0,6,6
Harshiv,M,100,0,6,6
Harwood,M,100,0,6,6
Hasheem,M,100,0,6,6
Hasita,F,100,6,0,6
Hassanah,F,100,6,0,6
Hasten,M,100,0,6,6
Havala,F,100,6,0,6
Havan,F,100,6,0,6
Havick,M,100,0,6,6
Haviland,F,100,6,0,6
Hawo,F,100,6,0,6
Hawthorn,M,100,0,6,6
Hawwaa,F,100,6,0,6
Haydi,F,100,6,0,6
Hayleen,F,100,6,0,6
Hazelee,F,100,6,0,6
Hazeline,F,100,6,0,6
Heatherann,F,100,6,0,6
Hein,M,100,0,6,6
Hemma,F,100,6,0,6
Henessey,F,100,6,0,6
Hennie,F,100,6,0,6
Hennley,F,100,6,0,6
Henoc,M,100,0,6,6
Henreitta,F,100,6,0,6
Hermanda,F,100,6,0,6
Hersey,M,100,0,6,6
Hershall,M,100,0,6,6
Hesper,F,100,6,0,6
Het,M,100,0,6,6
Hetvi,F,100,6,0,6
Heyam,F,100,6,0,6
Hezekiel,M,100,0,6,6
Hibo,F,100,6,0,6
Hikma,F,100,6,0,6
Hilberto,M,100,0,6,6
Hilery,F,100,6,0,6
Hiley,F,100,6,0,6
Hima,F,100,6,0,6
Hinaea,F,100,6,0,6
Hixon,M,100,0,6,6
Hollin,F,100,6,0,6
Hollynd,F,100,6,0,6
Hooman,M,100,0,6,6
Hopelyn,F,100,6,0,6
Hopper,M,100,0,6,6
Horizon,F,100,6,0,6
Hoss,M,100,0,6,6
Hossain,M,100,0,6,6
Hossam,M,100,0,6,6
Hovig,M,100,0,6,6
Hrehaan,M,100,0,6,6
Hristos,M,100,0,6,6
Hulices,M,100,0,6,6
Hurman,M,100,0,6,6
Hurtis,M,100,0,6,6
Husani,M,100,0,6,6
Hypatia,F,100,6,0,6
Ianto,M,100,0,6,6
Iasiah,M,100,0,6,6
Idalee,F,100,6,0,6
Idaliz,F,100,6,0,6
Idolina,F,100,6,0,6
Ieva,F,100,6,0,6
Ikira,F,100,6,0,6
Ildiko,F,100,6,0,6
Ileane,F,100,6,0,6
Ilhaan,F,100,6,0,6
Ilma,F,100,6,0,6
Ilo,F,100,6,0,6
Ilyjah,M,100,0,6,6
Imagene,F,100,6,0,6
Imajae,F,100,6,0,6
Imany,F,100,6,0,6
Imrane,M,100,0,6,6
Inci,F,100,6,0,6
Inesh,M,100,0,6,6
Ingmar,M,100,0,6,6
Ingry,F,100,6,0,6
Inita,F,100,6,0,6
Innessa,F,100,6,0,6
Insley,F,100,6,0,6
Ipek,F,100,6,0,6
Iralyn,F,100,6,0,6
Iratze,F,100,6,0,6
Ireneo,M,100,0,6,6
Ireri,F,100,6,0,6
Ireta,F,100,6,0,6
Irha,F,100,6,0,6
Irian,F,100,6,0,6
Iriz,F,100,6,0,6
Isaack,M,100,0,6,6
Isaam,M,100,0,6,6
Isair,M,100,0,6,6
Isamarie,F,100,6,0,6
Isavela,F,100,6,0,6
Isham,M,100,0,6,6
Ishman,M,100,0,6,6
Isma,F,100,6,0,6
Ismaila,M,100,0,6,6
Itzayani,F,100,6,0,6
Itzelt,F,100,6,0,6
Ivannah,F,100,6,0,6
Ivi,F,100,6,0,6
Ivion,M,100,0,6,6
Ivona,F,100,6,0,6
Ivyunna,F,100,6,0,6
Ixareli,F,100,6,0,6
Iyaad,M,100,0,6,6
Iyiana,F,100,6,0,6
Iyleen,F,100,6,0,6
Izaeh,M,100,0,6,6
Izeck,M,100,0,6,6
Izelle,F,100,6,0,6
Izzabellah,F,100,6,0,6
Izzi,F,100,6,0,6
Izzibella,F,100,6,0,6
Jaana,F,100,6,0,6
Jaasritha,F,100,6,0,6
Jabdiel,M,100,0,6,6
Jabraylen,M,100,0,6,6
Jabreia,F,100,6,0,6
Jabriyah,F,100,6,0,6
Jacaree,M,100,0,6,6
Jacent,M,100,0,6,6
Jacieon,M,100,0,6,6
Jacina,F,100,6,0,6
Jackia,F,100,6,0,6
Jacklyne,F,100,6,0,6
Jacklynne,F,100,6,0,6
Jacleen,F,100,6,0,6
Jacorius,M,100,0,6,6
Jacoury,M,100,0,6,6
Jacyion,M,100,0,6,6
Jacyn,F,100,6,0,6
Jadae,F,100,6,0,6
Jadaisha,F,100,6,0,6
Jadalyse,F,100,6,0,6
Jadarrion,M,100,0,6,6
Jadelin,F,100,6,0,6
Jaderrick,M,100,0,6,6
Jadey,F,100,6,0,6
Jadier,M,100,0,6,6
Jadyel,M,100,0,6,6
Jaesun,M,100,0,6,6
Jaetyn,M,100,0,6,6
Jaeyla,F,100,6,0,6
Jagen,M,100,0,6,6
Jagjot,M,100,0,6,6
Jahasia,F,100,6,0,6
Jahcere,M,100,0,6,6
Jahda,F,100,6,0,6
Jaheir,M,100,0,6,6
Jahiya,F,100,6,0,6
Jahiyah,F,100,6,0,6
Jahlissa,F,100,6,0,6
Jahnyia,F,100,6,0,6
Jahree,M,100,0,6,6
Jahsean,M,100,0,6,6
Jahsun,M,100,0,6,6
Jahvel,M,100,0,6,6
Jahyden,M,100,0,6,6
Jahyra,F,100,6,0,6
Jaiceyon,M,100,0,6,6
Jaideep,M,100,0,6,6
Jaidelyn,F,100,6,0,6
Jaier,M,100,0,6,6
Jaik,M,100,0,6,6
Jailenne,F,100,6,0,6
Jailiyah,F,100,6,0,6
Jaimon,M,100,0,6,6
Jairius,M,100,0,6,6
Jaisal,M,100,0,6,6
Jakailyn,F,100,6,0,6
Jakar,M,100,0,6,6
Jakeim,M,100,0,6,6
Jakendrick,M,100,0,6,6
Jakeryan,M,100,0,6,6
Jakhiya,F,100,6,0,6
Jakier,M,100,0,6,6
Jakilah,F,100,6,0,6
Jakisha,F,100,6,0,6
Jakobee,M,100,0,6,6
Jakobey,M,100,0,6,6
Jakoda,M,100,0,6,6
Jakov,M,100,0,6,6
Jalaia,F,100,6,0,6
Jalanda,F,100,6,0,6
Jaleaha,F,100,6,0,6
Jaleasa,F,100,6,0,6
Jaleiya,F,100,6,0,6
Jaleo,M,100,0,6,6
Jaleyiah,F,100,6,0,6
Jaliene,F,100,6,0,6
Jaliesa,F,100,6,0,6
Jalitza,F,100,6,0,6
Jalontae,M,100,0,6,6
Jalya,F,100,6,0,6
Jalyah,F,100,6,0,6
Jalyse,F,100,6,0,6
Jamaari,M,100,0,6,6
Jamahri,M,100,0,6,6
Jamaiyah,F,100,6,0,6
Jamaka,F,100,6,0,6
Jamarieon,M,100,0,6,6
Jamarkis,M,100,0,6,6
Jamarrius,M,100,0,6,6
Jamayla,F,100,6,0,6
Jameesha,F,100,6,0,6
Jamerio,M,100,0,6,6
Jamerius,M,100,0,6,6
Jameslee,M,100,0,6,6
Jamesryan,M,100,0,6,6
Jameyah,F,100,6,0,6
Jamiaya,F,100,6,0,6
Jamieon,M,100,0,6,6
Jamorie,M,100,0,6,6
Jamyrion,M,100,0,6,6
Janaeh,F,100,6,0,6
Janalynn,F,100,6,0,6
Janavia,F,100,6,0,6
Janazia,F,100,6,0,6
Janear,F,100,6,0,6
Janeesha,F,100,6,0,6
Janeisy,F,100,6,0,6
Janelda,F,100,6,0,6
Janelee,F,100,6,0,6
Janera,F,100,6,0,6
Janessah,F,100,6,0,6
Janier,M,100,0,6,6
Janihya,F,100,6,0,6
Janijah,F,100,6,0,6
Janil,F,100,6,0,6
Janille,F,100,6,0,6
Jankarlo,M,100,0,6,6
Janon,F,100,6,0,6
Jansiel,M,100,0,6,6
Janyll,F,100,6,0,6
Japera,F,100,6,0,6
Japeth,M,100,0,6,6
Japneet,F,100,6,0,6
Jaquelinee,F,100,6,0,6
Jaquelle,M,100,0,6,6
Jaqulyn,F,100,6,0,6
Jaraad,M,100,0,6,6
Jaramiah,M,100,0,6,6
Jarard,M,100,0,6,6
Jaraya,F,100,6,0,6
Jardon,M,100,0,6,6
Jaremiah,M,100,0,6,6
Jaric,M,100,0,6,6
Jarie,F,100,6,0,6
Jarieliz,F,100,6,0,6
Jario,M,100,0,6,6
Jarquise,M,100,0,6,6
Jarratt,M,100,0,6,6
Jarrot,M,100,0,6,6
Jasel,F,100,6,0,6
Jashae,F,100,6,0,6
Jasian,M,100,0,6,6
Jasias,M,100,0,6,6
Jasielle,F,100,6,0,6
Jasilynn,F,100,6,0,6
Jasminda,F,100,6,0,6
Jasminemarie,F,100,6,0,6
Jasonna,F,100,6,0,6
Jasser,M,100,0,6,6
Jassim,M,100,0,6,6
Jasya,F,100,6,0,6
Jaszmin,F,100,6,0,6
Jataveon,M,100,0,6,6
Jataya,F,100,6,0,6
Jatayvion,M,100,0,6,6
Jaterrius,M,100,0,6,6
Jatorria,F,100,6,0,6
Javare,M,100,0,6,6
Javiana,F,100,6,0,6
Javionna,F,100,6,0,6
Javionne,M,100,0,6,6
Javir,M,100,0,6,6
Javiyon,M,100,0,6,6
Jawun,M,100,0,6,6
Jaxzon,M,100,0,6,6
Jayace,M,100,0,6,6
Jayant,M,100,0,6,6
Jayauna,F,100,6,0,6
Jaycean,M,100,0,6,6
Jayceeon,M,100,0,6,6
Jaydelin,F,100,6,0,6
Jaydelynn,F,100,6,0,6
Jaydhen,M,100,0,6,6
Jaylaah,F,100,6,0,6
Jaylamarie,F,100,6,0,6
Jaylanis,F,100,6,0,6
Jaylaun,M,100,0,6,6
Jayle,F,100,6,0,6
Jaylianis,F,100,6,0,6
Jaymani,M,100,0,6,6
Jaynah,F,100,6,0,6
Jaynelle,F,100,6,0,6
Jaysaun,M,100,0,6,6
Jayvonni,M,100,0,6,6
Jayvonte,M,100,0,6,6
Jazael,M,100,0,6,6
Jazhiel,M,100,0,6,6
Jazlean,F,100,6,0,6
Jazmynne,F,100,6,0,6
Jazya,F,100,6,0,6
Jazzabella,F,100,6,0,6
Jazzabelle,F,100,6,0,6
Jazzi,F,100,6,0,6
Jazzleen,F,100,6,0,6
Jcyon,M,100,0,6,6
Jea,F,100,6,0,6
Jeckson,M,100,0,6,6
Jediel,M,100,0,6,6
Jedrik,M,100,0,6,6
Jehilyn,F,100,6,0,6
Jehovah,M,100,0,6,6
Jeiren,M,100,0,6,6
Jeiry,F,100,6,0,6
Jelah,F,100,6,0,6
Jelene,F,100,6,0,6
Jellisa,F,100,6,0,6
Jemarr,M,100,0,6,6
Jemica,F,100,6,0,6
Jenaliz,F,100,6,0,6
Jeneanne,F,100,6,0,6
Jenece,F,100,6,0,6
Jenelly,F,100,6,0,6
Jenely,F,100,6,0,6
Jenesa,F,100,6,0,6
Jenessy,F,100,6,0,6
Jenicia,F,100,6,0,6
Jennasis,F,100,6,0,6
Jennaveve,F,100,6,0,6
Jenniferlynn,F,100,6,0,6
Jennifermarie,F,100,6,0,6
Jenrry,M,100,0,6,6
Jentrie,F,100,6,0,6
Jenzel,M,100,0,6,6
Jephthe,M,100,0,6,6
Jeraldy,F,100,6,0,6
Jeraldyn,F,100,6,0,6
Jeralene,F,100,6,0,6
Jeraline,F,100,6,0,6
Jerely,F,100,6,0,6
Jeremai,M,100,0,6,6
Jeremaiah,M,100,0,6,6
Jeriana,F,100,6,0,6
Jericah,F,100,6,0,6
Jermelle,M,100,0,6,6
Jermica,F,100,6,0,6
Jermika,F,100,6,0,6
Jermol,M,100,0,6,6
Jerquan,M,100,0,6,6
Jerrail,M,100,0,6,6
Jerrianne,F,100,6,0,6
Jerriel,M,100,0,6,6
Jerrine,F,100,6,0,6
Jerwin,M,100,0,6,6
Jerzei,F,100,6,0,6
Jesai,M,100,0,6,6
Jeshaun,M,100,0,6,6
Jeshawn,M,100,0,6,6
Jeshuah,M,100,0,6,6
Jesmarie,F,100,6,0,6
Jesselin,F,100,6,0,6
Jessicka,F,100,6,0,6
Jessieca,F,100,6,0,6
Jessikah,F,100,6,0,6
Jesstin,M,100,0,6,6
Jestiny,F,100,6,0,6
Jesusjr,M,100,0,6,6
Jetton,M,100,0,6,6
Jewellia,F,100,6,0,6
Jexiel,M,100,0,6,6
Jeyko,M,100,0,6,6
Jeyleen,F,100,6,0,6
Jeylen,F,100,6,0,6
Jezebelle,F,100,6,0,6
Jhaden,M,100,0,6,6
Jhenae,F,100,6,0,6
Jhia,F,100,6,0,6
Jhoel,M,100,0,6,6
Jhoshua,M,100,0,6,6
Jiannah,F,100,6,0,6
Jibriel,M,100,0,6,6
Jihanna,F,100,6,0,6
Jiho,M,100,0,6,6
Jillean,F,100,6,0,6
Jillena,F,100,6,0,6
Jimar,M,100,0,6,6
Jimm,M,100,0,6,6
Jiron,M,100,0,6,6
Jissell,F,100,6,0,6
Jiyaan,M,100,0,6,6
Jizell,F,100,6,0,6
Jlin,M,100,0,6,6
Jmia,F,100,6,0,6
Jmir,M,100,0,6,6
Jmiyah,F,100,6,0,6
Joacim,M,100,0,6,6
Joanathan,M,100,0,6,6
Joannamarie,F,100,6,0,6
Joaopaulo,M,100,0,6,6
Joben,M,100,0,6,6
Jobi,F,100,6,0,6
Jociah,M,100,0,6,6
Jodan,M,100,0,6,6
Joeliz,F,100,6,0,6
Joesha,F,100,6,0,6
Joesiyah,M,100,0,6,6
Joevanny,M,100,0,6,6
Johandy,M,100,0,6,6
Johel,M,100,0,6,6
Johnathn,M,100,0,6,6
Johnethan,M,100,0,6,6
Johniel,M,100,0,6,6
Johntavis,M,100,0,6,6
Johon,M,100,0,6,6
Joliette,F,100,6,0,6
Jomana,F,100,6,0,6
Jonahs,M,100,0,6,6
Jonath,M,100,0,6,6
Jonavin,M,100,0,6,6
Jonce,M,100,0,6,6
Jonella,F,100,6,0,6
Jonia,F,100,6,0,6
Jonis,M,100,0,6,6
Jonne,F,100,6,0,6
Jonothon,M,100,0,6,6
Jophiel,M,100,0,6,6
Joree,F,100,6,0,6
Joretha,F,100,6,0,6
Joron,M,100,0,6,6
Jorrin,M,100,0,6,6
Josanne,F,100,6,0,6
Joseff,M,100,0,6,6
Joseignacio,M,100,0,6,6
Joselene,F,100,6,0,6
Joselina,F,100,6,0,6
Josephe,M,100,0,6,6
Josephy,M,100,0,6,6
Joshaun,M,100,0,6,6
Joshuacaleb,M,100,0,6,6
Joshuel,M,100,0,6,6
Josiana,F,100,6,0,6
Joslen,F,100,6,0,6
Josmarie,F,100,6,0,6
Josmary,F,100,6,0,6
Jossalin,F,100,6,0,6
Jouri,F,100,6,0,6
Journeii,F,100,6,0,6
Journye,F,100,6,0,6
Jovahni,M,100,0,6,6
Jovannah,F,100,6,0,6
Jovianne,F,100,6,0,6
Jovonn,M,100,0,6,6
Joyful,F,100,6,0,6
Joylin,F,100,6,0,6
Jozaiah,M,100,0,6,6
Jozlynne,F,100,6,0,6
Jozzlynn,F,100,6,0,6
Juanalberto,M,100,0,6,6
Juanjesus,M,100,0,6,6
Juanya,M,100,0,6,6
Judeen,F,100,6,0,6
Juelez,M,100,0,6,6
Julea,F,100,6,0,6
Juleana,F,100,6,0,6
Juleon,M,100,0,6,6
Julianni,F,100,6,0,6
Juliea,F,100,6,0,6
Junnie,F,100,6,0,6
Junyi,M,100,0,6,6
Jurrell,M,100,0,6,6
Justa,F,100,6,0,6
Justain,M,100,0,6,6
Justess,F,100,6,0,6
Justn,M,100,0,6,6
Juvia,F,100,6,0,6
Jvian,M,100,0,6,6
Jyles,M,100,0,6,6
Jylian,F,100,6,0,6
Jyson,M,100,0,6,6
Kaalyn,F,100,6,0,6
Kaari,F,100,6,0,6
Kacei,F,100,6,0,6
Kachiri,F,100,6,0,6
Kacin,M,100,0,6,6
Kaddie,F,100,6,0,6
Kadeisha,F,100,6,0,6
Kadeshia,F,100,6,0,6
Kadidia,F,100,6,0,6
Kadidiatou,F,100,6,0,6
Kadidja,F,100,6,0,6
Kaed,M,100,0,6,6
Kaeda,F,100,6,0,6
Kaegen,M,100,0,6,6
Kaelub,M,100,0,6,6
Kaenan,M,100,0,6,6
Kahaan,M,100,0,6,6
Kahdeem,M,100,0,6,6
Kahir,M,100,0,6,6
Kahlel,M,100,0,6,6
Kahlid,M,100,0,6,6
Kahmia,F,100,6,0,6
Kaiann,F,100,6,0,6
Kaicee,F,100,6,0,6
Kaigan,M,100,0,6,6
Kaiicen,M,100,0,6,6
Kailayah,F,100,6,0,6
Kaille,F,100,6,0,6
Kaion,M,100,0,6,6
Kaire,M,100,0,6,6
Kairie,F,100,6,0,6
Kaisee,F,100,6,0,6
Kaitleen,F,100,6,0,6
Kaitlind,F,100,6,0,6
Kajaun,M,100,0,6,6
Kajetan,M,100,0,6,6
Kajus,M,100,0,6,6
Kalandria,F,100,6,0,6
Kalayshia,F,100,6,0,6
Kaleal,M,100,0,6,6
Kaleese,F,100,6,0,6
Kaleesha,F,100,6,0,6
Kaleil,M,100,0,6,6
Kalep,M,100,0,6,6
Kalet,M,100,0,6,6
Kaleta,F,100,6,0,6
Kaliber,M,100,0,6,6
Kalieah,F,100,6,0,6
Kalifa,F,100,6,0,6
Kaliyana,F,100,6,0,6
Kaliym,M,100,0,6,6
Kalleb,M,100,0,6,6
Kalpesh,M,100,0,6,6
Kamaiyah,F,100,6,0,6
Kamariana,F,100,6,0,6
Kamariona,F,100,6,0,6
Kambra,F,100,6,0,6
Kambre,F,100,6,0,6
Kambreigh,F,100,6,0,6
Kamecia,F,100,6,0,6
Kamell,M,100,0,6,6
Kamellia,F,100,6,0,6
Kamini,F,100,6,0,6
Kamiyha,F,100,6,0,6
Kamiylah,F,100,6,0,6
Kamoree,F,100,6,0,6
Kamorion,M,100,0,6,6
Kamsi,F,100,6,0,6
Kamyree,F,100,6,0,6
Kamyri,F,100,6,0,6
Kamyrie,F,100,6,0,6
Kanard,M,100,0,6,6
Kandas,F,100,6,0,6
Kandiss,F,100,6,0,6
Kanessha,F,100,6,0,6
Kanish,M,100,0,6,6
Kanosha,F,100,6,0,6
Karai,F,100,6,0,6
Karanvir,M,100,0,6,6
Kardae,M,100,0,6,6
Karelis,F,100,6,0,6
Karenann,F,100,6,0,6
Kariel,F,100,6,0,6
Karilee,F,100,6,0,6
Kariss,F,100,6,0,6
Karissma,F,100,6,0,6
Karizmah,F,100,6,0,6
Karlan,M,100,0,6,6
Karlen,F,100,6,0,6
Karlesha,F,100,6,0,6
Karlia,F,100,6,0,6
Karliee,F,100,6,0,6
Karneshia,F,100,6,0,6
Karnisha,F,100,6,0,6
Karolann,F,100,6,0,6
Karrena,F,100,6,0,6
Karrine,F,100,6,0,6
Karris,F,100,6,0,6
Karsan,M,100,0,6,6
Karstyn,F,100,6,0,6
Kartar,M,100,0,6,6
Kasadee,F,100,6,0,6
Kasaun,M,100,0,6,6
Kashanda,F,100,6,0,6
Kashauna,F,100,6,0,6
Kashden,M,100,0,6,6
Kashdyn,M,100,0,6,6
Kashun,M,100,0,6,6
Kasity,F,100,6,0,6
Kaslyn,F,100,6,0,6
Kasmira,F,100,6,0,6
Kassiana,F,100,6,0,6
Katalayah,F,100,6,0,6
Kataliyah,F,100,6,0,6
Katalya,F,100,6,0,6
Katavia,F,100,6,0,6
Katerria,F,100,6,0,6
Katharin,F,100,6,0,6
Katheine,F,100,6,0,6
Kathyanne,F,100,6,0,6
Katline,F,100,6,0,6
Katlynd,F,100,6,0,6
Katosha,F,100,6,0,6
Kattrina,F,100,6,0,6
Katylin,F,100,6,0,6
Kauri,F,100,6,0,6
Kavaughn,M,100,0,6,6
Kavell,M,100,0,6,6
Kavona,F,100,6,0,6
Kawsar,F,100,6,0,6
Kaydense,F,100,6,0,6
Kaydian,M,100,0,6,6
Kaydrian,M,100,0,6,6
Kaydrie,F,100,6,0,6
Kayeden,M,100,0,6,6
Kayeloni,F,100,6,0,6
Kayge,M,100,0,6,6
Kaylanicole,F,100,6,0,6
Kaylann,F,100,6,0,6
Kayleeanne,F,100,6,0,6
Kaylise,F,100,6,0,6
Kaylisha,F,100,6,0,6
Kaymani,F,100,6,0,6
Kayro,M,100,0,6,6
Kayshia,F,100,6,0,6
Kaytelyn,F,100,6,0,6
Kaytlynne,F,100,6,0,6
Kazariah,F,100,6,0,6
Kazlynn,F,100,6,0,6
Kazuya,M,100,0,6,6
Kci,M,100,0,6,6
Keair,M,100,0,6,6
Kealynn,F,100,6,0,6
Keannah,F,100,6,0,6
Kearie,F,100,6,0,6
Keatan,M,100,0,6,6
Keating,M,100,0,6,6
Keayla,F,100,6,0,6
Kechia,F,100,6,0,6
Kedarious,M,100,0,6,6
Kedarrius,M,100,0,6,6
Kedrin,M,100,0,6,6
Kedzie,F,100,6,0,6
Keeshaun,M,100,0,6,6
Keetra,F,100,6,0,6
Keeven,M,100,0,6,6
Keghan,M,100,0,6,6
Keidan,M,100,0,6,6
Keidren,M,100,0,6,6
Keiliany,F,100,6,0,6
Keithrick,M,100,0,6,6
Keland,M,100,0,6,6
Keleah,F,100,6,0,6
Kelene,F,100,6,0,6
Keley,F,100,6,0,6
Kelven,M,100,0,6,6
Kelvis,M,100,0,6,6
Kelvisha,F,100,6,0,6
Kemariyah,F,100,6,0,6
Kemaurion,M,100,0,6,6
Kemo,M,100,0,6,6
Kemontay,M,100,0,6,6
Kenari,F,100,6,0,6
Kenasia,F,100,6,0,6
Kendee,F,100,6,0,6
Kendo,M,100,0,6,6
Kendricka,F,100,6,0,6
Kendryk,M,100,0,6,6
Kenja,F,100,6,0,6
Kennyel,M,100,0,6,6
Kentavia,F,100,6,0,6
Kentavis,M,100,0,6,6
Kenteria,F,100,6,0,6
Kentez,M,100,0,6,6
Kentleigh,F,100,6,0,6
Kentrice,F,100,6,0,6
Kenyae,F,100,6,0,6
Kenyia,F,100,6,0,6
Kenysha,F,100,6,0,6
Keonda,F,100,6,0,6
Keonne,M,100,0,6,6
Kepa,M,100,0,6,6
Kerbi,F,100,6,0,6
Kerionna,F,100,6,0,6
Kerman,M,100,0,6,6
Kermina,F,100,6,0,6
Kerric,M,100,0,6,6
Kerris,F,100,6,0,6
Kerryanne,F,100,6,0,6
Kerstine,F,100,6,0,6
Kerwyn,M,100,0,6,6
Kesaun,M,100,0,6,6
Keshuna,F,100,6,0,6
Kessiah,F,100,6,0,6
Kessie,F,100,6,0,6
Kestyn,M,100,0,6,6
Ketron,M,100,0,6,6
Kevaeh,F,100,6,0,6
Kevari,M,100,0,6,6
Kevinjohn,M,100,0,6,6
Kexin,F,100,6,0,6
Keyaun,M,100,0,6,6
Keydon,M,100,0,6,6
Keydren,M,100,0,6,6
Keylly,F,100,6,0,6
Keymond,M,100,0,6,6
Keyonnia,F,100,6,0,6
Keyontay,M,100,0,6,6
Keyshla,F,100,6,0,6
Keyundra,F,100,6,0,6
Keyuntae,M,100,0,6,6
Khabir,M,100,0,6,6
Khadidja,F,100,6,0,6
Khadijat,F,100,6,0,6
Khadin,M,100,0,6,6
Khaelyn,F,100,6,0,6
Khaiya,F,100,6,0,6
Khalee,M,100,0,6,6
Khaleia,F,100,6,0,6
Khalii,F,100,6,0,6
Khalisah,F,100,6,0,6
Khambrel,M,100,0,6,6
Khamden,M,100,0,6,6
Khamyah,F,100,6,0,6
Khania,F,100,6,0,6
Khansa,F,100,6,0,6
Khasim,M,100,0,6,6
Khaza,M,100,0,6,6
Khenadi,F,100,6,0,6
Khisha,F,100,6,0,6
Khiyan,M,100,0,6,6
Khiyon,M,100,0,6,6
Khloye,F,100,6,0,6
Kholee,F,100,6,0,6
Kholton,M,100,0,6,6
Khrystine,F,100,6,0,6
Khusbu,F,100,6,0,6
Khylon,M,100,0,6,6
Khyon,M,100,0,6,6
Kiabeth,F,100,6,0,6
Kiahra,F,100,6,0,6
Kiajah,F,100,6,0,6
Kianie,F,100,6,0,6
Kiaralee,F,100,6,0,6
Kiaraliz,F,100,6,0,6
Kida,F,100,6,0,6
Kief,M,100,0,6,6
Kieria,F,100,6,0,6
Kierria,F,100,6,0,6
Kiersyn,F,100,6,0,6
Kieshia,F,100,6,0,6
Kieu,F,100,6,0,6
Kileyann,F,100,6,0,6
Kimana,F,100,6,0,6
Kimaria,F,100,6,0,6
Kimarion,M,100,0,6,6
Kimary,F,100,6,0,6
Kimayah,F,100,6,0,6
Kimly,F,100,6,0,6
Kimon,M,100,0,6,6
Kimyia,F,100,6,0,6
Kinaya,F,100,6,0,6
Kineta,F,100,6,0,6
Kingcharles,M,100,0,6,6
Kingelijah,M,100,0,6,6
Kingman,M,100,0,6,6
Kinita,F,100,6,0,6
Kinneth,M,100,0,6,6
Kinnidy,F,100,6,0,6
Kinsington,F,100,6,0,6
Kipper,M,100,0,6,6
Kire,M,100,0,6,6
Kiro,M,100,0,6,6
Kiros,M,100,0,6,6
Kirstee,F,100,6,0,6
Kirti,F,100,6,0,6
Kirtis,M,100,0,6,6
Kirtley,M,100,0,6,6
Kissa,F,100,6,0,6
Kiyanah,F,100,6,0,6
Kiylie,F,100,6,0,6
Kiyuana,F,100,6,0,6
Kjirsten,F,100,6,0,6
Kloei,F,100,6,0,6
Klowie,F,100,6,0,6
Knoa,M,100,0,6,6
Knoxley,M,100,0,6,6
Kobin,M,100,0,6,6
Koehn,M,100,0,6,6
Kogan,M,100,0,6,6
Kojiro,M,100,0,6,6
Konan,M,100,0,6,6
Konica,F,100,6,0,6
Kopelynn,F,100,6,0,6
Koralyne,F,100,6,0,6
Korbynn,F,100,6,0,6
Kordale,M,100,0,6,6
Koreena,F,100,6,0,6
Korei,M,100,0,6,6
Korrion,M,100,0,6,6
Korsica,F,100,6,0,6
Kouta,M,100,0,6,6
Kovu,M,100,0,6,6
Kowsar,F,100,6,0,6
Krisie,F,100,6,0,6
Krisina,F,100,6,0,6
Kristah,F,100,6,0,6
Kristey,F,100,6,0,6
Kristhel,F,100,6,0,6
Kristiano,M,100,0,6,6
Kristijan,M,100,0,6,6
Kristo,M,100,0,6,6
Krisy,F,100,6,0,6
Krymson,F,100,6,0,6
Kryslyn,F,100,6,0,6
Krystalann,F,100,6,0,6
Krystell,F,100,6,0,6
Krystena,F,100,6,0,6
Kule,M,100,0,6,6
Kuran,M,100,0,6,6
Kurston,F,100,6,0,6
Kushagra,M,100,0,6,6
Kuyper,M,100,0,6,6
Kvaughn,M,100,0,6,6
Kwanesha,F,100,6,0,6
Kwmaine,M,100,0,6,6
Kwon,M,100,0,6,6
Kyaisha,F,100,6,0,6
Kyala,F,100,6,0,6
Kyaw,M,100,0,6,6
Kyelle,F,100,6,0,6
Kylaya,F,100,6,0,6
Kyleighann,F,100,6,0,6
Kylianna,F,100,6,0,6
Kymbree,F,100,6,0,6
Kymia,F,100,6,0,6
Kymm,F,100,6,0,6
Kynden,M,100,0,6,6
Kynnlie,F,100,6,0,6
Kynslea,F,100,6,0,6
Kynzli,F,100,6,0,6
Kyrianna,F,100,6,0,6
Kyriee,M,100,0,6,6
Kyrus,M,100,0,6,6
Kysean,M,100,0,6,6
Kystal,F,100,6,0,6
Kyya,F,100,6,0,6
Kyzier,M,100,0,6,6
Lachaun,F,100,6,0,6
Lachlann,M,100,0,6,6
Lachrista,F,100,6,0,6
Lacia,F,100,6,0,6
Laconya,F,100,6,0,6
Lacreasha,F,100,6,0,6
Lacreisha,F,100,6,0,6
Lacreta,F,100,6,0,6
Ladamian,M,100,0,6,6
Ladamien,M,100,0,6,6
Ladarris,M,100,0,6,6
Laderian,M,100,0,6,6
Laena,F,100,6,0,6
Lagreta,F,100,6,0,6
Laicey,F,100,6,0,6
Lailaa,F,100,6,0,6
Lailarose,F,100,6,0,6
Laili,F,100,6,0,6
Lajasmine,F,100,6,0,6
Lakaiya,F,100,6,0,6
Lakan,F,100,6,0,6
Lakari,M,100,0,6,6
Lakeena,F,100,6,0,6
Lakeeya,F,100,6,0,6
Laketria,F,100,6,0,6
Lakiera,F,100,6,0,6
Laking,M,100,0,6,6
Lakreisha,F,100,6,0,6
Lalaina,F,100,6,0,6
Lalanya,F,100,6,0,6
Lalinda,F,100,6,0,6
Laliyah,F,100,6,0,6
Lamarian,M,100,0,6,6
Lambros,M,100,0,6,6
Lametra,F,100,6,0,6
Lamontre,M,100,0,6,6
Lanaiyah,F,100,6,0,6
Lanashia,F,100,6,0,6
Landun,M,100,0,6,6
Lanedra,F,100,6,0,6
Langford,M,100,0,6,6
Lanicia,F,100,6,0,6
Lanston,M,100,0,6,6
Lanxton,M,100,0,6,6
Laparis,F,100,6,0,6
Laporchia,F,100,6,0,6
Laporshia,F,100,6,0,6
Laquann,M,100,0,6,6
Laquavis,M,100,0,6,6
Laquette,F,100,6,0,6
Laquista,F,100,6,0,6
Laquitha,F,100,6,0,6
Laqunda,F,100,6,0,6
Laquonda,F,100,6,0,6
Laramy,M,100,0,6,6
Lareisha,F,100,6,0,6
Larwance,M,100,0,6,6
Lasey,F,100,6,0,6
Lashaon,F,100,6,0,6
Lashel,F,100,6,0,6
Lashena,F,100,6,0,6
Lashenda,F,100,6,0,6
Lashonia,F,100,6,0,6
Lashonn,F,100,6,0,6
Lashounda,F,100,6,0,6
Lashunna,F,100,6,0,6
Lassana,M,100,0,6,6
Latanza,F,100,6,0,6
Latavian,M,100,0,6,6
Latay,F,100,6,0,6
Lateafa,F,100,6,0,6
Lateen,F,100,6,0,6
Latefia,F,100,6,0,6
Latera,F,100,6,0,6
Laterrion,M,100,0,6,6
Latha,F,100,6,0,6
Latischa,F,100,6,0,6
Latonio,M,100,0,6,6
Latonyia,F,100,6,0,6
Latoyria,F,100,6,0,6
Latoysha,F,100,6,0,6
Latreal,M,100,0,6,6
Latreisha,F,100,6,0,6
Latrenia,F,100,6,0,6
Latres,F,100,6,0,6
Latreva,F,100,6,0,6
Latrez,M,100,0,6,6
Latwana,F,100,6,0,6
Laundyn,F,100,6,0,6
Laurelei,F,100,6,0,6
Laurenda,F,100,6,0,6
Laurenmarie,F,100,6,0,6
Laurieanne,F,100,6,0,6
Lavania,F,100,6,0,6
Lavares,M,100,0,6,6
Lavie,F,100,6,0,6
Lavora,F,100,6,0,6
Layahna,F,100,6,0,6
Layelle,F,100,6,0,6
Layke,M,100,0,6,6
Laykyn,F,100,6,0,6
Laylagrace,F,100,6,0,6
Laylonie,F,100,6,0,6
Layman,M,100,0,6,6
Layra,F,100,6,0,6
Lazariya,F,100,6,0,6
Lazerrick,M,100,0,6,6
Laziyah,F,100,6,0,6
Leahana,F,100,6,0,6
Leangela,F,100,6,0,6
Leavy,M,100,0,6,6
Leca,F,100,6,0,6
Leddi,F,100,6,0,6
Leelend,M,100,0,6,6
Leeonna,F,100,6,0,6
Leeson,M,100,0,6,6
Leimomi,F,100,6,0,6
Leisl,F,100,6,0,6
Lekevia,F,100,6,0,6
Lemmy,M,100,0,6,6
Lennora,F,100,6,0,6
Lenorah,F,100,6,0,6
Lenyn,F,100,6,0,6
Leoda,F,100,6,0,6
Leray,M,100,0,6,6
Leretha,F,100,6,0,6
Lesette,F,100,6,0,6
Lesliann,F,100,6,0,6
Leslyn,F,100,6,0,6
Lesvia,F,100,6,0,6
Letanya,F,100,6,0,6
Leti,F,100,6,0,6
Letrisha,F,100,6,0,6
Leum,M,100,0,6,6
Levitt,M,100,0,6,6
Lewyn,M,100,0,6,6
Lexanie,F,100,6,0,6
Lexas,F,100,6,0,6
Lexin,M,100,0,6,6
Liad,M,100,0,6,6
Liahona,F,100,6,0,6
Liamm,M,100,0,6,6
Lianett,F,100,6,0,6
Libia,F,100,6,0,6
Libny,F,100,6,0,6
Liera,F,100,6,0,6
Lija,F,100,6,0,6
Lijana,F,100,6,0,6
Lilea,F,100,6,0,6
Lileana,F,100,6,0,6
Liliam,F,100,6,0,6
Liliannah,F,100,6,0,6
Lillyaunna,F,100,6,0,6
Lillybeth,F,100,6,0,6
Lilyiana,F,100,6,0,6
Lilyrae,F,100,6,0,6
Limmie,M,100,0,6,6
Linas,M,100,0,6,6
Linayah,F,100,6,0,6
Lindal,M,100,0,6,6
Lindle,M,100,0,6,6
Lindsea,F,100,6,0,6
Lindzee,F,100,6,0,6
Lindzi,F,100,6,0,6
Lindzy,F,100,6,0,6
Linett,F,100,6,0,6
Lingyi,F,100,6,0,6
Linsi,F,100,6,0,6
Lionso,M,100,0,6,6
Lipman,M,100,0,6,6
Lirim,M,100,0,6,6
Lisaanne,F,100,6,0,6
Lisabella,F,100,6,0,6
Lisania,F,100,6,0,6
Lisanna,F,100,6,0,6
Litsi,F,100,6,0,6
Littie,F,100,6,0,6
Livya,F,100,6,0,6
Liylah,F,100,6,0,6
Lizann,F,100,6,0,6
Lizbeht,F,100,6,0,6
Lizete,F,100,6,0,6
Lizsandra,F,100,6,0,6
Lizveth,F,100,6,0,6
Lizy,F,100,6,0,6
Llamile,F,100,6,0,6
Llana,F,100,6,0,6
Llia,F,100,6,0,6
Loah,F,100,6,0,6
Loch,M,100,0,6,6
Locklin,M,100,0,6,6
Locklynn,F,100,6,0,6
Lodema,F,100,6,0,6
Loman,M,100,0,6,6
Lonia,F,100,6,0,6
Lonniel,M,100,0,6,6
Lonnisha,F,100,6,0,6
Lor,M,100,0,6,6
Lorae,F,100,6,0,6
Loras,M,100,0,6,6
Loreina,F,100,6,0,6
Loreyna,F,100,6,0,6
Lorian,F,100,6,0,6
Lorii,F,100,6,0,6
Loritta,F,100,6,0,6
Lorriann,F,100,6,0,6
Lossie,F,100,6,0,6
Loui,M,100,0,6,6
Lourena,F,100,6,0,6
Louria,F,100,6,0,6
Lowella,F,100,6,0,6
Luay,M,100,0,6,6
Luccia,F,100,6,0,6
Lucendia,F,100,6,0,6
Luchana,F,100,6,0,6
Ludwika,F,100,6,0,6
Lueann,F,100,6,0,6
Luisalejandro,M,100,0,6,6
Luiseduardo,M,100,0,6,6
Luisita,F,100,6,0,6
Luismario,M,100,0,6,6
Luispablo,M,100,0,6,6
Lukyan,M,100,0,6,6
Lulamae,F,100,6,0,6
Lulla,F,100,6,0,6
Lum,M,100,0,6,6
Lumin,F,100,6,0,6
Lumina,F,100,6,0,6
Lunda,F,100,6,0,6
Lusila,F,100,6,0,6
Lusine,F,100,6,0,6
Luxx,F,100,6,0,6
Luzero,F,100,6,0,6
Lyannah,F,100,6,0,6
Lyell,M,100,0,6,6
Lylli,F,100,6,0,6
Lyllia,F,100,6,0,6
Lyndzee,F,100,6,0,6
Lyndzi,F,100,6,0,6
Lynel,F,100,6,0,6
Lynet,F,100,6,0,6
Lynk,M,100,0,6,6
Lynken,M,100,0,6,6
Lynnaya,F,100,6,0,6
Lynneah,F,100,6,0,6
Lynnzie,F,100,6,0,6
Lynore,F,100,6,0,6
Lynx,M,100,0,6,6
Lyrie,F,100,6,0,6
Lyssette,F,100,6,0,6
Lytia,F,100,6,0,6
Lytonia,F,100,6,0,6
Lywanda,F,100,6,0,6
Maali,F,100,6,0,6
Maaria,F,100,6,0,6
Mabrie,F,100,6,0,6
Macalah,F,100,6,0,6
Macayle,F,100,6,0,6
Macaylee,F,100,6,0,6
Macgyver,M,100,0,6,6
Machala,F,100,6,0,6
Machayla,F,100,6,0,6
Machenzie,F,100,6,0,6
Mackai,M,100,0,6,6
Mackena,F,100,6,0,6
Mackenlee,F,100,6,0,6
Mackensey,F,100,6,0,6
Mackinzee,F,100,6,0,6
Macklan,M,100,0,6,6
Macklyn,F,100,6,0,6
Maclan,M,100,0,6,6
Madan,M,100,0,6,6
Maday,F,100,6,0,6
Madchen,F,100,6,0,6
Maddin,M,100,0,6,6
Madeley,F,100,6,0,6
Madellyn,F,100,6,0,6
Madilene,F,100,6,0,6
Madlin,F,100,6,0,6
Madrona,F,100,6,0,6
Maelah,F,100,6,0,6
Maesa,F,100,6,0,6
Maesie,F,100,6,0,6
Mafata,F,100,6,0,6
Magalis,F,100,6,0,6
Magdelin,F,100,6,0,6
Mahaela,F,100,6,0,6
Mahal,F,100,6,0,6
Mahati,F,100,6,0,6
Mahawa,F,100,6,0,6
Mahelet,F,100,6,0,6
Mahia,F,100,6,0,6
Mahiyah,F,100,6,0,6
Mahjabeen,F,100,6,0,6
Mahlani,F,100,6,0,6
Mahri,F,100,6,0,6
Mahsiah,M,100,0,6,6
Maijah,F,100,6,0,6
Maiko,F,100,6,0,6
Maikou,F,100,6,0,6
Mailah,F,100,6,0,6
Mailei,F,100,6,0,6
Mairenn,F,100,6,0,6
Maize,F,100,6,0,6
Majok,M,100,0,6,6
Makah,M,100,0,6,6
Makaiyla,F,100,6,0,6
Makaleigh,F,100,6,0,6
Makalla,F,100,6,0,6
Makay,F,100,6,0,6
Makbel,M,100,0,6,6
Makeesha,F,100,6,0,6
Makeira,F,100,6,0,6
Makenya,F,100,6,0,6
Malaija,F,100,6,0,6
Malaila,F,100,6,0,6
Malaja,F,100,6,0,6
Malcome,M,100,0,6,6
Malen,M,100,0,6,6
Malene,F,100,6,0,6
Malibu,F,100,6,0,6
Malinah,F,100,6,0,6
Malisia,F,100,6,0,6
Malkie,F,100,6,0,6
Malkiel,M,100,0,6,6
Mallak,F,100,6,0,6
Mallari,F,100,6,0,6
Mallorey,F,100,6,0,6
Malta,F,100,6,0,6
Malvern,M,100,0,6,6
Malvika,F,100,6,0,6
Malyke,M,100,0,6,6
Mamady,M,100,0,6,6
Mamediarra,F,100,6,0,6
Manali,F,100,6,0,6
Mancil,M,100,0,6,6
Mandolyn,F,100,6,0,6
Maneh,F,100,6,0,6
Manetta,F,100,6,0,6
Manijah,F,100,6,0,6
Mannuel,M,100,0,6,6
Maraia,F,100,6,0,6
Maraki,F,100,6,0,6
Marbely,F,100,6,0,6
Marcjacob,M,100,0,6,6
Marcon,M,100,0,6,6
Maredith,F,100,6,0,6
Mareen,F,100,6,0,6
Marell,M,100,0,6,6
Marenda,F,100,6,0,6
Mareon,M,100,0,6,6
Margues,M,100,0,6,6
Mariacamila,F,100,6,0,6
Mariacecilia,F,100,6,0,6
Mariaisabella,F,100,6,0,6
Marialuiza,F,100,6,0,6
Marielouise,F,100,6,0,6
Marierose,F,100,6,0,6
Marigene,F,100,6,0,6
Marilisa,F,100,6,0,6
Marillany,F,100,6,0,6
Marisah,F,100,6,0,6
Marithza,F,100,6,0,6
Marjo,F,100,6,0,6
Markael,M,100,0,6,6
Markal,M,100,0,6,6
Markas,M,100,0,6,6
Markecia,F,100,6,0,6
Markeesha,F,100,6,0,6
Markesa,F,100,6,0,6
Markevis,M,100,0,6,6
Marks,M,100,0,6,6
Marlasia,F,100,6,0,6
Marle,F,100,6,0,6
Marlean,F,100,6,0,6
Marleyna,F,100,6,0,6
Marliah,F,100,6,0,6
Marnia,F,100,6,0,6
Marquaveon,M,100,0,6,6
Marqueshia,F,100,6,0,6
Marquett,M,100,0,6,6
Marquila,F,100,6,0,6
Marren,F,100,6,0,6
Marryn,F,100,6,0,6
Marshelia,F,100,6,0,6
Marsia,F,100,6,0,6
Marson,M,100,0,6,6
Martene,F,100,6,0,6
Martesha,F,100,6,0,6
Martiana,F,100,6,0,6
Martricia,F,100,6,0,6
Maryela,F,100,6,0,6
Maryia,F,100,6,0,6
Maryjose,F,100,6,0,6
Marylene,F,100,6,0,6
Marylon,F,100,6,0,6
Marymichael,F,100,6,0,6
Marynell,F,100,6,0,6
Maryona,F,100,6,0,6
Maryorie,F,100,6,0,6
Mashanda,F,100,6,0,6
Mashika,F,100,6,0,6
Masonjames,M,100,0,6,6
Masun,M,100,0,6,6
Mateah,F,100,6,0,6
Matha,F,100,6,0,6
Mati,M,100,0,6,6
Matisen,F,100,6,0,6
Matrim,M,100,0,6,6
Mattigan,F,100,6,0,6
Maurina,F,100,6,0,6
Maxey,M,100,0,6,6
Maxiel,F,100,6,0,6
Maximilano,M,100,0,6,6
Maximillan,M,100,0,6,6
Maximillien,M,100,0,6,6
Maximous,M,100,0,6,6
Maxus,M,100,0,6,6
Maxxton,M,100,0,6,6
Maybelin,F,100,6,0,6
Mayford,M,100,0,6,6
Mayhem,M,100,0,6,6
Mayim,F,100,6,0,6
Maykala,F,100,6,0,6
Maylasia,F,100,6,0,6
Mayle,F,100,6,0,6
Mayren,F,100,6,0,6
Mcallister,F,100,6,0,6
Mccabe,M,100,0,6,6
Mcclane,M,100,0,6,6
Mcdaniel,M,100,0,6,6
Mckaylie,F,100,6,0,6
Mckaylin,F,100,6,0,6
Mckynli,F,100,6,0,6
Mcneil,M,100,0,6,6
Meea,F,100,6,0,6
Megham,F,100,6,0,6
Meilany,F,100,6,0,6
Meiyi,F,100,6,0,6
Mekiyah,F,100,6,0,6
Mekko,M,100,0,6,6
Melech,M,100,0,6,6
Melecia,F,100,6,0,6
Melesia,F,100,6,0,6
Melica,F,100,6,0,6
Melih,M,100,0,6,6
Melissasue,F,100,6,0,6
Mellinda,F,100,6,0,6
Mellyssa,F,100,6,0,6
Melodyrose,F,100,6,0,6
Melonia,F,100,6,0,6
Melquiades,M,100,0,6,6
Melroy,M,100,0,6,6
Memphys,M,100,0,6,6
Menachemmendel,M,100,0,6,6
Merab,F,100,6,0,6
Meraiah,F,100,6,0,6
Meraris,F,100,6,0,6
Mercedees,F,100,6,0,6
Merena,F,100,6,0,6
Merianne,F,100,6,0,6
Merie,F,100,6,0,6
Merilynn,F,100,6,0,6
Merisha,F,100,6,0,6
Meritt,F,100,6,0,6
Merleen,F,100,6,0,6
Merliah,F,100,6,0,6
Merlynn,F,100,6,0,6
Merrit,F,100,6,0,6
Mertie,F,100,6,0,6
Meshon,F,100,6,0,6
Meshulem,M,100,0,6,6
Messiyah,M,100,0,6,6
Metro,M,100,0,6,6
Mevelyn,F,100,6,0,6
Mialyn,F,100,6,0,6
Miamore,F,100,6,0,6
Miari,F,100,6,0,6
Miccah,F,100,6,0,6
Michaee,M,100,0,6,6
Michaeel,M,100,0,6,6
Michaelanne,F,100,6,0,6
Michaelgabriel,M,100,0,6,6
Michaeljames,M,100,0,6,6
Michaelvincent,M,100,0,6,6
Michall,M,100,0,6,6
Micharl,M,100,0,6,6
Michealangelo,M,100,0,6,6
Micheale,F,100,6,0,6
Michellie,F,100,6,0,6
Michille,F,100,6,0,6
Mickaylah,F,100,6,0,6
Mickenna,F,100,6,0,6
Miguelito,M,100,0,6,6
Mihajlo,M,100,0,6,6
Mihit,M,100,0,6,6
Miho,F,100,6,0,6
Mikali,F,100,6,0,6
Mikalia,F,100,6,0,6
Mikayel,M,100,0,6,6
Mikayela,F,100,6,0,6
Mikelyn,F,100,6,0,6
Mikeshia,F,100,6,0,6
Mikkayla,F,100,6,0,6
Mikkia,F,100,6,0,6
Milaun,F,100,6,0,6
Milen,M,100,0,6,6
Milene,F,100,6,0,6
Milenka,F,100,6,0,6
Milessa,F,100,6,0,6
Mileyah,F,100,6,0,6
Milicent,F,100,6,0,6
Militza,F,100,6,0,6
Milledge,M,100,0,6,6
Minaal,F,100,6,0,6
Minas,M,100,0,6,6
Miori,F,100,6,0,6
Mirae,F,100,6,0,6
Mirannda,F,100,6,0,6
Mirayah,F,100,6,0,6
Mirola,F,100,6,0,6
Mironda,F,100,6,0,6
Miryan,F,100,6,0,6
Mishale,F,100,6,0,6
Mishall,F,100,6,0,6
Mishea,F,100,6,0,6
Mithun,M,100,0,6,6
Mitze,F,100,6,0,6
Miyako,F,100,6,0,6
Miykael,M,100,0,6,6
Miyona,F,100,6,0,6
Mkai,M,100,0,6,6
Moaaz,M,100,0,6,6
Moad,M,100,0,6,6
Modena,F,100,6,0,6
Modesti,F,100,6,0,6
Moeko,F,100,6,0,6
Mohmed,M,100,0,6,6
Moire,F,100,6,0,6
Momen,M,100,0,6,6
Monaye,F,100,6,0,6
Mondell,M,100,0,6,6
Mondre,M,100,0,6,6
Moneca,F,100,6,0,6
Monecia,F,100,6,0,6
Monek,F,100,6,0,6
Monifah,F,100,6,0,6
Monisa,F,100,6,0,6
Monnica,F,100,6,0,6
Monque,F,100,6,0,6
Monson,M,100,0,6,6
Montee,M,100,0,6,6
Monterious,M,100,0,6,6
Monterius,M,100,0,6,6
Monterrius,M,100,0,6,6
Montessa,F,100,6,0,6
Monteze,M,100,0,6,6
Montica,F,100,6,0,6
Montinique,F,100,6,0,6
Montra,F,100,6,0,6
Montrelle,M,100,0,6,6
Mordcha,M,100,0,6,6
Morgynn,F,100,6,0,6
Morine,F,100,6,0,6
Morocco,M,100,0,6,6
Morrighan,F,100,6,0,6
Morrissa,F,100,6,0,6
Morsal,F,100,6,0,6
Morty,M,100,0,6,6
Mosa,M,100,0,6,6
Mosetta,F,100,6,0,6
Mosha,M,100,0,6,6
Mosley,M,100,0,6,6
Mossimo,M,100,0,6,6
Mouctar,M,100,0,6,6
Moxxi,F,100,6,0,6
Mrk,M,100,0,6,6
Muaaz,M,100,0,6,6
Mubeen,M,100,0,6,6
Mubina,F,100,6,0,6
Mumina,F,100,6,0,6
Mumtas,F,100,6,0,6
Munachi,M,100,0,6,6
Mundy,F,100,6,0,6
Murlean,F,100,6,0,6
Murleen,F,100,6,0,6
Mursal,F,100,6,0,6
Murtis,F,100,6,0,6
Musfirah,F,100,6,0,6
Musheerah,F,100,6,0,6
Mussa,M,100,0,6,6
Myalee,F,100,6,0,6
Myani,F,100,6,0,6
Myar,F,100,6,0,6
Myion,M,100,0,6,6
Myionna,F,100,6,0,6
Mykailah,F,100,6,0,6
Mykesha,F,100,6,0,6
Mykeya,F,100,6,0,6
Mylania,F,100,6,0,6
Myon,M,100,0,6,6
Myshon,M,100,0,6,6
Naail,M,100,0,6,6
Naailah,F,100,6,0,6
Naairah,F,100,6,0,6
Nabella,F,100,6,0,6
Nabihah,F,100,6,0,6
Nadjah,F,100,6,0,6
Nadyah,F,100,6,0,6
Nafi,M,100,0,6,6
Nagisa,F,100,6,0,6
Nahiomy,F,100,6,0,6
Nahmir,M,100,0,6,6
Nahome,M,100,0,6,6
Nahuel,M,100,0,6,6
Nahyeli,F,100,6,0,6
Naihla,F,100,6,0,6
Naileah,F,100,6,0,6
Naiyeli,F,100,6,0,6
Nakaia,F,100,6,0,6
Nakasha,F,100,6,0,6
Nakeda,F,100,6,0,6
Nakeita,F,100,6,0,6
Nakeitha,F,100,6,0,6
Nakendra,F,100,6,0,6
Nakeria,F,100,6,0,6
Nakoma,M,100,0,6,6
Nakye,M,100,0,6,6
Nakyiah,F,100,6,0,6
Nalan,M,100,0,6,6
Nalana,F,100,6,0,6
Nali,F,100,6,0,6
Nanyamka,F,100,6,0,6
Naoya,M,100,0,6,6
Narayah,F,100,6,0,6
Nardia,F,100,6,0,6
Narith,M,100,0,6,6
Narvis,F,100,6,0,6
Naryan,M,100,0,6,6
Nashaly,F,100,6,0,6
Nashiem,M,100,0,6,6
Nashonda,F,100,6,0,6
Nasiar,M,100,0,6,6
Nasirah,F,100,6,0,6
Nassem,M,100,0,6,6
Nastashia,F,100,6,0,6
Naszier,M,100,0,6,6
Natachia,F,100,6,0,6
Nataiya,F,100,6,0,6
Natalieann,F,100,6,0,6
Natalierose,F,100,6,0,6
Nataline,F,100,6,0,6
Natanim,M,100,0,6,6
Natas,M,100,0,6,6
Natavion,M,100,0,6,6
Nathann,M,100,0,6,6
Nathanual,M,100,0,6,6
Nathanyal,M,100,0,6,6
Natonia,F,100,6,0,6
Naturi,F,100,6,0,6
Natusha,F,100,6,0,6
Natya,F,100,6,0,6
Navada,F,100,6,0,6
Navae,F,100,6,0,6
Navar,M,100,0,6,6
Navarre,M,100,0,6,6
Navreet,F,100,6,0,6
Nayaly,F,100,6,0,6
Nayelee,F,100,6,0,6
Nayisha,F,100,6,0,6
Nayloni,F,100,6,0,6
Naymar,M,100,0,6,6
Nayome,F,100,6,0,6
Nayomie,F,100,6,0,6
Nayonika,F,100,6,0,6
Nayonna,F,100,6,0,6
Nazeir,M,100,0,6,6
Nazifa,F,100,6,0,6
Nedine,F,100,6,0,6
Neeah,F,100,6,0,6
Neerav,M,100,0,6,6
Neeya,F,100,6,0,6
Neily,F,100,6,0,6
Neimar,M,100,0,6,6
Neina,F,100,6,0,6
Nekiesha,F,100,6,0,6
Nelah,F,100,6,0,6
Nelina,F,100,6,0,6
Nemanja,M,100,0,6,6
Nemo,M,100,0,6,6
Neomy,F,100,6,0,6
Neon,M,100,0,6,6
Nequita,F,100,6,0,6
Nethania,F,100,6,0,6
Netty,F,100,6,0,6
Nevaen,F,100,6,0,6
Nevaha,F,100,6,0,6
Neveaha,F,100,6,0,6
Nevina,F,100,6,0,6
Nevo,M,100,0,6,6
Neylin,F,100,6,0,6
Ngela,F,100,6,0,6
Nianna,F,100,6,0,6
Nickali,M,100,0,6,6
Nickan,M,100,0,6,6
Nickeya,F,100,6,0,6
Niclole,F,100,6,0,6
Nicoe,F,100,6,0,6
Nicollas,M,100,0,6,6
Nicos,M,100,0,6,6
Nicson,M,100,0,6,6
Nidhish,M,100,0,6,6
Niela,F,100,6,0,6
Niemah,F,100,6,0,6
Nieman,M,100,0,6,6
Nigal,M,100,0,6,6
Niha,F,100,6,0,6
Nikeia,F,100,6,0,6
Nikema,F,100,6,0,6
Nikera,F,100,6,0,6
Nikesh,M,100,0,6,6
Nikima,F,100,6,0,6
Nikitas,M,100,0,6,6
Nikith,M,100,0,6,6
Nikitta,F,100,6,0,6
Nikkea,F,100,6,0,6
Nikkisha,F,100,6,0,6
Nikkolaus,M,100,0,6,6
Nilka,F,100,6,0,6
Nilla,F,100,6,0,6
Niloofar,F,100,6,0,6
Niloufar,F,100,6,0,6
Nilza,F,100,6,0,6
Nimai,M,100,0,6,6
Nimco,F,100,6,0,6
Nimue,F,100,6,0,6
Ninetta,F,100,6,0,6
Ninon,F,100,6,0,6
Ninti,F,100,6,0,6
Niomie,F,100,6,0,6
Nisaiah,M,100,0,6,6
Nishaan,M,100,0,6,6
Nishad,M,100,0,6,6
Nishal,M,100,0,6,6
Nishawn,M,100,0,6,6
Nishma,F,100,6,0,6
Niti,F,100,6,0,6
Nitisha,F,100,6,0,6
Nittaya,F,100,6,0,6
Niviah,F,100,6,0,6
Niyahlee,F,100,6,0,6
Noahh,M,100,0,6,6
Nolee,F,100,6,0,6
Norabelle,F,100,6,0,6
Norbu,M,100,0,6,6
Noris,F,100,6,0,6
Normandy,F,100,6,0,6
Nouci,F,100,6,0,6
Nouh,M,100,0,6,6
Novali,F,100,6,0,6
Nube,F,100,6,0,6
Nurto,F,100,6,0,6
Nyalise,F,100,6,0,6
Nyani,F,100,6,0,6
Nyeemah,F,100,6,0,6
Nygil,M,100,0,6,6
Nyjee,M,100,0,6,6
Nykeah,F,100,6,0,6
Nykiah,F,100,6,0,6
Nyko,M,100,0,6,6
Nylani,F,100,6,0,6
Nylasia,F,100,6,0,6
Nylayah,F,100,6,0,6
Nyonna,F,100,6,0,6
Nyseem,M,100,0,6,6
Nyshia,F,100,6,0,6
Nysia,F,100,6,0,6
Nytasia,F,100,6,0,6
Nyteria,F,100,6,0,6
Nytisha,F,100,6,0,6
Obet,M,100,0,6,6
Obiora,M,100,0,6,6
Odali,F,100,6,0,6
Odarius,M,100,0,6,6
Oddis,M,100,0,6,6
Odel,M,100,0,6,6
Odester,F,100,6,0,6
Odett,F,100,6,0,6
Odile,F,100,6,0,6
Ohemaa,F,100,6,0,6
Ojani,M,100,0,6,6
Okalani,F,100,6,0,6
Oktober,F,100,6,0,6
Olajawon,M,100,0,6,6
Olander,M,100,0,6,6
Olani,F,100,6,0,6
Olean,F,100,6,0,6
Olivine,F,100,6,0,6
Oliviya,F,100,6,0,6
Olla,F,100,6,0,6
Ollivander,M,100,0,6,6
Oluseyi,M,100,0,6,6
Oluwafunmilayo,F,100,6,0,6
Oluwaseyifunmi,F,100,6,0,6
Olwyn,F,100,6,0,6
Olyn,M,100,0,6,6
Omaid,M,100,0,6,6
Omaida,F,100,6,0,6
Omeshia,F,100,6,0,6
Omiyah,F,100,6,0,6
Omotayo,M,100,0,6,6
Onda,F,100,6,0,6
Ondria,F,100,6,0,6
Onel,M,100,0,6,6
Onetha,F,100,6,0,6
Ontarius,M,100,0,6,6
Onyinyechukwu,F,100,6,0,6
Oonagh,F,100,6,0,6
Orbin,M,100,0,6,6
Oreste,M,100,0,6,6
Oretta,F,100,6,0,6
Orey,M,100,0,6,6
Orfelinda,F,100,6,0,6
Orinda,F,100,6,0,6
Oriya,F,100,6,0,6
Orlandis,M,100,0,6,6
Ormond,M,100,0,6,6
Orquidia,F,100,6,0,6
Orysia,F,100,6,0,6
Osaretin,M,100,0,6,6
Osby,M,100,0,6,6
Osheana,F,100,6,0,6
Othelia,F,100,6,0,6
Ottavio,M,100,0,6,6
Ottilia,F,100,6,0,6
Oumy,F,100,6,0,6
Oved,M,100,0,6,6
Ovie,M,100,0,6,6
Oyinkansola,F,100,6,0,6
Ozziel,M,100,0,6,6
Pacifica,F,100,6,0,6
Pai,F,100,6,0,6
Panagiotes,M,100,0,6,6
Panda,F,100,6,0,6
Pandy,F,100,6,0,6
Paramveer,M,100,0,6,6
Pareesa,F,100,6,0,6
Paridhi,F,100,6,0,6
Parina,F,100,6,0,6
Parisha,F,100,6,0,6
Parizoda,F,100,6,0,6
Parmida,F,100,6,0,6
Parmis,F,100,6,0,6
Pashion,F,100,6,0,6
Pasleigh,F,100,6,0,6
Pater,M,100,0,6,6
Patericia,F,100,6,0,6
Patricie,F,100,6,0,6
Patrise,F,100,6,0,6
Patrycia,F,100,6,0,6
Patte,F,100,6,0,6
Paulena,F,100,6,0,6
Pauleth,F,100,6,0,6
Paulos,M,100,0,6,6
Pawan,M,100,0,6,6
Paxtin,M,100,0,6,6
Paydon,M,100,0,6,6
Paylen,F,100,6,0,6
Paymon,M,100,0,6,6
Payshance,F,100,6,0,6
Payshence,F,100,6,0,6
Paysleigh,F,100,6,0,6
Paytton,F,100,6,0,6
Pearle,F,100,6,0,6
Pedram,M,100,0,6,6
Peggyanne,F,100,6,0,6
Peighten,F,100,6,0,6
Peneloperose,F,100,6,0,6
Penrose,F,100,6,0,6
Peregrin,M,100,0,6,6
Persayus,F,100,6,0,6
Pershing,M,100,0,6,6
Petro,M,100,0,6,6
Pfeiffer,F,100,6,0,6
Phala,F,100,6,0,6
Phares,M,100,0,6,6
Phat,M,100,0,6,6
Philicity,F,100,6,0,6
Phylica,F,100,6,0,6
Phyllistine,F,100,6,0,6
Phynix,F,100,6,0,6
Pinkey,F,100,6,0,6
Piyush,M,100,0,6,6
Pnina,F,100,6,0,6
Porshae,F,100,6,0,6
Pranathi,F,100,6,0,6
Pranisha,F,100,6,0,6
Pranshi,F,100,6,0,6
Prayas,M,100,0,6,6
Pricella,F,100,6,0,6
Pricsilla,F,100,6,0,6
Princejohn,M,100,0,6,6
Princton,M,100,0,6,6
Pritam,M,100,0,6,6
Pritesh,M,100,0,6,6
Pritika,F,100,6,0,6
Priyana,F,100,6,0,6
Priyansh,M,100,0,6,6
Priyasha,F,100,6,0,6
Promiss,F,100,6,0,6
Providencia,F,100,6,0,6
Prudy,F,100,6,0,6
Prue,F,100,6,0,6
Prynceton,M,100,0,6,6
Pual,M,100,0,6,6
Purav,M,100,0,6,6
Pushti,F,100,6,0,6
Qi,M,100,0,6,6
Quadarious,M,100,0,6,6
Quamere,M,100,0,6,6
Quandell,M,100,0,6,6
Quaneka,F,100,6,0,6
Quaniece,F,100,6,0,6
Quashun,M,100,0,6,6
Quayla,F,100,6,0,6
Qudarius,M,100,0,6,6
Que,M,100,0,6,6
Quenesha,F,100,6,0,6
Quentella,F,100,6,0,6
Quess,M,100,0,6,6
Quienten,M,100,0,6,6
Quientin,M,100,0,6,6
Quinnisha,F,100,6,0,6
Quion,M,100,0,6,6
Quisean,M,100,0,6,6
Qunisha,F,100,6,0,6
Qunita,F,100,6,0,6
Quvondo,M,100,0,6,6
Qwanell,M,100,0,6,6
Qwentin,M,100,0,6,6
Raashida,F,100,6,0,6
Rachella,F,100,6,0,6
Racie,F,100,6,0,6
Radarius,M,100,0,6,6
Rade,M,100,0,6,6
Radhames,M,100,0,6,6
Radine,F,100,6,0,6
Radly,M,100,0,6,6
Raelen,F,100,6,0,6
Raeonna,F,100,6,0,6
Raewyn,F,100,6,0,6
Raeyah,F,100,6,0,6
Rafa,F,100,6,0,6
Raffaela,F,100,6,0,6
Rafiel,M,100,0,6,6
Rahsan,M,100,0,6,6
Raichel,F,100,6,0,6
Raidel,M,100,0,6,6
Raimi,F,100,6,0,6
Raishaun,M,100,0,6,6
Raith,M,100,0,6,6
Rajaee,M,100,0,6,6
Rajana,F,100,6,0,6
Rajohn,M,100,0,6,6
Rakeshia,F,100,6,0,6
Rakeya,F,100,6,0,6
Rakhee,F,100,6,0,6
Ralana,F,100,6,0,6
Ralik,M,100,0,6,6
Raliyah,F,100,6,0,6
Ralphel,M,100,0,6,6
Rameir,M,100,0,6,6
Ramira,F,100,6,0,6
Ramonica,F,100,6,0,6
Ranay,F,100,6,0,6
Randine,F,100,6,0,6
Ranea,F,100,6,0,6
Raniesha,F,100,6,0,6
Ranota,F,100,6,0,6
Raphiel,M,100,0,6,6
Rasaun,M,100,0,6,6
Rashadd,M,100,0,6,6
Rashaundra,F,100,6,0,6
Rashidi,M,100,0,6,6
Rashima,F,100,6,0,6
Rashmika,F,100,6,0,6
Rashonna,F,100,6,0,6
Ratana,M,100,0,6,6
Rathanak,M,100,0,6,6
Ratisha,F,100,6,0,6
Rauri,F,100,6,0,6
Ravis,M,100,0,6,6
Ravleen,F,100,6,0,6
Ravonda,F,100,6,0,6
Rawly,M,100,0,6,6
Raxton,M,100,0,6,6
Rayahna,F,100,6,0,6
Rayannah,F,100,6,0,6
Rayella,F,100,6,0,6
Rayleah,F,100,6,0,6
Rayniyah,F,100,6,0,6
Razmig,M,100,0,6,6
Reagann,F,100,6,0,6
Reatta,F,100,6,0,6
Rebba,F,100,6,0,6
Rebekan,F,100,6,0,6
Rechard,M,100,0,6,6
Reddington,M,100,0,6,6
Redge,M,100,0,6,6
Reenie,F,100,6,0,6
Regal,M,100,0,6,6
Regnald,M,100,0,6,6
Reilee,F,100,6,0,6
Reinette,F,100,6,0,6
Reja,F,100,6,0,6
Rekeisha,F,100,6,0,6
Relina,F,100,6,0,6
Remedios,F,100,6,0,6
Remingtyn,F,100,6,0,6
Remond,M,100,0,6,6
Renat,M,100,0,6,6
Renauta,F,100,6,0,6
Render,M,100,0,6,6
Renford,M,100,0,6,6
Reni,F,100,6,0,6
Renice,F,100,6,0,6
Reniesha,F,100,6,0,6
Renitta,F,100,6,0,6
Renleigh,F,100,6,0,6
Rennata,F,100,6,0,6
Rennick,M,100,0,6,6
Reveca,F,100,6,0,6
Revell,M,100,0,6,6
Revon,M,100,0,6,6
Rexine,F,100,6,0,6
Reyad,M,100,0,6,6
Reyanne,F,100,6,0,6
Reylan,M,100,0,6,6
Reyly,M,100,0,6,6
Reyse,F,100,6,0,6
Reyshawn,M,100,0,6,6
Rhakeem,M,100,0,6,6
Rhaniyah,F,100,6,0,6
Rhasheen,M,100,0,6,6
Rhodesia,F,100,6,0,6
Rhunette,F,100,6,0,6
Rhyana,F,100,6,0,6
Rhyanne,F,100,6,0,6
Rhydian,M,100,0,6,6
Rice,M,100,0,6,6
Richardean,F,100,6,0,6
Richel,F,100,6,0,6
Ricko,M,100,0,6,6
Rickyah,F,100,6,0,6
Ridhwan,M,100,0,6,6
Riece,M,100,0,6,6
Rikiyah,F,100,6,0,6
Riland,M,100,0,6,6
Rimya,F,100,6,0,6
Rinah,F,100,6,0,6
Rinata,F,100,6,0,6
Rindi,F,100,6,0,6
Rinyah,F,100,6,0,6
Riquelme,M,100,0,6,6
Rishad,M,100,0,6,6
Rishikesh,M,100,0,6,6
Ritage,F,100,6,0,6
Ritamarie,F,100,6,0,6
Rithy,M,100,0,6,6
Riylee,F,100,6,0,6
Roane,M,100,0,6,6
Robeert,M,100,0,6,6
Roche,M,100,0,6,6
Roddell,M,100,0,6,6
Rodner,M,100,0,6,6
Rodnika,F,100,6,0,6
Rodrecus,M,100,0,6,6
Rodrickus,M,100,0,6,6
Rodrigue,M,100,0,6,6
Rogelia,F,100,6,0,6
Rokesha,F,100,6,0,6
Rokisha,F,100,6,0,6
Rolley,M,100,0,6,6
Romando,M,100,0,6,6
Romelio,M,100,0,6,6
Romilda,F,100,6,0,6
Romolo,M,100,0,6,6
Romonia,F,100,6,0,6
Ronalda,F,100,6,0,6
Ronaldinho,M,100,0,6,6
Ronice,F,100,6,0,6
Ronise,F,100,6,0,6
Ronnica,F,100,6,0,6
Ronreaco,M,100,0,6,6
Roree,F,100,6,0,6
Rorke,M,100,0,6,6
Rosaelia,F,100,6,0,6
Rosan,F,100,6,0,6
Rosebud,F,100,6,0,6
Roseleen,F,100,6,0,6
Roselena,F,100,6,0,6
Roselina,F,100,6,0,6
Roselio,M,100,0,6,6
Rosezena,F,100,6,0,6
Roshod,M,100,0,6,6
Rosilee,F,100,6,0,6
Rosmary,F,100,6,0,6
Rossella,F,100,6,0,6
Rosser,M,100,0,6,6
Roston,M,100,0,6,6
Roula,F,100,6,0,6
Rovin,M,100,0,6,6
Rownan,M,100,0,6,6
Roxette,F,100,6,0,6
Roxey,F,100,6,0,6
Roxianne,F,100,6,0,6
Roxxi,F,100,6,0,6
Ruaa,F,100,6,0,6
Rubicela,F,100,6,0,6
Rueger,M,100,0,6,6
Rukaya,F,100,6,0,6
Rumor,F,100,6,0,6
Rupali,F,100,6,0,6
Ruqaiya,F,100,6,0,6
Rury,M,100,0,6,6
Ruslana,F,100,6,0,6
Russella,F,100,6,0,6
Russelle,M,100,0,6,6
Rustie,F,100,6,0,6
Rutilio,M,100,0,6,6
Ryasia,F,100,6,0,6
Rychelle,F,100,6,0,6
Ryelin,M,100,0,6,6
Ryia,F,100,6,0,6
Rylii,F,100,6,0,6
Rylind,M,100,0,6,6
Ryott,M,100,0,6,6
Ryun,M,100,0,6,6
Ryusei,M,100,0,6,6
Ryuu,M,100,0,6,6
Saadiya,F,100,6,0,6
Saajid,M,100,0,6,6
Saamia,F,100,6,0,6
Sabastain,M,100,0,6,6
Sachika,F,100,6,0,6
Sacramento,M,100,0,6,6
Sadena,F,100,6,0,6
Sadora,F,100,6,0,6
Saed,M,100,0,6,6
Safeer,M,100,0,6,6
Sagarika,F,100,6,0,6
Sahal,M,100,0,6,6
Sahibjot,M,100,0,6,6
Sahl,M,100,0,6,6
Sahmya,F,100,6,0,6
Sahniya,F,100,6,0,6
Sahrish,F,100,6,0,6
Sailyn,F,100,6,0,6
Sajani,F,100,6,0,6
Sajni,F,100,6,0,6
Sakaria,M,100,0,6,6
Salea,F,100,6,0,6
Salesi,M,100,0,6,6
Samaia,F,100,6,0,6
Samaiah,F,100,6,0,6
Samanthanicole,F,100,6,0,6
Samanvita,F,100,6,0,6
Samanvitha,F,100,6,0,6
Samaris,F,100,6,0,6
Samariyah,F,100,6,0,6
Samaura,F,100,6,0,6
Sameisha,F,100,6,0,6
Sameriah,F,100,6,0,6
Samhith,M,100,0,6,6
Samiira,F,100,6,0,6
Samisha,F,100,6,0,6
Samit,M,100,0,6,6
Sammual,M,100,0,6,6
Samnatha,F,100,6,0,6
Samonte,M,100,0,6,6
Samori,M,100,0,6,6
Samriddhi,F,100,6,0,6
Samul,M,100,0,6,6
Sanaia,F,100,6,0,6
Sanaiah,F,100,6,0,6
Sanijah,F,100,6,0,6
Sannidhi,F,100,6,0,6
Santangelo,M,100,0,6,6
Santerica,F,100,6,0,6
Santrese,F,100,6,0,6
Saquita,F,100,6,0,6
Saquoia,F,100,6,0,6
Sarahjean,F,100,6,0,6
Sarahjo,F,100,6,0,6
Saraly,F,100,6,0,6
Sardor,M,100,0,6,6
Sare,F,100,6,0,6
Sarea,F,100,6,0,6
Sareya,F,100,6,0,6
Sariana,F,100,6,0,6
Sarinah,F,100,6,0,6
Saro,M,100,0,6,6
Sarynity,F,100,6,0,6
Sathya,M,100,0,6,6
Satia,F,100,6,0,6
Satine,F,100,6,0,6
Satoko,F,100,6,0,6
Satvika,F,100,6,0,6
Saurabh,M,100,0,6,6
Savante,M,100,0,6,6
Savar,M,100,0,6,6
Savas,M,100,0,6,6
Saveer,M,100,0,6,6
Savera,F,100,6,0,6
Saviel,M,100,0,6,6
Saviour,M,100,0,6,6
Saviyon,M,100,0,6,6
Savona,F,100,6,0,6
Savonnah,F,100,6,0,6
Savvas,M,100,0,6,6
Sayre,M,100,0,6,6
Schawn,M,100,0,6,6
Scheherazade,F,100,6,0,6
Schuylar,F,100,6,0,6
Schwanda,F,100,6,0,6
Seanice,F,100,6,0,6
Sedalia,F,100,6,0,6
Seerit,F,100,6,0,6
Seith,M,100,0,6,6
Selestine,F,100,6,0,6
Semaya,F,100,6,0,6
Semeko,F,100,6,0,6
Semhar,F,100,6,0,6
Semika,F,100,6,0,6
Semiya,F,100,6,0,6
Semyon,M,100,0,6,6
Senad,M,100,0,6,6
Senikka,F,100,6,0,6
Seph,M,100,0,6,6
Sephanie,F,100,6,0,6
Seprina,F,100,6,0,6
Serbando,M,100,0,6,6
Sereda,F,100,6,0,6
Serenityrose,F,100,6,0,6
Serious,M,100,0,6,6
Seriya,F,100,6,0,6
Serj,M,100,0,6,6
Serria,F,100,6,0,6
Serynity,F,100,6,0,6
Sesily,F,100,6,0,6
Sevannah,F,100,6,0,6
Sevara,F,100,6,0,6
Shaban,M,100,0,6,6
Shadan,F,100,6,0,6
Shadaria,F,100,6,0,6
Shadel,F,100,6,0,6
Shadell,F,100,6,0,6
Shadena,F,100,6,0,6
Shaderrica,F,100,6,0,6
Shafiq,M,100,0,6,6
Shahiem,M,100,0,6,6
Shahram,M,100,0,6,6
Shakee,M,100,0,6,6
Shakeemah,F,100,6,0,6
Shakeim,M,100,0,6,6
Shaketra,F,100,6,0,6
Shaketta,F,100,6,0,6
Shakilah,F,100,6,0,6
Shakoya,F,100,6,0,6
Shalako,M,100,0,6,6
Shalani,F,100,6,0,6
Shalayne,F,100,6,0,6
Shalecia,F,100,6,0,6
Shaleek,M,100,0,6,6
Shalesha,F,100,6,0,6
Shalethia,F,100,6,0,6
Shaletta,F,100,6,0,6
Shalik,M,100,0,6,6
Shalitha,F,100,6,0,6
Shallah,M,100,0,6,6
Shallen,F,100,6,0,6
Shamane,F,100,6,0,6
Shamani,F,100,6,0,6
Shamarcus,M,100,0,6,6
Shamario,M,100,0,6,6
Shamesha,F,100,6,0,6
Shami,F,100,6,0,6
Shamier,M,100,0,6,6
Shamikia,F,100,6,0,6
Shamilla,F,100,6,0,6
Shamiqua,F,100,6,0,6
Shamiracle,F,100,6,0,6
Shamirra,F,100,6,0,6
Shamorrow,F,100,6,0,6
Shamyla,F,100,6,0,6
Shanaia,F,100,6,0,6
Shanari,F,100,6,0,6
Shandricka,F,100,6,0,6
Shanecia,F,100,6,0,6
Shanei,F,100,6,0,6
Shanet,F,100,6,0,6
Shanethia,F,100,6,0,6
Shaneya,F,100,6,0,6
Shaniese,F,100,6,0,6
Shanine,F,100,6,0,6
Shankar,M,100,0,6,6
Shannetta,F,100,6,0,6
Shannone,F,100,6,0,6
Shanoah,F,100,6,0,6
Shanquetta,F,100,6,0,6
Shanquilla,F,100,6,0,6
Shantaria,F,100,6,0,6
Shantaye,F,100,6,0,6
Shantrece,F,100,6,0,6
Shaquavia,F,100,6,0,6
Shaquay,F,100,6,0,6
Shaquelle,M,100,0,6,6
Shaquida,F,100,6,0,6
Shaquil,M,100,0,6,6
Shaqula,F,100,6,0,6
Sharaye,F,100,6,0,6
Sharayne,F,100,6,0,6
Share,F,100,6,0,6
Shareda,F,100,6,0,6
Sharessa,F,100,6,0,6
Sharidan,F,100,6,0,6
Shariece,F,100,6,0,6
Sharil,F,100,6,0,6
Sharilee,F,100,6,0,6
Shariyf,M,100,0,6,6
Sharlean,F,100,6,0,6
Sharleez,F,100,6,0,6
Sharlize,F,100,6,0,6
Sharnika,F,100,6,0,6
Sharran,F,100,6,0,6
Sharvani,F,100,6,0,6
Shasmeen,F,100,6,0,6
Shata,F,100,6,0,6
Shaterika,F,100,6,0,6
Shatice,F,100,6,0,6
Shaunell,F,100,6,0,6
Shaunessy,F,100,6,0,6
Shauniece,F,100,6,0,6
Shauntasia,F,100,6,0,6
Shauntea,F,100,6,0,6
Shauntrell,F,100,6,0,6
Shauntrice,F,100,6,0,6
Shavanda,F,100,6,0,6
Shavontae,F,100,6,0,6
Shavonya,F,100,6,0,6
Shawandra,F,100,6,0,6
Shawnalee,F,100,6,0,6
Shawneen,F,100,6,0,6
Shawnelle,F,100,6,0,6
Shawntrice,F,100,6,0,6
Shawonda,F,100,6,0,6
Shaydee,F,100,6,0,6
Shaylia,F,100,6,0,6
Shaz,M,100,0,6,6
Shazad,M,100,0,6,6
Shealeen,F,100,6,0,6
Shederick,M,100,0,6,6
Sheereen,F,100,6,0,6
Sheketha,F,100,6,0,6
Shekima,F,100,6,0,6
Shelana,F,100,6,0,6
Shelbye,F,100,6,0,6
Sheldyn,M,100,0,6,6
Sheleah,F,100,6,0,6
Sheletta,F,100,6,0,6
Shelice,F,100,6,0,6
Shelika,F,100,6,0,6
Shen,M,100,0,6,6
Shenekia,F,100,6,0,6
Shenetha,F,100,6,0,6
Sheonta,F,100,6,0,6
Shequan,M,100,0,6,6
Sheraz,M,100,0,6,6
Shereda,F,100,6,0,6
Sheriden,F,100,6,0,6
Sheridon,F,100,6,0,6
Sherlean,F,100,6,0,6
Sherona,F,100,6,0,6
Sherren,F,100,6,0,6
Sherrey,F,100,6,0,6
Sherrone,F,100,6,0,6
Sherryll,F,100,6,0,6
Shervonne,F,100,6,0,6
Sheryln,F,100,6,0,6
Sheyann,F,100,6,0,6
Shieka,F,100,6,0,6
Shiffy,F,100,6,0,6
Shihab,M,100,0,6,6
Shikeem,M,100,0,6,6
Shilonda,F,100,6,0,6
Shinell,F,100,6,0,6
Shinetta,F,100,6,0,6
Shinique,F,100,6,0,6
Shinna,F,100,6,0,6
Shiran,F,100,6,0,6
Shironda,F,100,6,0,6
Shivanshi,F,100,6,0,6
Shiyan,F,100,6,0,6
Shloke,M,100,0,6,6
Shohei,M,100,0,6,6
Shohjahon,M,100,0,6,6
Shondi,F,100,6,0,6
Shondria,F,100,6,0,6
Shonetta,F,100,6,0,6
Shontoya,F,100,6,0,6
Shoumik,M,100,0,6,6
Shovan,F,100,6,0,6
Shqipe,F,100,6,0,6
Shreena,F,100,6,0,6
Shreyash,M,100,0,6,6
Shrish,M,100,0,6,6
Shuana,F,100,6,0,6
Shuji,M,100,0,6,6
Shumeka,F,100,6,0,6
Shuntell,F,100,6,0,6
Shuntia,F,100,6,0,6
Shvonne,F,100,6,0,6
Shyia,F,100,6,0,6
Shykim,M,100,0,6,6
Shylene,F,100,6,0,6
Shyrell,F,100,6,0,6
Siale,M,100,0,6,6
Sibella,F,100,6,0,6
Sicilee,F,100,6,0,6
Sidak,M,100,0,6,6
Siddh,M,100,0,6,6
Sidny,F,100,6,0,6
Sieglinde,F,100,6,0,6
Silah,F,100,6,0,6
Silbia,F,100,6,0,6
Silja,F,100,6,0,6
Siniah,F,100,6,0,6
Sirah,F,100,6,0,6
Siran,M,100,0,6,6
Siranthony,M,100,0,6,6
Sireena,F,100,6,0,6
Sirine,F,100,6,0,6
Sismai,F,100,6,0,6
Sjon,M,100,0,6,6
Skyylar,F,100,6,0,6
Smanatha,F,100,6,0,6
Smita,F,100,6,0,6
Smokey,M,100,0,6,6
Sobeida,F,100,6,0,6
Sofiarose,F,100,6,0,6
Sofina,F,100,6,0,6
Solangie,F,100,6,0,6
Solaris,F,100,6,0,6
Solen,M,100,0,6,6
Solitaire,F,100,6,0,6
Solmarie,F,100,6,0,6
Somi,F,100,6,0,6
Somia,F,100,6,0,6
Sophany,F,100,6,0,6
Sophelia,F,100,6,0,6
Sophiaann,F,100,6,0,6
Sophyia,F,100,6,0,6
Sorayda,F,100,6,0,6
Sosaia,M,100,0,6,6
Spike,M,100,0,6,6
Spruha,F,100,6,0,6
Srikrishna,M,100,0,6,6
Srilakshmi,F,100,6,0,6
Srinivas,M,100,0,6,6
Srisha,F,100,6,0,6
Srivatsa,M,100,0,6,6
Srushti,F,100,6,0,6
Stallone,M,100,0,6,6
Standly,M,100,0,6,6
Stanely,M,100,0,6,6
Stanya,F,100,6,0,6
Starkeisha,F,100,6,0,6
Starkesha,F,100,6,0,6
Starlisha,F,100,6,0,6
Starnisha,F,100,6,0,6
Stav,F,100,6,0,6
Steeler,M,100,0,6,6
Stefenie,F,100,6,0,6
Stefin,M,100,0,6,6
Stellamae,F,100,6,0,6
Stellina,F,100,6,0,6
Steohanie,F,100,6,0,6
Stepfan,M,100,0,6,6
Stephanne,F,100,6,0,6
Stracy,F,100,6,0,6
Stu,M,100,0,6,6
Suave,M,100,0,6,6
Subin,F,100,6,0,6
Sudays,M,100,0,6,6
Suhanth,M,100,0,6,6
Sukie,F,100,6,0,6
Sumitra,F,100,6,0,6
Summers,F,100,6,0,6
Sunay,M,100,0,6,6
Sundance,M,100,0,6,6
Sunshyne,F,100,6,0,6
Suong,F,100,6,0,6
Supreet,F,100,6,0,6
Surenity,F,100,6,0,6
Susej,F,100,6,0,6
Sussan,F,100,6,0,6
Sutten,F,100,6,0,6
Suveer,M,100,0,6,6
Svana,F,100,6,0,6
Swapna,F,100,6,0,6
Swaraj,M,100,0,6,6
Swasti,F,100,6,0,6
Sweden,F,100,6,0,6
Swiyyah,F,100,6,0,6
Sye,M,100,0,6,6
Syedmuhammad,M,100,0,6,6
Syia,F,100,6,0,6
Syier,M,100,0,6,6
Syleste,F,100,6,0,6
Sylias,M,100,0,6,6
Sylys,M,100,0,6,6
Syna,F,100,6,0,6
Synda,F,100,6,0,6
Synnove,F,100,6,0,6
Syree,M,100,0,6,6
Syren,F,100,6,0,6
Syreta,F,100,6,0,6
Syretha,F,100,6,0,6
Tabata,F,100,6,0,6
Tache,F,100,6,0,6
Tacita,F,100,6,0,6
Tacorey,M,100,0,6,6
Tadrian,M,100,0,6,6
Taekwon,M,100,0,6,6
Taelen,M,100,0,6,6
Taeon,M,100,0,6,6
Taff,M,100,0,6,6
Tagan,M,100,0,6,6
Tahan,M,100,0,6,6
Tahiem,M,100,0,6,6
Tahlil,M,100,0,6,6
Tahliyah,F,100,6,0,6
Tahlor,F,100,6,0,6
Tahron,M,100,0,6,6
Taimur,M,100,0,6,6
Taishaun,M,100,0,6,6
Taitym,F,100,6,0,6
Taiveon,M,100,0,6,6
Taiyon,M,100,0,6,6
Taizlee,F,100,6,0,6
Tajanique,F,100,6,0,6
Tajuanna,F,100,6,0,6
Takanori,M,100,0,6,6
Takeita,F,100,6,0,6
Taksh,M,100,0,6,6
Taku,M,100,0,6,6
Takuto,M,100,0,6,6
Takyrah,F,100,6,0,6
Talaiya,F,100,6,0,6
Talanda,F,100,6,0,6
Talayiah,F,100,6,0,6
Talaysha,F,100,6,0,6
Talazia,F,100,6,0,6
Taleea,F,100,6,0,6
Talei,F,100,6,0,6
Taleiah,F,100,6,0,6
Talion,M,100,0,6,6
Taliyha,F,100,6,0,6
Talma,F,100,6,0,6
Talullah,F,100,6,0,6
Talus,M,100,0,6,6
Tamaia,F,100,6,0,6
Tamaj,M,100,0,6,6
Tamare,M,100,0,6,6
Tamariana,F,100,6,0,6
Tamas,M,100,0,6,6
Tamasha,F,100,6,0,6
Tametra,F,100,6,0,6
Tamilore,F,100,6,0,6
Tamiqua,F,100,6,0,6
Tamiracle,F,100,6,0,6
Tammitha,F,100,6,0,6
Tammyjo,F,100,6,0,6
Tamyiah,F,100,6,0,6
Tamzyn,F,100,6,0,6
Tanaia,F,100,6,0,6
Tanajia,F,100,6,0,6
Tanari,F,100,6,0,6
Tanaysia,F,100,6,0,6
Tanazia,F,100,6,0,6
Tanechia,F,100,6,0,6
Tangia,F,100,6,0,6
Tanira,F,100,6,0,6
Taniyha,F,100,6,0,6
Tanmayi,F,100,6,0,6
Tanni,F,100,6,0,6
Tanyell,F,100,6,0,6
Tanyka,F,100,6,0,6
Tanzim,M,100,0,6,6
Taquia,F,100,6,0,6
Taqwa,F,100,6,0,6
Tarajhi,F,100,6,0,6
Tarasa,F,100,6,0,6
Taree,F,100,6,0,6
Tareek,M,100,0,6,6
Tarel,M,100,0,6,6
Tarelle,M,100,0,6,6
Tarja,F,100,6,0,6
Tarji,F,100,6,0,6
Tarna,F,100,6,0,6
Tarvares,M,100,0,6,6
Taryah,F,100,6,0,6
Tasa,F,100,6,0,6
Tashari,F,100,6,0,6
Tashaunda,F,100,6,0,6
Tashaye,F,100,6,0,6
Tashera,F,100,6,0,6
Tata,F,100,6,0,6
Tathiana,F,100,6,0,6
Tatianah,F,100,6,0,6
Tatianya,F,100,6,0,6
Tatijana,F,100,6,0,6
Tatisha,F,100,6,0,6
Tatyiana,F,100,6,0,6
Tauren,M,100,0,6,6
Taurin,M,100,0,6,6
Tavara,F,100,6,0,6
Tavier,M,100,0,6,6
Tawfiq,M,100,0,6,6
Taycen,M,100,0,6,6
Taylea,F,100,6,0,6
Taylorjo,F,100,6,0,6
Taylorrae,F,100,6,0,6
Taylr,F,100,6,0,6
Tayma,F,100,6,0,6
Tays,F,100,6,0,6
Tayseer,M,100,0,6,6
Tayshia,F,100,6,0,6
Tayyab,M,100,0,6,6
Tazion,M,100,0,6,6
Tazkia,F,100,6,0,6
Tazlyn,F,100,6,0,6
Tazz,M,100,0,6,6
Teaghen,F,100,6,0,6
Teagin,F,100,6,0,6
Teather,F,100,6,0,6
Tehra,F,100,6,0,6
Tejash,M,100,0,6,6
Tekelia,F,100,6,0,6
Tekera,F,100,6,0,6
Tekeria,F,100,6,0,6
Telesforo,M,100,0,6,6
Teleshia,F,100,6,0,6
Telishia,F,100,6,0,6
Temeika,F,100,6,0,6
Temitayo,F,100,6,0,6
Teneil,F,100,6,0,6
Tenequa,F,100,6,0,6
Tenice,F,100,6,0,6
Tenly,F,100,6,0,6
Tennison,M,100,0,6,6
Tenuun,M,100,0,6,6
Teoman,M,100,0,6,6
Tequisha,F,100,6,0,6
Tequlia,F,100,6,0,6
Teraji,F,100,6,0,6
Teranique,F,100,6,0,6
Teres,F,100,6,0,6
Terick,M,100,0,6,6
Terranisha,F,100,6,0,6
Terreance,M,100,0,6,6
Terrena,F,100,6,0,6
Terrico,M,100,0,6,6
Terrik,M,100,0,6,6
Terriss,M,100,0,6,6
Territa,F,100,6,0,6
Terrod,M,100,0,6,6
Terryion,M,100,0,6,6
Tesfa,M,100,0,6,6
Teslyn,F,100,6,0,6
Tesslynn,F,100,6,0,6
Tewanna,F,100,6,0,6
Teyani,F,100,6,0,6
Thackery,M,100,0,6,6
Thaden,M,100,0,6,6
Thaine,M,100,0,6,6
Thamas,M,100,0,6,6
Tharun,M,100,0,6,6
Thatiana,F,100,6,0,6
Thedford,M,100,0,6,6
Thena,F,100,6,0,6
Theresamarie,F,100,6,0,6
Thiana,F,100,6,0,6
Tho,M,100,0,6,6
Thommy,M,100,0,6,6
Thristian,M,100,0,6,6
Thurl,M,100,0,6,6
Thurnell,M,100,0,6,6
Thuytien,F,100,6,0,6
Thyago,M,100,0,6,6
Tiairra,F,100,6,0,6
Tianca,F,100,6,0,6
Tiarrah,F,100,6,0,6
Tiayana,F,100,6,0,6
Tice,M,100,0,6,6
Tifeoluwa,M,100,0,6,6
Tiffeney,F,100,6,0,6
Tiffnay,F,100,6,0,6
Tiffy,F,100,6,0,6
Tifinie,F,100,6,0,6
Tifiny,F,100,6,0,6
Tihanna,F,100,6,0,6
Tijae,F,100,6,0,6
Tijah,F,100,6,0,6
Tikita,F,100,6,0,6
Tilghman,M,100,0,6,6
Till,M,100,0,6,6
Timberlyn,F,100,6,0,6
Timmeka,F,100,6,0,6
Timmeshia,F,100,6,0,6
Timmia,F,100,6,0,6
Timmya,F,100,6,0,6
Timothea,F,100,6,0,6
Timoty,M,100,0,6,6
Timtohy,M,100,0,6,6
Tineshia,F,100,6,0,6
Tinita,F,100,6,0,6
Tiniya,F,100,6,0,6
Tinsleigh,F,100,6,0,6
Tirenioluwa,F,100,6,0,6
Tirra,F,100,6,0,6
Tishina,F,100,6,0,6
Tlalli,F,100,6,0,6
Tnya,F,100,6,0,6
Tobiloba,M,100,0,6,6
Toltu,F,100,6,0,6
Tomecia,F,100,6,0,6
Tomias,M,100,0,6,6
Tomii,F,100,6,0,6
Tomoya,M,100,0,6,6
Tomya,F,100,6,0,6
Tondrea,F,100,6,0,6
Tonilyn,F,100,6,0,6
Tonirose,F,100,6,0,6
Tonji,F,100,6,0,6
Tonyette,F,100,6,0,6
Toral,F,100,6,0,6
Torance,M,100,0,6,6
Torrean,M,100,0,6,6
Torriana,F,100,6,0,6
Torstein,M,100,0,6,6
Toyota,F,100,6,0,6
Tracyn,M,100,0,6,6
Traeshon,M,100,0,6,6
Tranese,F,100,6,0,6
Trase,M,100,0,6,6
Travan,M,100,0,6,6
Trawn,M,100,0,6,6
Trayci,F,100,6,0,6
Traydon,M,100,0,6,6
Traylor,M,100,0,6,6
Tredell,M,100,0,6,6
Trela,F,100,6,0,6
Trema,F,100,6,0,6
Tremekia,F,100,6,0,6
Tremere,M,100,0,6,6
Trenady,F,100,6,0,6
Trenedy,F,100,6,0,6
Trenica,F,100,6,0,6
Trenny,F,100,6,0,6
Treona,F,100,6,0,6
Trese,F,100,6,0,6
Trevel,M,100,0,6,6
Trevelyan,M,100,0,6,6
Trevionne,M,100,0,6,6
Trevontay,M,100,0,6,6
Trevoris,M,100,0,6,6
Trexton,M,100,0,6,6
Treyvor,M,100,0,6,6
Trezden,M,100,0,6,6
Trillian,F,100,6,0,6
Trimeka,F,100,6,0,6
Trinatee,F,100,6,0,6
Trinice,F,100,6,0,6
Triniece,F,100,6,0,6
Trinika,F,100,6,0,6
Tripper,M,100,0,6,6
Trippton,M,100,0,6,6
Tristine,F,100,6,0,6
Trotter,M,100,0,6,6
Trudell,F,100,6,0,6
Trulie,F,100,6,0,6
Tsosie,M,100,0,6,6
Tullia,F,100,6,0,6
Tupou,F,100,6,0,6
Turkesa,F,100,6,0,6
Turon,M,100,0,6,6
Twanette,F,100,6,0,6
Tyah,F,100,6,0,6
Tyahna,F,100,6,0,6
Tyair,M,100,0,6,6
Tydrick,M,100,0,6,6
Tyelise,F,100,6,0,6
Tyerell,M,100,0,6,6
Tyge,M,100,0,6,6
Tyi,M,100,0,6,6
Tyjanay,F,100,6,0,6
Tykiria,F,100,6,0,6
Tymeshia,F,100,6,0,6
Tyneesha,F,100,6,0,6
Tynesia,F,100,6,0,6
Tynise,F,100,6,0,6
Tynsley,F,100,6,0,6
Tyquasha,F,100,6,0,6
Tyrael,M,100,0,6,6
Tyreana,F,100,6,0,6
Tyreanna,F,100,6,0,6
Tyrena,F,100,6,0,6
Tyreq,M,100,0,6,6
Tyshauna,F,100,6,0,6
Tyshera,F,100,6,0,6
Tysir,M,100,0,6,6
Tysun,M,100,0,6,6
Tzivi,F,100,6,0,6
Uchechi,F,100,6,0,6
Ulisa,F,100,6,0,6
Ulisis,M,100,0,6,6
Ulrike,F,100,6,0,6
Umaira,F,100,6,0,6
Umeki,F,100,6,0,6
Unica,F,100,6,0,6
Ustin,M,100,0,6,6
Vaelyn,F,100,6,0,6
Vahid,M,100,0,6,6
Vaiden,M,100,0,6,6
Valicity,F,100,6,0,6
Valle,F,100,6,0,6
Valree,F,100,6,0,6
Vanaya,F,100,6,0,6
Vanelope,F,100,6,0,6
Vaneshia,F,100,6,0,6
Vanilla,F,100,6,0,6
Vannya,F,100,6,0,6
Vantrell,M,100,0,6,6
Varad,M,100,0,6,6
Varetta,F,100,6,0,6
Varish,M,100,0,6,6
Varney,M,100,0,6,6
Vashonda,F,100,6,0,6
Vassilios,M,100,0,6,6
Vasthi,F,100,6,0,6
Vatche,M,100,0,6,6
Vedaant,M,100,0,6,6
Vedat,M,100,0,6,6
Velna,F,100,6,0,6
Velora,F,100,6,0,6
Venellope,F,100,6,0,6
Veniamin,M,100,0,6,6
Venida,F,100,6,0,6
Veniece,F,100,6,0,6
Vennessa,F,100,6,0,6
Verdene,F,100,6,0,6
Vergia,F,100,6,0,6
Vernestine,F,100,6,0,6
Vernett,F,100,6,0,6
Vernika,F,100,6,0,6
Vernonica,F,100,6,0,6
Vertina,F,100,6,0,6
Vesenia,F,100,6,0,6
Veto,M,100,0,6,6
Victoire,F,100,6,0,6
Vidula,F,100,6,0,6
Vidyut,M,100,0,6,6
Vihaa,F,100,6,0,6
Vihaanreddy,M,100,0,6,6
Vihas,M,100,0,6,6
Vikie,F,100,6,0,6
Vincentmichael,M,100,0,6,6
Vinesha,F,100,6,0,6
Vinzent,M,100,0,6,6
Viral,M,100,0,6,6
Virginio,M,100,0,6,6
Virjinia,F,100,6,0,6
Virl,M,100,0,6,6
Vishak,M,100,0,6,6
Vividiana,F,100,6,0,6
Vivyana,F,100,6,0,6
Vonne,F,100,6,0,6
Vontella,F,100,6,0,6
Vuthy,M,100,0,6,6
Vyaan,M,100,0,6,6
Vyanna,F,100,6,0,6
Vylet,F,100,6,0,6
Vyolette,F,100,6,0,6
Vyvian,F,100,6,0,6
Wajiha,F,100,6,0,6
Wakia,F,100,6,0,6
Wakinyan,M,100,0,6,6
Wala,F,100,6,0,6
Walda,F,100,6,0,6
Walisha,F,100,6,0,6
Wandell,M,100,0,6,6
Wane,M,100,0,6,6
Wayneshia,F,100,6,0,6
Waynisha,F,100,6,0,6
Weiland,M,100,0,6,6
Wensley,M,100,0,6,6
Wilbern,M,100,0,6,6
Wilbon,M,100,0,6,6
Wilhemena,F,100,6,0,6
Willeen,F,100,6,0,6
Williamson,M,100,0,6,6
Willisa,F,100,6,0,6
Winchester,M,100,0,6,6
Winny,F,100,6,0,6
Winslet,F,100,6,0,6
Wojciech,M,100,0,6,6
Woodard,M,100,0,6,6
Woodfin,M,100,0,6,6
Worthy,M,100,0,6,6
Wrett,M,100,0,6,6
Wryder,M,100,0,6,6
Wulfric,M,100,0,6,6
Wyette,M,100,0,6,6
Wyndsor,F,100,6,0,6
Wynee,F,100,6,0,6
Wynelle,F,100,6,0,6
Wynema,F,100,6,0,6
Xadyn,M,100,0,6,6
Xael,M,100,0,6,6
Xana,F,100,6,0,6
Xaniya,F,100,6,0,6
Xayne,M,100,0,6,6
Xi,F,100,6,0,6
Xienna,F,100,6,0,6
Xinran,F,100,6,0,6
Xinyu,F,100,6,0,6
Xyliah,F,100,6,0,6
Xymena,F,100,6,0,6
Xzandria,F,100,6,0,6
Xzayvian,M,100,0,6,6
Yadirah,F,100,6,0,6
Yadon,M,100,0,6,6
Yaelin,F,100,6,0,6
Yahdira,F,100,6,0,6
Yaicha,F,100,6,0,6
Yakia,F,100,6,0,6
Yaleiza,F,100,6,0,6
Yalissa,F,100,6,0,6
Yamely,F,100,6,0,6
Yamillet,F,100,6,0,6
Yance,M,100,0,6,6
Yanelys,F,100,6,0,6
Yaniece,F,100,6,0,6
Yanil,F,100,6,0,6
Yanisha,F,100,6,0,6
Yanissa,F,100,6,0,6
Yanixan,M,100,0,6,6
Yaqoob,M,100,0,6,6
Yaresly,F,100,6,0,6
Yarianny,F,100,6,0,6
Yaribel,F,100,6,0,6
Yariely,F,100,6,0,6
Yasaira,F,100,6,0,6
Yaschica,F,100,6,0,6
Yashaswini,F,100,6,0,6
Yasheca,F,100,6,0,6
Yasheika,F,100,6,0,6
Yashi,F,100,6,0,6
Yasina,F,100,6,0,6
Yasmean,F,100,6,0,6
Yassiel,M,100,0,6,6
Yathziri,F,100,6,0,6
Yavonda,F,100,6,0,6
Yaxiry,F,100,6,0,6
Yecica,F,100,6,0,6
Yediel,M,100,0,6,6
Yeili,F,100,6,0,6
Yeiri,F,100,6,0,6
Yejun,M,100,0,6,6
Yenna,F,100,6,0,6
Yensi,F,100,6,0,6
Yensy,F,100,6,0,6
Yeritza,F,100,6,0,6
Yesania,F,100,6,0,6
Yesenio,F,100,6,0,6
Yesmeen,F,100,6,0,6
Yessi,F,100,6,0,6
Yexalen,F,100,6,0,6
Yhoalibeth,F,100,6,0,6
Yianna,F,100,6,0,6
Yilia,F,100,6,0,6
Yilin,F,100,6,0,6
Yinuo,M,100,0,6,6
Yiyi,F,100,6,0,6
Ylanda,F,100,6,0,6
Yocasta,F,100,6,0,6
Yochanon,M,100,0,6,6
Yohandry,M,100,0,6,6
Yohel,M,100,0,6,6
Yolani,F,100,6,0,6
Yomayra,F,100,6,0,6
Yonaton,M,100,0,6,6
Yonic,M,100,0,6,6
Yonina,F,100,6,0,6
Yonny,M,100,0,6,6
Yori,F,100,6,0,6
Yorleni,F,100,6,0,6
Yosbel,M,100,0,6,6
Yosif,M,100,0,6,6
Yosvani,M,100,0,6,6
Youcef,M,100,0,6,6
Younique,F,100,6,0,6
Younus,M,100,0,6,6
Youssif,M,100,0,6,6
Ysatis,F,100,6,0,6
Yuda,M,100,0,6,6
Yuko,F,100,6,0,6
Yulexi,F,100,6,0,6
Yusei,M,100,0,6,6
Yuva,M,100,0,6,6
Yuvansh,M,100,0,6,6
Yvelisse,F,100,6,0,6
Yvens,M,100,0,6,6
Yvianna,F,100,6,0,6
Yzamar,F,100,6,0,6
Zabdy,F,100,6,0,6
Zabryna,F,100,6,0,6
Zackie,M,100,0,6,6
Zadan,M,100,0,6,6
Zadee,F,100,6,0,6
Zaen,M,100,0,6,6
Zahia,F,100,6,0,6
Zahyir,M,100,0,6,6
Zainaldeen,M,100,0,6,6
Zairy,F,100,6,0,6
Zakarah,F,100,6,0,6
Zakaree,M,100,0,6,6
Zakarias,M,100,0,6,6
Zakera,F,100,6,0,6
Zakria,M,100,0,6,6
Zaleyah,F,100,6,0,6
Zalon,M,100,0,6,6
Zam,M,100,0,6,6
Zamera,F,100,6,0,6
Zamonte,M,100,0,6,6
Zamyriah,F,100,6,0,6
Zanay,F,100,6,0,6
Zandaya,F,100,6,0,6
Zanilah,F,100,6,0,6
Zaphira,F,100,6,0,6
Zarien,M,100,0,6,6
Zarihya,F,100,6,0,6
Zarrius,M,100,0,6,6
Zarriyah,F,100,6,0,6
Zavanna,F,100,6,0,6
Zavhary,M,100,0,6,6
Zaviyar,M,100,0,6,6
Zaylaa,F,100,6,0,6
Zaylei,F,100,6,0,6
Zaylor,M,100,0,6,6
Zeana,F,100,6,0,6
Zef,M,100,0,6,6
Zeik,M,100,0,6,6
Zeljko,M,100,0,6,6
Zema,F,100,6,0,6
Zenae,F,100,6,0,6
Zenola,F,100,6,0,6
Zeon,M,100,0,6,6
Zereon,M,100,0,6,6
Zerrion,M,100,0,6,6
Zhakira,F,100,6,0,6
Zhari,F,100,6,0,6
Zhariya,F,100,6,0,6
Zhen,M,100,0,6,6
Ziaira,F,100,6,0,6
Ziannah,F,100,6,0,6
Zianne,F,100,6,0,6
Ziere,M,100,0,6,6
Zilphia,F,100,6,0,6
Zinda,F,100,6,0,6
Zionnah,F,100,6,0,6
Zirel,F,100,6,0,6
Zitlally,F,100,6,0,6
Zoeh,F,100,6,0,6
Zoeii,F,100,6,0,6
Zoel,M,100,0,6,6
Zoeylynn,F,100,6,0,6
Zolah,F,100,6,0,6
Zolie,F,100,6,0,6
Zolton,M,100,0,6,6
Zowii,F,100,6,0,6
Zriyah,F,100,6,0,6
Zsolt,M,100,0,6,6
Zubeyr,M,100,0,6,6
Zuleidy,F,100,6,0,6
Zulimar,F,100,6,0,6
Zuriana,F,100,6,0,6
Zuriela,F,100,6,0,6
Zurina,F,100,6,0,6
Zyara,F,100,6,0,6
Zykeira,F,100,6,0,6
Zykell,M,100,0,6,6
Zyking,M,100,0,6,6
Zylis,M,100,0,6,6
Zynovia,F,100,6,0,6
Zyshaun,M,100,0,6,6
Zytavious,M,100,0,6,6
Zyyanna,F,100,6,0,6
Zyyon,M,100,0,6,6
Aabriella,F,100,5,0,5
Aadhavan,M,100,0,5,5
Aadhi,M,100,0,5,5
Aadian,M,100,0,5,5
Aadiv,M,100,0,5,5
Aadrika,F,100,5,0,5
Aaidan,M,100,0,5,5
Aaiza,F,100,5,0,5
Aalexis,F,100,5,0,5
Aaliayh,F,100,5,0,5
Aalimah,F,100,5,0,5
Aaliyaha,F,100,5,0,5
Aamarion,M,100,0,5,5
Aamilah,F,100,5,0,5
Aamoni,F,100,5,0,5
Aamya,F,100,5,0,5
Aanchal,F,100,5,0,5
Aania,F,100,5,0,5
Aaniylah,F,100,5,0,5
Aaqib,M,100,0,5,5
Aarabella,F,100,5,0,5
Aari,M,100,0,5,5
Aarielle,F,100,5,0,5
Aariyan,M,100,0,5,5
Aaroh,M,100,0,5,5
Aarohan,M,100,0,5,5
Aaronjacob,M,100,0,5,5
Aaronjames,M,100,0,5,5
Aaronjoshua,M,100,0,5,5
Aarshi,F,100,5,0,5
Aarvin,M,100,0,5,5
Aaryah,F,100,5,0,5
Aaser,M,100,0,5,5
Aashirya,F,100,5,0,5
Aavi,M,100,0,5,5
Aavya,F,100,5,0,5
Aavyan,M,100,0,5,5
Aayam,M,100,0,5,5
Aayanah,F,100,5,0,5
Aayra,F,100,5,0,5
Aayusha,F,100,5,0,5
Abaan,M,100,0,5,5
Abass,M,100,0,5,5
Abdihakim,M,100,0,5,5
Abdilahi,M,100,0,5,5
Abdisamad,M,100,0,5,5
Abdula,M,100,0,5,5
Abdulhalim,M,100,0,5,5
Abdulhameed,M,100,0,5,5
Abdulmajeed,M,100,0,5,5
Abdulmalek,M,100,0,5,5
Abdulmohsen,M,100,0,5,5
Abdulsalam,M,100,0,5,5
Abdulwadud,M,100,0,5,5
Abdurraheem,M,100,0,5,5
Abedallah,M,100,0,5,5
Abegayle,F,100,5,0,5
Aben,M,100,0,5,5
Aberham,M,100,0,5,5
Abhigna,F,100,5,0,5
Abhilash,M,100,0,5,5
Abhinaya,F,100,5,0,5
Abian,M,100,0,5,5
Abiezer,M,100,0,5,5
Abimbola,M,100,0,5,5
Abinav,M,100,0,5,5
Abinaya,F,100,5,0,5
Abisha,F,100,5,0,5
Abiyah,M,100,0,5,5
Abony,F,100,5,0,5
Abreana,F,100,5,0,5
Abreonna,F,100,5,0,5
Abrianne,F,100,5,0,5
Abrienne,F,100,5,0,5
Abrihet,F,100,5,0,5
Abubakarr,M,100,0,5,5
Abubaker,M,100,0,5,5
Abyssinia,F,100,5,0,5
Achel,F,100,5,0,5
Achsah,F,100,5,0,5
Achyut,M,100,0,5,5
Aciano,M,100,0,5,5
Acy,M,100,0,5,5
Adaija,F,100,5,0,5
Adalinda,F,100,5,0,5
Adalye,F,100,5,0,5
Adamae,F,100,5,0,5
Adamo,M,100,0,5,5
Adaneli,F,100,5,0,5
Adarah,F,100,5,0,5
Adarien,M,100,0,5,5
Adason,F,100,5,0,5
Adavia,F,100,5,0,5
Adavion,M,100,0,5,5
Adaysha,F,100,5,0,5
Adaysia,F,100,5,0,5
Adbiel,M,100,0,5,5
Addelyne,F,100,5,0,5
Adderly,M,100,0,5,5
Addicyn,F,100,5,0,5
Addileigh,F,100,5,0,5
Addiline,F,100,5,0,5
Addington,F,100,5,0,5
Addiston,F,100,5,0,5
Addisun,F,100,5,0,5
Addix,M,100,0,5,5
Addlee,F,100,5,0,5
Addylyn,F,100,5,0,5
Adebayo,M,100,0,5,5
Adebola,M,100,0,5,5
Adein,M,100,0,5,5
Adelah,F,100,5,0,5
Adelaido,M,100,0,5,5
Adelais,F,100,5,0,5
Adelane,F,100,5,0,5
Adeleke,M,100,0,5,5
Adelfo,M,100,0,5,5
Adeli,F,100,5,0,5
Adelinne,F,100,5,0,5
Adelya,F,100,5,0,5
Adeniyi,M,100,0,5,5
Aderonke,F,100,5,0,5
Adeyemi,M,100,0,5,5
Adheesh,M,100,0,5,5
Adhithi,F,100,5,0,5
Adiella,F,100,5,0,5
Adinah,F,100,5,0,5
Adithri,F,100,5,0,5
Adiyah,F,100,5,0,5
Adlemi,F,100,5,0,5
Adnaan,M,100,0,5,5
Adoniram,M,100,0,5,5
Adonys,M,100,0,5,5
Adran,M,100,0,5,5
Adrein,M,100,0,5,5
Adreyan,M,100,0,5,5
Adrial,M,100,0,5,5
Adrianny,F,100,5,0,5
Adriela,F,100,5,0,5
Adrinna,F,100,5,0,5
Adrita,F,100,5,0,5
Adry,F,100,5,0,5
Adut,F,100,5,0,5
Advitha,F,100,5,0,5
Adwaith,M,100,0,5,5
Adwitiya,F,100,5,0,5
Adyant,M,100,0,5,5
Adysun,F,100,5,0,5
Adysyn,F,100,5,0,5
Aeddon,M,100,0,5,5
Aeiden,M,100,0,5,5
Aeleen,F,100,5,0,5
Aelisa,F,100,5,0,5
Aeralynn,F,100,5,0,5
Aerick,M,100,0,5,5
Aeryal,F,100,5,0,5
Aeryanna,F,100,5,0,5
Aesa,F,100,5,0,5
Aevah,F,100,5,0,5
Aevin,M,100,0,5,5
Afina,F,100,5,0,5
Afiyah,F,100,5,0,5
Afshin,M,100,0,5,5
Aftin,F,100,5,0,5
Agamjot,M,100,0,5,5
Agathe,F,100,5,0,5
Agness,F,100,5,0,5
Ah,F,100,5,0,5
Ahamed,M,100,0,5,5
Ahisha,F,100,5,0,5
Ahlaysia,F,100,5,0,5
Ahlina,F,100,5,0,5
Ahmara,F,100,5,0,5
Ahmare,M,100,0,5,5
Ahmauri,M,100,0,5,5
Ahmer,M,100,0,5,5
Ahmond,M,100,0,5,5
Ahmyiah,F,100,5,0,5
Ahnah,F,100,5,0,5
Ahnari,F,100,5,0,5
Ahsoka,F,100,5,0,5
Aianna,F,100,5,0,5
Aibhilin,F,100,5,0,5
Aidelyn,F,100,5,0,5
Aidenjoseph,M,100,0,5,5
Aidenmichael,M,100,0,5,5
Aidia,F,100,5,0,5
Ailia,F,100,5,0,5
Ailiana,F,100,5,0,5
Aionna,F,100,5,0,5
Airess,F,100,5,0,5
Airick,M,100,0,5,5
Airielle,F,100,5,0,5
Airin,M,100,0,5,5
Airyona,F,100,5,0,5
Aishlyn,F,100,5,0,5
Aithen,M,100,0,5,5
Aivley,F,100,5,0,5
Aiylah,F,100,5,0,5
Aizeah,M,100,0,5,5
Aizza,F,100,5,0,5
Ajada,F,100,5,0,5
Ajak,M,100,0,5,5
Ajee,F,100,5,0,5
Ajiana,F,100,5,0,5
Ajitesh,M,100,0,5,5
Ajuni,F,100,5,0,5
Akadian,M,100,0,5,5
Akarsh,M,100,0,5,5
Akea,F,100,5,0,5
Akeim,M,100,0,5,5
Akhenaton,M,100,0,5,5
Akiel,M,100,0,5,5
Akif,M,100,0,5,5
Akiles,M,100,0,5,5
Akir,M,100,0,5,5
Akita,F,100,5,0,5
Akshadha,F,100,5,0,5
Akyia,F,100,5,0,5
Alainnah,F,100,5,0,5
Alaire,F,100,5,0,5
Alajha,F,100,5,0,5
Alajhia,F,100,5,0,5
Alaki,M,100,0,5,5
Alalah,F,100,5,0,5
Alanson,M,100,0,5,5
Alarie,F,100,5,0,5
Alaris,F,100,5,0,5
Alassane,M,100,0,5,5
Alaunah,F,100,5,0,5
Alax,M,100,0,5,5
Alaythia,F,100,5,0,5
Alayzah,F,100,5,0,5
Albana,F,100,5,0,5
Alber,M,100,0,5,5
Alberteen,F,100,5,0,5
Albesa,F,100,5,0,5
Albree,F,100,5,0,5
Alchemy,F,100,5,0,5
Alcus,M,100,0,5,5
Aldana,F,100,5,0,5
Aldemar,M,100,0,5,5
Aleahya,F,100,5,0,5
Aleara,F,100,5,0,5
Aleasa,F,100,5,0,5
Aleathea,F,100,5,0,5
Alece,F,100,5,0,5
Aleecya,F,100,5,0,5
Aleera,F,100,5,0,5
Aleezah,F,100,5,0,5
Alegacy,F,100,5,0,5
Alegna,F,100,5,0,5
Aleighanna,F,100,5,0,5
Aleighia,F,100,5,0,5
Aleighsha,F,100,5,0,5
Aleiha,F,100,5,0,5
Aleila,F,100,5,0,5
Aleira,F,100,5,0,5
Aleiza,F,100,5,0,5
Alelia,F,100,5,0,5
Alely,F,100,5,0,5
Alenka,F,100,5,0,5
Alescia,F,100,5,0,5
Alesiram,F,100,5,0,5
Alessi,F,100,5,0,5
Alevia,F,100,5,0,5
Alexana,F,100,5,0,5
Alexaundra,F,100,5,0,5
Alexender,M,100,0,5,5
Alexeus,F,100,5,0,5
Alexiel,F,100,5,0,5
Alexjandro,M,100,0,5,5
Alexondria,F,100,5,0,5
Alexxandria,F,100,5,0,5
Alexyanna,F,100,5,0,5
Aley,F,100,5,0,5
Aleydis,F,100,5,0,5
Aleyha,F,100,5,0,5
Alezandria,F,100,5,0,5
Alezay,F,100,5,0,5
Alfonsa,M,100,0,5,5
Alfonzia,M,100,0,5,5
Alfrida,F,100,5,0,5
Algeria,F,100,5,0,5
Alhakim,M,100,0,5,5
Alhanouf,F,100,5,0,5
Alheli,F,100,5,0,5
Aliandra,F,100,5,0,5
Alick,M,100,0,5,5
Alienna,F,100,5,0,5
Alieshia,F,100,5,0,5
Alijandra,F,100,5,0,5
Alilyana,F,100,5,0,5
Alishah,F,100,5,0,5
Alisya,F,100,5,0,5
Aliva,F,100,5,0,5
Aliveya,F,100,5,0,5
Alivyah,F,100,5,0,5
Alixa,F,100,5,0,5
Alizandra,F,100,5,0,5
Alizaye,F,100,5,0,5
Allaire,F,100,5,0,5
Allaya,F,100,5,0,5
Allaynah,F,100,5,0,5
Allayne,F,100,5,0,5
Allenah,F,100,5,0,5
Alleria,F,100,5,0,5
Allesia,F,100,5,0,5
Alleson,F,100,5,0,5
Allice,F,100,5,0,5
Allijah,M,100,0,5,5
Allisan,F,100,5,0,5
Allishia,F,100,5,0,5
Allory,F,100,5,0,5
Allya,F,100,5,0,5
Allynn,F,100,5,0,5
Almalik,M,100,0,5,5
Almanda,F,100,5,0,5
Almonza,M,100,0,5,5
Almyra,F,100,5,0,5
Alnita,F,100,5,0,5
Alohi,F,100,5,0,5
Alondre,M,100,0,5,5
Alpa,F,100,5,0,5
Alphonce,M,100,0,5,5
Alray,M,100,0,5,5
Alshon,M,100,0,5,5
Altavious,M,100,0,5,5
Althia,F,100,5,0,5
Altina,F,100,5,0,5
Altonia,F,100,5,0,5
Altouise,F,100,5,0,5
Altus,M,100,0,5,5
Alula,M,100,0,5,5
Alvar,M,100,0,5,5
Alven,M,100,0,5,5
Alver,M,100,0,5,5
Alverda,F,100,5,0,5
Alvertis,M,100,0,5,5
Alvy,M,100,0,5,5
Alvyn,M,100,0,5,5
Alycen,F,100,5,0,5
Alyea,F,100,5,0,5
Alyese,F,100,5,0,5
Alyeska,F,100,5,0,5
Alyiana,F,100,5,0,5
Alyis,M,100,0,5,5
Alyisa,F,100,5,0,5
Alyk,M,100,0,5,5
Alymuhammad,M,100,0,5,5
Alysabeth,F,100,5,0,5
Alyssaann,F,100,5,0,5
Alyxa,F,100,5,0,5
Alyxzander,M,100,0,5,5
Amahd,M,100,0,5,5
Amai,F,100,5,0,5
Amais,M,100,0,5,5
Amaj,M,100,0,5,5
Amalea,F,100,5,0,5
Amaleah,F,100,5,0,5
Amanat,F,100,5,0,5
Amandalyn,F,100,5,0,5
Amande,F,100,5,0,5
Amandine,F,100,5,0,5
Amandy,F,100,5,0,5
Amane,F,100,5,0,5
Amarae,F,100,5,0,5
Amaranta,F,100,5,0,5
Amarhi,F,100,5,0,5
Amarillis,F,100,5,0,5
Amarious,M,100,0,5,5
Amariss,F,100,5,0,5
Amariyon,M,100,0,5,5
Amarre,M,100,0,5,5
Amaryss,F,100,5,0,5
Amaure,M,100,0,5,5
Amaurion,M,100,0,5,5
Amaylee,F,100,5,0,5
Ambera,F,100,5,0,5
Amberia,F,100,5,0,5
Ambermarie,F,100,5,0,5
Ambrey,F,100,5,0,5
Ambriana,F,100,5,0,5
Amedee,M,100,0,5,5
Ameelia,F,100,5,0,5
Amelah,F,100,5,0,5
Ameleah,F,100,5,0,5
Ameliagrace,F,100,5,0,5
Amelle,F,100,5,0,5
Amerra,F,100,5,0,5
Amerson,M,100,0,5,5
Ametria,F,100,5,0,5
Ameyaa,F,100,5,0,5
Amiia,F,100,5,0,5
Amilliona,F,100,5,0,5
Amilyn,F,100,5,0,5
Amirea,F,100,5,0,5
Amiyha,F,100,5,0,5
Ammaarah,F,100,5,0,5
Ammer,M,100,0,5,5
Amneh,F,100,5,0,5
Amner,M,100,0,5,5
Amonti,M,100,0,5,5
Amoreena,F,100,5,0,5
Amorina,F,100,5,0,5
Amouri,M,100,0,5,5
Amoy,F,100,5,0,5
Amriel,F,100,5,0,5
Amsey,F,100,5,0,5
Amsi,F,100,5,0,5
Amukta,F,100,5,0,5
Amyha,F,100,5,0,5
Amzee,F,100,5,0,5
Amzi,F,100,5,0,5
Anaceli,F,100,5,0,5
Anacleto,M,100,0,5,5
Anadia,F,100,5,0,5
Anaelisa,F,100,5,0,5
Anahly,F,100,5,0,5
Anaiis,F,100,5,0,5
Anaili,F,100,5,0,5
Analey,F,100,5,0,5
Analeyah,F,100,5,0,5
Analice,F,100,5,0,5
Analily,F,100,5,0,5
Analize,F,100,5,0,5
Analu,M,100,0,5,5
Analyce,F,100,5,0,5
Analysse,F,100,5,0,5
Analyssia,F,100,5,0,5
Anamar,F,100,5,0,5
Anamia,F,100,5,0,5
Anashe,F,100,5,0,5
Anastasya,F,100,5,0,5
Anastaysia,F,100,5,0,5
Anatasia,F,100,5,0,5
Anathea,F,100,5,0,5
Anavaeh,F,100,5,0,5
Anavay,F,100,5,0,5
Anaveah,F,100,5,0,5
Anayansi,F,100,5,0,5
Anayis,F,100,5,0,5
Anber,F,100,5,0,5
Anbria,F,100,5,0,5
Anchal,F,100,5,0,5
Andalasia,F,100,5,0,5
Anderw,M,100,0,5,5
Anderzon,M,100,0,5,5
Andis,M,100,0,5,5
Andonia,F,100,5,0,5
Andora,F,100,5,0,5
Andralyn,F,100,5,0,5
Andreaz,M,100,0,5,5
Andreis,M,100,0,5,5
Andreita,F,100,5,0,5
Andrene,F,100,5,0,5
Andreous,M,100,0,5,5
Andrewjoseph,M,100,0,5,5
Andricka,F,100,5,0,5
Andriette,F,100,5,0,5
Andrika,F,100,5,0,5
Andro,M,100,0,5,5
Andrw,M,100,0,5,5
Anea,F,100,5,0,5
Aneel,M,100,0,5,5
Aneeza,F,100,5,0,5
Aneida,F,100,5,0,5
Aneissa,F,100,5,0,5
Anell,F,100,5,0,5
Aner,M,100,0,5,5
Aneres,F,100,5,0,5
Anes,M,100,0,5,5
Anesti,F,100,5,0,5
Anesty,F,100,5,0,5
Anet,F,100,5,0,5
Aneudi,M,100,0,5,5
Aneysha,F,100,5,0,5
Anezka,F,100,5,0,5
Anferney,M,100,0,5,5
Angelah,F,100,5,0,5
Angelann,F,100,5,0,5
Angeleigh,F,100,5,0,5
Angelinah,F,100,5,0,5
Angelissa,F,100,5,0,5
Angelmiguel,M,100,0,5,5
Angelou,M,100,0,5,5
Angenetta,F,100,5,0,5
Angil,F,100,5,0,5
Angleica,F,100,5,0,5
Angler,M,100,0,5,5
Angles,F,100,5,0,5
Angyl,F,100,5,0,5
Anhtony,M,100,0,5,5
Aniaha,F,100,5,0,5
Anielka,F,100,5,0,5
Aniesha,F,100,5,0,5
Aniessa,F,100,5,0,5
Anieyah,F,100,5,0,5
Anikan,M,100,0,5,5
Anilya,F,100,5,0,5
Anirud,M,100,0,5,5
Aniruddha,M,100,0,5,5
Anirvin,M,100,0,5,5
Anishia,F,100,5,0,5
Anisley,F,100,5,0,5
Anistasia,F,100,5,0,5
Anite,F,100,5,0,5
Aniye,F,100,5,0,5
Aniysa,F,100,5,0,5
Anjay,M,100,0,5,5
Anji,F,100,5,0,5
Anjonette,F,100,5,0,5
Anker,M,100,0,5,5
Anlin,F,100,5,0,5
Anly,F,100,5,0,5
Annaalicia,F,100,5,0,5
Annabela,F,100,5,0,5
Annabellah,F,100,5,0,5
Annagail,F,100,5,0,5
Annahbella,F,100,5,0,5
Annajoy,F,100,5,0,5
Annakay,F,100,5,0,5
Annalaura,F,100,5,0,5
Annalaya,F,100,5,0,5
Annaleya,F,100,5,0,5
Annaluiza,F,100,5,0,5
Annalyssia,F,100,5,0,5
Annan,M,100,0,5,5
Annanicole,F,100,5,0,5
Annavictoria,F,100,5,0,5
Annelisse,F,100,5,0,5
Anneliz,F,100,5,0,5
Annelizabeth,F,100,5,0,5
Annelouise,F,100,5,0,5
Annelyn,F,100,5,0,5
Annesa,F,100,5,0,5
Annesley,F,100,5,0,5
Annete,F,100,5,0,5
Annettie,F,100,5,0,5
Annibella,F,100,5,0,5
Annslie,F,100,5,0,5
Annyka,F,100,5,0,5
Anooj,M,100,0,5,5
Anova,F,100,5,0,5
Anquenette,F,100,5,0,5
Anquinetta,F,100,5,0,5
Anri,M,100,0,5,5
Ansa,F,100,5,0,5
Ansar,M,100,0,5,5
Ansara,M,100,0,5,5
Antaeus,M,100,0,5,5
Antanesha,F,100,5,0,5
Antaniya,F,100,5,0,5
Antaysia,F,100,5,0,5
Antha,F,100,5,0,5
Anthonella,F,100,5,0,5
Anthonique,F,100,5,0,5
Anthonyjohn,M,100,0,5,5
Anthoy,M,100,0,5,5
Antiana,F,100,5,0,5
Antionett,F,100,5,0,5
Antoinio,M,100,0,5,5
Antoinnette,F,100,5,0,5
Antoneo,M,100,0,5,5
Antonica,F,100,5,0,5
Antonieo,M,100,0,5,5
Antonis,M,100,0,5,5
Antonnio,M,100,0,5,5
Antranette,F,100,5,0,5
Antravion,M,100,0,5,5
Antrez,M,100,0,5,5
Antronette,F,100,5,0,5
Antuwan,M,100,0,5,5
Antwanett,F,100,5,0,5
Antwanique,F,100,5,0,5
Antwayne,M,100,0,5,5
Antwian,M,100,0,5,5
Antwyne,M,100,0,5,5
Anudeep,M,100,0,5,5
Anujin,F,100,5,0,5
Anuoluwa,F,100,5,0,5
Anupriya,F,100,5,0,5
Anuva,F,100,5,0,5
Anvesha,F,100,5,0,5
Anycia,F,100,5,0,5
Anyea,F,100,5,0,5
Anyelo,M,100,0,5,5
Anyhia,F,100,5,0,5
Anyila,F,100,5,0,5
Anyjah,F,100,5,0,5
Anyka,F,100,5,0,5
Anyria,F,100,5,0,5
Anza,F,100,5,0,5
Anzlie,F,100,5,0,5
Aoibheann,F,100,5,0,5
Aous,M,100,0,5,5
Aphton,F,100,5,0,5
Apsara,F,100,5,0,5
Aquan,M,100,0,5,5
Aquasia,F,100,5,0,5
Aquavia,F,100,5,0,5
Aquetzalli,F,100,5,0,5
Aquileo,M,100,0,5,5
Aquinas,M,100,0,5,5
Aracel,F,100,5,0,5
Aracellie,F,100,5,0,5
Araelynn,F,100,5,0,5
Aragorn,M,100,0,5,5
Araia,F,100,5,0,5
Araly,F,100,5,0,5
Aralynne,F,100,5,0,5
Arame,F,100,5,0,5
Aranxa,F,100,5,0,5
Arathi,F,100,5,0,5
Aravis,F,100,5,0,5
Arayia,F,100,5,0,5
Arbutus,F,100,5,0,5
Arcangelo,M,100,0,5,5
Arcel,M,100,0,5,5
Arcola,F,100,5,0,5
Ardean,F,100,5,0,5
Ardel,F,100,5,0,5
Ardia,F,100,5,0,5
Ardine,F,100,5,0,5
Ardys,F,100,5,0,5
Aree,M,100,0,5,5
Areeya,F,100,5,0,5
Areial,F,100,5,0,5
Areigha,F,100,5,0,5
Arelene,F,100,5,0,5
Areliz,F,100,5,0,5
Aresha,F,100,5,0,5
Arethea,F,100,5,0,5
Argelis,M,100,0,5,5
Argenys,M,100,0,5,5
Ariaan,M,100,0,5,5
Ariadnne,F,100,5,0,5
Arialle,F,100,5,0,5
Arianamarie,F,100,5,0,5
Arianis,F,100,5,0,5
Arib,M,100,0,5,5
Aribeth,F,100,5,0,5
Arieta,F,100,5,0,5
Arifa,F,100,5,0,5
Arii,F,100,5,0,5
Ariiana,F,100,5,0,5
Aril,F,100,5,0,5
Arinjay,M,100,0,5,5
Arinn,F,100,5,0,5
Arionah,F,100,5,0,5
Arisela,F,100,5,0,5
Arison,M,100,0,5,5
Aristede,M,100,0,5,5
Aristotelis,M,100,0,5,5
Arit,F,100,5,0,5
Aritha,F,100,5,0,5
Ariyani,F,100,5,0,5
Arkeisha,F,100,5,0,5
Arkeshia,F,100,5,0,5
Arlenys,F,100,5,0,5
Arlesia,F,100,5,0,5
Arlethea,F,100,5,0,5
Arliana,F,100,5,0,5
Arlice,F,100,5,0,5
Arlynne,F,100,5,0,5
Arlyss,F,100,5,0,5
Armanti,M,100,0,5,5
Armenda,F,100,5,0,5
Armesha,F,100,5,0,5
Armiah,F,100,5,0,5
Armine,F,100,5,0,5
Armonni,F,100,5,0,5
Armonnie,F,100,5,0,5
Arnardo,M,100,0,5,5
Arnella,F,100,5,0,5
Arnes,M,100,0,5,5
Arnesia,F,100,5,0,5
Arnetra,F,100,5,0,5
Arnica,F,100,5,0,5
Arniesha,F,100,5,0,5
Arnissa,F,100,5,0,5
Arrah,F,100,5,0,5
Arriannah,F,100,5,0,5
Arrihanna,F,100,5,0,5
Arrika,F,100,5,0,5
Arriona,F,100,5,0,5
Arrius,M,100,0,5,5
Arsene,M,100,0,5,5
Arsenia,F,100,5,0,5
Artavion,M,100,0,5,5
Artavis,M,100,0,5,5
Artemas,M,100,0,5,5
Artemisa,F,100,5,0,5
Arteria,F,100,5,0,5
Arthea,F,100,5,0,5
Artia,F,100,5,0,5
Artishia,F,100,5,0,5
Arvi,F,100,5,0,5
Aryane,F,100,5,0,5
Aryauna,F,100,5,0,5
Aryela,F,100,5,0,5
Aryk,M,100,0,5,5
Arynne,F,100,5,0,5
Arys,F,100,5,0,5
Asal,F,100,5,0,5
Asana,F,100,5,0,5
Asaya,M,100,0,5,5
Aschley,F,100,5,0,5
Aseda,M,100,0,5,5
Aseem,M,100,0,5,5
Aset,F,100,5,0,5
Ashaad,M,100,0,5,5
Ashae,F,100,5,0,5
Ashantie,F,100,5,0,5
Ashauna,F,100,5,0,5
Ashi,F,100,5,0,5
Ashla,F,100,5,0,5
Ashleh,F,100,5,0,5
Ashleyanne,F,100,5,0,5
Ashleykate,F,100,5,0,5
Ashston,M,100,0,5,5
Ashunta,F,100,5,0,5
Ashvath,M,100,0,5,5
Ashvi,F,100,5,0,5
Asialynn,F,100,5,0,5
Asmir,M,100,0,5,5
Asna,F,100,5,0,5
Asonte,M,100,0,5,5
Assan,M,100,0,5,5
Asser,M,100,0,5,5
Astara,F,100,5,0,5
Asten,M,100,0,5,5
Astria,F,100,5,0,5
Asuna,F,100,5,0,5
Atalanta,F,100,5,0,5
Atavion,M,100,0,5,5
Athaniel,M,100,0,5,5
Athenamarie,F,100,5,0,5
Athenea,F,100,5,0,5
Atifa,F,100,5,0,5
Atnhony,M,100,0,5,5
Ato,M,100,0,5,5
Atonya,F,100,5,0,5
Attis,M,100,0,5,5
Atzhiri,F,100,5,0,5
Aubrelle,F,100,5,0,5
Aubreonna,F,100,5,0,5
Aubreyelle,F,100,5,0,5
Aubreyrose,F,100,5,0,5
Aubrieanna,F,100,5,0,5
Audelio,M,100,0,5,5
Audiana,F,100,5,0,5
Audrene,F,100,5,0,5
Audreyonna,F,100,5,0,5
Audrick,M,100,0,5,5
Audriena,F,100,5,0,5
Audrii,F,100,5,0,5
Audrone,F,100,5,0,5
Auja,F,100,5,0,5
Aujane,F,100,5,0,5
Aukeem,M,100,0,5,5
Aulden,M,100,0,5,5
Aunisti,F,100,5,0,5
Aunjel,F,100,5,0,5
Aurbree,F,100,5,0,5
Auree,F,100,5,0,5
Aurik,M,100,0,5,5
Aurin,M,100,0,5,5
Auriona,F,100,5,0,5
Aurore,F,100,5,0,5
Aurra,F,100,5,0,5
Ausitn,M,100,0,5,5
Austreberto,M,100,0,5,5
Austun,M,100,0,5,5
Autrey,M,100,0,5,5
Avae,F,100,5,0,5
Avaelizabeth,F,100,5,0,5
Avali,F,100,5,0,5
Avalie,F,100,5,0,5
Avalyne,F,100,5,0,5
Avanah,F,100,5,0,5
Avanell,F,100,5,0,5
Avasophia,F,100,5,0,5
Aveanna,F,100,5,0,5
Aveda,F,100,5,0,5
Aveigha,F,100,5,0,5
Avelie,F,100,5,0,5
Avellina,F,100,5,0,5
Avenlea,F,100,5,0,5
Avenley,F,100,5,0,5
Aveonna,F,100,5,0,5
Averionna,F,100,5,0,5
Averymarie,F,100,5,0,5
Avilee,F,100,5,0,5
Avona,F,100,5,0,5
Avondre,M,100,0,5,5
Avori,F,100,5,0,5
Avraj,M,100,0,5,5
Avrora,F,100,5,0,5
Awbree,F,100,5,0,5
Awbrey,F,100,5,0,5
Aweys,M,100,0,5,5
Awna,F,100,5,0,5
Axcell,M,100,0,5,5
Axiry,F,100,5,0,5
Axtin,M,100,0,5,5
Axwell,M,100,0,5,5
Ayak,F,100,5,0,5
Ayania,F,100,5,0,5
Ayauna,F,100,5,0,5
Ayedan,M,100,0,5,5
Ayedin,M,100,0,5,5
Ayeesha,F,100,5,0,5
Ayeh,F,100,5,0,5
Ayele,M,100,0,5,5
Ayhem,M,100,0,5,5
Ayin,F,100,5,0,5
Ayira,F,100,5,0,5
Ayishah,F,100,5,0,5
Aylamae,F,100,5,0,5
Aylanna,F,100,5,0,5
Ayleena,F,100,5,0,5
Aylia,F,100,5,0,5
Aylinne,F,100,5,0,5
Ayobami,M,100,0,5,5
Ayon,M,100,0,5,5
Ayreona,F,100,5,0,5
Ayreonna,F,100,5,0,5
Ayres,M,100,0,5,5
Ayria,F,100,5,0,5
Ayriah,F,100,5,0,5
Ayrian,F,100,5,0,5
Ayric,M,100,0,5,5
Ayshah,F,100,5,0,5
Ayslyn,F,100,5,0,5
Ayten,F,100,5,0,5
Ayzen,M,100,0,5,5
Ayzlyn,F,100,5,0,5
Azailya,F,100,5,0,5
Azaniah,F,100,5,0,5
Azarael,M,100,0,5,5
Azarea,F,100,5,0,5
Azarel,M,100,0,5,5
Azareya,F,100,5,0,5
Azariea,F,100,5,0,5
Azarya,M,100,0,5,5
Azaryia,F,100,5,0,5
Azayleah,F,100,5,0,5
Azealia,F,100,5,0,5
Azelea,F,100,5,0,5
Azelle,F,100,5,0,5
Azelya,F,100,5,0,5
Azha,F,100,5,0,5
Azhia,F,100,5,0,5
Azianna,F,100,5,0,5
Azilyn,F,100,5,0,5
Azira,F,100,5,0,5
Azjah,F,100,5,0,5
Azlin,F,100,5,0,5
Azlynne,F,100,5,0,5
Azmeer,M,100,0,5,5
Azmi,M,100,0,5,5
Azora,F,100,5,0,5
Azriah,F,100,5,0,5
Azurah,F,100,5,0,5
Azury,F,100,5,0,5
Azyon,M,100,0,5,5
Azyrah,F,100,5,0,5
Baboucarr,M,100,0,5,5
Badia,F,100,5,0,5
Baela,F,100,5,0,5
Baeley,F,100,5,0,5
Baha,M,100,0,5,5
Bahia,F,100,5,0,5
Bahja,F,100,5,0,5
Bai,F,100,5,0,5
Bailiegh,F,100,5,0,5
Baille,F,100,5,0,5
Baisley,F,100,5,0,5
Baja,F,100,5,0,5
Balaji,M,100,0,5,5
Balee,F,100,5,0,5
Balie,F,100,5,0,5
Balke,M,100,0,5,5
Balvina,F,100,5,0,5
Bandon,M,100,0,5,5
Bangaly,M,100,0,5,5
Bania,F,100,5,0,5
Banna,F,100,5,0,5
Banning,M,100,0,5,5
Bar,F,100,5,0,5
Bara,M,100,0,5,5
Barbarette,F,100,5,0,5
Barbe,F,100,5,0,5
Bardo,M,100,0,5,5
Bareerah,F,100,5,0,5
Baris,M,100,0,5,5
Barisha,F,100,5,0,5
Barndon,M,100,0,5,5
Barren,M,100,0,5,5
Barrick,M,100,0,5,5
Bartholome,M,100,0,5,5
Bartolome,M,100,0,5,5
Bartolomeo,M,100,0,5,5
Bartu,M,100,0,5,5
Baruc,M,100,0,5,5
Bash,M,100,0,5,5
Bassil,M,100,0,5,5
Bassirou,M,100,0,5,5
Batuhan,M,100,0,5,5
Bazil,M,100,0,5,5
Beaonca,F,100,5,0,5
Beate,F,100,5,0,5
Beather,F,100,5,0,5
Beatrize,F,100,5,0,5
Beebe,F,100,5,0,5
Beeta,F,100,5,0,5
Beighley,F,100,5,0,5
Beila,F,100,5,0,5
Bejan,M,100,0,5,5
Belford,M,100,0,5,5
Believe,F,100,5,0,5
Bellamae,F,100,5,0,5
Bellamay,F,100,5,0,5
Bellani,F,100,5,0,5
Belvie,F,100,5,0,5
Benae,F,100,5,0,5
Bendetta,F,100,5,0,5
Benet,M,100,0,5,5
Benford,M,100,0,5,5
Benitez,M,100,0,5,5
Benner,M,100,0,5,5
Bennjamin,M,100,0,5,5
Bennye,F,100,5,0,5
Benten,M,100,0,5,5
Beola,F,100,5,0,5
Ber,M,100,0,5,5
Beranda,F,100,5,0,5
Berat,M,100,0,5,5
Berdina,F,100,5,0,5
Berdine,F,100,5,0,5
Beri,F,100,5,0,5
Berman,M,100,0,5,5
Bernadean,F,100,5,0,5
Bernadino,M,100,0,5,5
Bernise,F,100,5,0,5
Bernnadette,F,100,5,0,5
Bernon,M,100,0,5,5
Bernt,M,100,0,5,5
Berra,F,100,5,0,5
Bertell,M,100,0,5,5
Bertran,M,100,0,5,5
Besma,F,100,5,0,5
Betanya,F,100,5,0,5
Betha,F,100,5,0,5
Bethan,F,100,5,0,5
Bethellen,F,100,5,0,5
Bethena,F,100,5,0,5
Bethina,F,100,5,0,5
Bethsy,F,100,5,0,5
Bethy,F,100,5,0,5
Betrina,F,100,5,0,5
Betsye,F,100,5,0,5
Bettejane,F,100,5,0,5
Bety,F,100,5,0,5
Betzabel,F,100,5,0,5
Betzayda,F,100,5,0,5
Beula,F,100,5,0,5
Beverli,F,100,5,0,5
Bevyn,F,100,5,0,5
Beyoncee,F,100,5,0,5
Beyunka,F,100,5,0,5
Bhargava,M,100,0,5,5
Bhargavi,F,100,5,0,5
Biatris,F,100,5,0,5
Bibek,M,100,0,5,5
Bibiano,M,100,0,5,5
Bilen,F,100,5,0,5
Billion,M,100,0,5,5
Bin,M,100,0,5,5
Binaca,F,100,5,0,5
Bineta,F,100,5,0,5
Binita,F,100,5,0,5
Bion,M,100,0,5,5
Birder,F,100,5,0,5
Birgitta,F,100,5,0,5
Bisceglia,F,100,5,0,5
Bitia,F,100,5,0,5
Bittany,F,100,5,0,5
Blace,M,100,0,5,5
Blakelie,F,100,5,0,5
Blakesley,F,100,5,0,5
Blass,M,100,0,5,5
Blayk,M,100,0,5,5
Blaz,M,100,0,5,5
Blerim,M,100,0,5,5
Blondine,F,100,5,0,5
Bluford,M,100,0,5,5
Bobbetta,F,100,5,0,5
Bobbiejean,F,100,5,0,5
Bobbilee,F,100,5,0,5
Bobie,F,100,5,0,5
Bobijo,F,100,5,0,5
Bohannon,M,100,0,5,5
Bohen,M,100,0,5,5
Bolden,M,100,0,5,5
Bolivia,F,100,5,0,5
Bolling,M,100,0,5,5
Bonnell,F,100,5,0,5
Bonniejo,F,100,5,0,5
Bonnielee,F,100,5,0,5
Booth,M,100,0,5,5
Borden,M,100,0,5,5
Bostin,M,100,0,5,5
Bowan,M,100,0,5,5
Bowin,M,100,0,5,5
Boykin,M,100,0,5,5
Bozena,F,100,5,0,5
Bracelynn,F,100,5,0,5
Bracyn,M,100,0,5,5
Bradlyn,M,100,0,5,5
Brage,M,100,0,5,5
Brailin,M,100,0,5,5
Brainard,M,100,0,5,5
Bralynne,F,100,5,0,5
Brana,F,100,5,0,5
Brandal,M,100,0,5,5
Brandea,F,100,5,0,5
Brania,F,100,5,0,5
Branko,M,100,0,5,5
Brannick,M,100,0,5,5
Branoon,M,100,0,5,5
Brashawn,M,100,0,5,5
Braston,M,100,0,5,5
Bravon,M,100,0,5,5
Bravyn,M,100,0,5,5
Braxdyn,M,100,0,5,5
Braxtynn,M,100,0,5,5
Brayle,F,100,5,0,5
Brayshaun,M,100,0,5,5
Brayston,M,100,0,5,5
Brayven,M,100,0,5,5
Breannon,F,100,5,0,5
Breara,F,100,5,0,5
Breasha,F,100,5,0,5
Brec,M,100,0,5,5
Breece,F,100,5,0,5
Breezi,F,100,5,0,5
Brehan,F,100,5,0,5
Breiden,M,100,0,5,5
Breigha,F,100,5,0,5
Brelin,M,100,0,5,5
Brendaa,F,100,5,0,5
Brendasia,F,100,5,0,5
Brender,F,100,5,0,5
Brendi,F,100,5,0,5
Brene,F,100,5,0,5
Brentleigh,F,100,5,0,5
Brentwood,M,100,0,5,5
Breonca,F,100,5,0,5
Breonda,F,100,5,0,5
Bretten,M,100,0,5,5
Brettnie,F,100,5,0,5
Brextyn,M,100,0,5,5
Breylee,F,100,5,0,5
Briam,M,100,0,5,5
Brianalee,F,100,5,0,5
Briania,F,100,5,0,5
Briannia,F,100,5,0,5
Briannie,F,100,5,0,5
Briara,F,100,5,0,5
Bricelynn,F,100,5,0,5
Bricola,F,100,5,0,5
Brielee,F,100,5,0,5
Brieon,F,100,5,0,5
Briesha,F,100,5,0,5
Brigden,M,100,0,5,5
Brigdon,M,100,0,5,5
Brij,M,100,0,5,5
Brijida,F,100,5,0,5
Brilei,F,100,5,0,5
Brilynne,F,100,5,0,5
Brindon,M,100,0,5,5
Brinisha,F,100,5,0,5
Brink,M,100,0,5,5
Brinlea,F,100,5,0,5
Brinlyn,F,100,5,0,5
Brisayda,F,100,5,0,5
Brisco,M,100,0,5,5
Briseidy,F,100,5,0,5
Bristin,M,100,0,5,5
Britteni,F,100,5,0,5
Brittlynn,F,100,5,0,5
Brittna,F,100,5,0,5
Brittnany,F,100,5,0,5
Britzy,F,100,5,0,5
Briunna,F,100,5,0,5
Briyelle,F,100,5,0,5
Brizeth,F,100,5,0,5
Brizia,F,100,5,0,5
Brocton,M,100,0,5,5
Bromley,M,100,0,5,5
Bronner,M,100,0,5,5
Bronsyn,M,100,0,5,5
Bronxton,M,100,0,5,5
Brooklan,F,100,5,0,5
Brookleigh,F,100,5,0,5
Brooklynrose,F,100,5,0,5
Brooksley,F,100,5,0,5
Brookyln,F,100,5,0,5
Brttany,F,100,5,0,5
Brunson,M,100,0,5,5
Brycenn,M,100,0,5,5
Brycyn,M,100,0,5,5
Bryell,F,100,5,0,5
Bryian,M,100,0,5,5
Bryin,M,100,0,5,5
Bryken,M,100,0,5,5
Bryne,M,100,0,5,5
Brynia,F,100,5,0,5
Bryniah,F,100,5,0,5
Brynt,M,100,0,5,5
Brysonn,M,100,0,5,5
Brytin,M,100,0,5,5
Brytne,F,100,5,0,5
Bryttnee,F,100,5,0,5
Buckner,M,100,0,5,5
Buena,F,100,5,0,5
Bula,F,100,5,0,5
Bunita,F,100,5,0,5
Burach,M,100,0,5,5
Burlene,F,100,5,0,5
Burlin,M,100,0,5,5
Burna,F,100,5,0,5
Burness,M,100,0,5,5
Buruk,M,100,0,5,5
Busra,F,100,5,0,5
Butterfly,F,100,5,0,5
Buzzy,M,100,0,5,5
Byan,M,100,0,5,5
Byntlee,F,100,5,0,5
Byrdie,F,100,5,0,5
Byson,M,100,0,5,5
Cacie,F,100,5,0,5
Cadhla,F,100,5,0,5
Cadia,F,100,5,0,5
Caed,M,100,0,5,5
Cahterine,F,100,5,0,5
Caidin,M,100,0,5,5
Cailley,F,100,5,0,5
Cailum,M,100,0,5,5
Caiman,M,100,0,5,5
Cairah,F,100,5,0,5
Caite,F,100,5,0,5
Caitilin,F,100,5,0,5
Caitin,F,100,5,0,5
Caitlynd,F,100,5,0,5
Caitria,F,100,5,0,5
Calaeb,M,100,0,5,5
Calasia,F,100,5,0,5
Calden,M,100,0,5,5
Caleel,M,100,0,5,5
Calev,M,100,0,5,5
Calian,M,100,0,5,5
Calieb,M,100,0,5,5
Caliese,F,100,5,0,5
Calimarie,F,100,5,0,5
Calven,M,100,0,5,5
Calvion,M,100,0,5,5
Cama,F,100,5,0,5
Camaree,F,100,5,0,5
Camarii,M,100,0,5,5
Camarri,M,100,0,5,5
Camaury,M,100,0,5,5
Cambra,F,100,5,0,5
Cambriah,F,100,5,0,5
Cambrielle,F,100,5,0,5
Cambron,M,100,0,5,5
Camerson,M,100,0,5,5
Camillemarie,F,100,5,0,5
Camilya,F,100,5,0,5
Campion,M,100,0,5,5
Camreon,M,100,0,5,5
Canan,F,100,5,0,5
Cande,F,100,5,0,5
Candina,F,100,5,0,5
Candler,M,100,0,5,5
Candyse,F,100,5,0,5
Canek,M,100,0,5,5
Canyla,F,100,5,0,5
Cappie,F,100,5,0,5
Capriana,F,100,5,0,5
Caprina,F,100,5,0,5
Carabelle,F,100,5,0,5
Cardel,M,100,0,5,5
Cardella,F,100,5,0,5
Cardero,M,100,0,5,5
Cardine,F,100,5,0,5
Cardiss,F,100,5,0,5
Cardon,M,100,0,5,5
Carell,M,100,0,5,5
Carelle,F,100,5,0,5
Caretta,F,100,5,0,5
Carice,F,100,5,0,5
Cariel,F,100,5,0,5
Carigan,F,100,5,0,5
Cariyah,F,100,5,0,5
Carlan,M,100,0,5,5
Carlaya,F,100,5,0,5
Carleena,F,100,5,0,5
Carlens,M,100,0,5,5
Carlethia,F,100,5,0,5
Carlianna,F,100,5,0,5
Carlise,F,100,5,0,5
Carlitta,F,100,5,0,5
Carlyssa,F,100,5,0,5
Carmelito,M,100,0,5,5
Carmenita,F,100,5,0,5
Carmenlita,F,100,5,0,5
Carmetta,F,100,5,0,5
Caroljean,F,100,5,0,5
Caronda,F,100,5,0,5
Caroyl,F,100,5,0,5
Carsandra,F,100,5,0,5
Carterjames,M,100,0,5,5
Caryann,F,100,5,0,5
Carynn,F,100,5,0,5
Casiah,F,100,5,0,5
Casimira,F,100,5,0,5
Casiyah,F,100,5,0,5
Cassanda,F,100,5,0,5
Cassidey,F,100,5,0,5
Casslyn,F,100,5,0,5
Casson,M,100,0,5,5
Caster,M,100,0,5,5
Castyn,M,100,0,5,5
Casundra,F,100,5,0,5
Caswell,M,100,0,5,5
Cataleena,F,100,5,0,5
Cataleia,F,100,5,0,5
Cataliya,F,100,5,0,5
Catasha,F,100,5,0,5
Catch,M,100,0,5,5
Cateria,F,100,5,0,5
Cathalia,F,100,5,0,5
Cathay,F,100,5,0,5
Catherne,F,100,5,0,5
Cathlean,F,100,5,0,5
Cathline,F,100,5,0,5
Cathren,F,100,5,0,5
Cathrin,F,100,5,0,5
Cati,F,100,5,0,5
Catrinia,F,100,5,0,5
Cauan,M,100,0,5,5
Cawanda,F,100,5,0,5
Caydenn,M,100,0,5,5
Caydince,F,100,5,0,5
Cayl,M,100,0,5,5
Caymon,M,100,0,5,5
Caysey,M,100,0,5,5
Cayslee,F,100,5,0,5
Cazandra,F,100,5,0,5
Cean,M,100,0,5,5
Ceann,F,100,5,0,5
Cearia,F,100,5,0,5
Ceci,F,100,5,0,5
Ceferino,M,100,0,5,5
Celenne,F,100,5,0,5
Celeta,F,100,5,0,5
Celetha,F,100,5,0,5
Celio,M,100,0,5,5
Celiyah,F,100,5,0,5
Celsie,F,100,5,0,5
Celton,M,100,0,5,5
Cenia,F,100,5,0,5
Cennedy,F,100,5,0,5
Centwane,M,100,0,5,5
Ceonna,F,100,5,0,5
Cerah,F,100,5,0,5
Ceren,F,100,5,0,5
Cervantes,M,100,0,5,5
Cesiley,F,100,5,0,5
Chaaya,F,100,5,0,5
Chaderick,M,100,0,5,5
Chadman,M,100,0,5,5
Chadsity,F,100,5,0,5
Chaisty,F,100,5,0,5
Chakeya,F,100,5,0,5
Chakong,M,100,0,5,5
Chalan,F,100,5,0,5
Chalandra,F,100,5,0,5
Chalie,F,100,5,0,5
Chalina,F,100,5,0,5
Chalis,F,100,5,0,5
Chalita,F,100,5,0,5
Chama,F,100,5,0,5
Chamara,F,100,5,0,5
Chambers,M,100,0,5,5
Chamille,F,100,5,0,5
Champaign,F,100,5,0,5
Chanai,F,100,5,0,5
Chanc,M,100,0,5,5
Chanceler,M,100,0,5,5
Chanci,F,100,5,0,5
Chandal,F,100,5,0,5
Chanden,M,100,0,5,5
Chandre,F,100,5,0,5
Chandrell,F,100,5,0,5
Chaneice,F,100,5,0,5
Chanielle,F,100,5,0,5
Channan,F,100,5,0,5
Channen,M,100,0,5,5
Chanston,M,100,0,5,5
Chantey,F,100,5,0,5
Chantez,F,100,5,0,5
Chantra,M,100,0,5,5
Chantrelle,F,100,5,0,5
Chanyah,F,100,5,0,5
Chappell,M,100,0,5,5
Chaquetta,F,100,5,0,5
Chardonae,F,100,5,0,5
Charessa,F,100,5,0,5
Charlanda,F,100,5,0,5
Charleah,F,100,5,0,5
Charlemagne,M,100,0,5,5
Charlesedward,M,100,0,5,5
Charlesha,F,100,5,0,5
Charletha,F,100,5,0,5
Charliemae,F,100,5,0,5
Charlies,M,100,0,5,5
Charlin,F,100,5,0,5
Charlisia,F,100,5,0,5
Charlon,F,100,5,0,5
Charlynne,F,100,5,0,5
Charmaigne,F,100,5,0,5
Charmarie,F,100,5,0,5
Charneshia,F,100,5,0,5
Charnessa,F,100,5,0,5
Charniqua,F,100,5,0,5
Charri,F,100,5,0,5
Charvey,F,100,5,0,5
Charvik,M,100,0,5,5
Charyn,F,100,5,0,5
Chasetin,M,100,0,5,5
Chasie,F,100,5,0,5
Chass,M,100,0,5,5
Chastina,F,100,5,0,5
Chatal,F,100,5,0,5
Chauntee,F,100,5,0,5
Chauntia,F,100,5,0,5
Chavah,F,100,5,0,5
Chayane,M,100,0,5,5
Chayil,F,100,5,0,5
Chealse,F,100,5,0,5
Cheena,F,100,5,0,5
Cheisa,F,100,5,0,5
Chelbe,F,100,5,0,5
Chelene,F,100,5,0,5
Chelese,F,100,5,0,5
Chelette,F,100,5,0,5
Chelsealynn,F,100,5,0,5
Chelseamarie,F,100,5,0,5
Chelynne,F,100,5,0,5
Chemane,F,100,5,0,5
Chemeka,F,100,5,0,5
Chemika,F,100,5,0,5
Chemise,F,100,5,0,5
Chenese,F,100,5,0,5
Chenin,F,100,5,0,5
Chennel,F,100,5,0,5
Chentel,F,100,5,0,5
Cheramie,F,100,5,0,5
Cherena,F,100,5,0,5
Cheriann,F,100,5,0,5
Cherida,F,100,5,0,5
Cherin,F,100,5,0,5
Cherrel,F,100,5,0,5
Cherrisse,F,100,5,0,5
Cheryce,F,100,5,0,5
Cheslie,F,100,5,0,5
Chesni,F,100,5,0,5
Chessica,F,100,5,0,5
Chetara,F,100,5,0,5
Chevella,F,100,5,0,5
Chiam,M,100,0,5,5
Chiani,F,100,5,0,5
Chiann,F,100,5,0,5
Chick,M,100,0,5,5
Chidumebi,F,100,5,0,5
Chiedozie,M,100,0,5,5
Chikaima,F,100,5,0,5
Chimaobi,M,100,0,5,5
Chimeka,F,100,5,0,5
Chimira,F,100,5,0,5
Chin,M,100,0,5,5
Chinemerem,M,100,0,5,5
Chinere,F,100,5,0,5
Chinh,M,100,0,5,5
Chirelle,F,100,5,0,5
Chirsty,F,100,5,0,5
Chloelynn,F,100,5,0,5
Chontae,F,100,5,0,5
Chontel,F,100,5,0,5
Chozen,M,100,0,5,5
Chree,F,100,5,0,5
Chrisalyn,F,100,5,0,5
Chrisalynn,F,100,5,0,5
Chrishawna,F,100,5,0,5
Chrisi,F,100,5,0,5
Chrisitne,F,100,5,0,5
Chrissandra,F,100,5,0,5
Chrissey,F,100,5,0,5
Chrisshawn,M,100,0,5,5
Christianjay,M,100,0,5,5
Christienne,F,100,5,0,5
Christinejoy,F,100,5,0,5
Christne,F,100,5,0,5
Christopherjame,M,100,0,5,5
Christopherlee,M,100,0,5,5
Chrstopher,M,100,0,5,5
Chrysanthe,F,100,5,0,5
Chrysoula,F,100,5,0,5
Chua,F,100,5,0,5
Chumy,F,100,5,0,5
Chy,F,100,5,0,5
Chyra,F,100,5,0,5
Chyrstal,F,100,5,0,5
Ciannah,F,100,5,0,5
Cidalia,F,100,5,0,5
Cidni,F,100,5,0,5
Cieanna,F,100,5,0,5
Cierre,F,100,5,0,5
Cin,M,100,0,5,5
Cina,F,100,5,0,5
Cindya,F,100,5,0,5
Ciniyah,F,100,5,0,5
Cinsere,M,100,0,5,5
Cintra,F,100,5,0,5
Ciya,F,100,5,0,5
Clabe,M,100,0,5,5
Clairece,F,100,5,0,5
Clairemarie,F,100,5,0,5
Clairene,F,100,5,0,5
Clairity,F,100,5,0,5
Clarah,F,100,5,0,5
Claramae,F,100,5,0,5
Claren,F,100,5,0,5
Claria,F,100,5,0,5
Clarisha,F,100,5,0,5
Claryce,F,100,5,0,5
Claudeen,F,100,5,0,5
Claudel,M,100,0,5,5
Claudett,F,100,5,0,5
Claven,M,100,0,5,5
Claytin,M,100,0,5,5
Cleatrice,F,100,5,0,5
Cleona,F,100,5,0,5
Clerance,M,100,0,5,5
Clevie,M,100,0,5,5
Cloretta,F,100,5,0,5
Clotilda,F,100,5,0,5
Cloyde,M,100,0,5,5
Coalson,M,100,0,5,5
Cobra,M,100,0,5,5
Coburn,M,100,0,5,5
Cohutta,M,100,0,5,5
Cola,M,100,0,5,5
Colena,F,100,5,0,5
Colgan,M,100,0,5,5
Colisa,F,100,5,0,5
Colita,F,100,5,0,5
Comari,M,100,0,5,5
Common,M,100,0,5,5
Compton,M,100,0,5,5
Conagher,M,100,0,5,5
Conar,M,100,0,5,5
Concettina,F,100,5,0,5
Coner,M,100,0,5,5
Coney,M,100,0,5,5
Cong,M,100,0,5,5
Conlon,M,100,0,5,5
Connolly,M,100,0,5,5
Consuello,F,100,5,0,5
Copen,M,100,0,5,5
Coralea,F,100,5,0,5
Coralis,F,100,5,0,5
Coralynne,F,100,5,0,5
Corayma,F,100,5,0,5
Corbitt,M,100,0,5,5
Cordeja,F,100,5,0,5
Cordella,F,100,5,0,5
Corderrius,M,100,0,5,5
Cordin,M,100,0,5,5
Corentin,M,100,0,5,5
Corinthians,M,100,0,5,5
Corleone,M,100,0,5,5
Cormack,M,100,0,5,5
Corneal,M,100,0,5,5
Corneilius,M,100,0,5,5
Cornesia,F,100,5,0,5
Corney,M,100,0,5,5
Corniya,F,100,5,0,5
Corniyah,F,100,5,0,5
Coron,M,100,0,5,5
Corren,F,100,5,0,5
Corrinn,F,100,5,0,5
Corris,M,100,0,5,5
Corron,M,100,0,5,5
Corryne,F,100,5,0,5
Corsha,F,100,5,0,5
Cortell,M,100,0,5,5
Cortlandt,M,100,0,5,5
Corvon,M,100,0,5,5
Corye,M,100,0,5,5
Coryion,M,100,0,5,5
Cosetta,F,100,5,0,5
Cosmas,M,100,0,5,5
Cossette,F,100,5,0,5
Cotina,F,100,5,0,5
Cottie,F,100,5,0,5
Coulten,M,100,0,5,5
Couri,F,100,5,0,5
Coury,M,100,0,5,5
Coven,M,100,0,5,5
Coyt,M,100,0,5,5
Creasie,F,100,5,0,5
Credence,F,100,5,0,5
Creedan,M,100,0,5,5
Creede,M,100,0,5,5
Creon,M,100,0,5,5
Cresha,F,100,5,0,5
Cretia,F,100,5,0,5
Crisanta,F,100,5,0,5
Crisha,F,100,5,0,5
Crisoforo,M,100,0,5,5
Crisol,F,100,5,0,5
Crissey,F,100,5,0,5
Cristaly,F,100,5,0,5
Cristien,M,100,0,5,5
Cruse,M,100,0,5,5
Crystalee,F,100,5,0,5
Crystalina,F,100,5,0,5
Crystaline,F,100,5,0,5
Crystil,F,100,5,0,5
Crystl,F,100,5,0,5
Crystopher,M,100,0,5,5
Curlene,F,100,5,0,5
Currie,M,100,0,5,5
Curstyn,F,100,5,0,5
Curtia,F,100,5,0,5
Custer,M,100,0,5,5
Cyarra,F,100,5,0,5
Cydnei,F,100,5,0,5
Cyndle,F,100,5,0,5
Cyntheia,F,100,5,0,5
Cynthi,F,100,5,0,5
Cytlali,F,100,5,0,5
Cytlaly,F,100,5,0,5
Czaria,F,100,5,0,5
Daaimah,F,100,5,0,5
Daan,M,100,0,5,5
Daania,F,100,5,0,5
Daciana,F,100,5,0,5
Dacion,M,100,0,5,5
Dacorian,M,100,0,5,5
Dacy,F,100,5,0,5
Dadrianna,F,100,5,0,5
Daebreona,F,100,5,0,5
Daejion,M,100,0,5,5
Daejohn,M,100,0,5,5
Daemond,M,100,0,5,5
Daeqwon,M,100,0,5,5
Daeshawna,F,100,5,0,5
Daeshia,F,100,5,0,5
Daezon,M,100,0,5,5
Daffany,F,100,5,0,5
Dafny,F,100,5,0,5
Dag,M,100,0,5,5
Dagem,M,100,0,5,5
Dagger,M,100,0,5,5
Dah,F,100,5,0,5
Dahana,F,100,5,0,5
Dahn,F,100,5,0,5
Dahnya,F,100,5,0,5
Daian,M,100,0,5,5
Daiceon,M,100,0,5,5
Daicy,F,100,5,0,5
Daid,M,100,0,5,5
Daimion,M,100,0,5,5
Dainon,M,100,0,5,5
Daiquiri,F,100,5,0,5
Dairl,M,100,0,5,5
Dairra,F,100,5,0,5
Dairyn,F,100,5,0,5
Daishana,F,100,5,0,5
Daishia,F,100,5,0,5
Daivik,M,100,0,5,5
Dajane,F,100,5,0,5
Dajauna,F,100,5,0,5
Dajavette,F,100,5,0,5
Daje,F,100,5,0,5
Dajhia,F,100,5,0,5
Dakarie,M,100,0,5,5
Dakhia,F,100,5,0,5
Dakisha,F,100,5,0,5
Dakiyah,F,100,5,0,5
Dakobe,M,100,0,5,5
Daksha,F,100,5,0,5
Dakwan,M,100,0,5,5
Dakwon,M,100,0,5,5
Dakyrah,F,100,5,0,5
Dalany,F,100,5,0,5
Dalaylah,F,100,5,0,5
Dalea,F,100,5,0,5
Daleigh,F,100,5,0,5
Daleisha,F,100,5,0,5
Dalerie,F,100,5,0,5
Daleysi,F,100,5,0,5
Dalijah,F,100,5,0,5
Daliyla,F,100,5,0,5
Daliylah,F,100,5,0,5
Dallyce,F,100,5,0,5
Dalys,F,100,5,0,5
Damaj,M,100,0,5,5
Damante,M,100,0,5,5
Damariae,M,100,0,5,5
Damarii,M,100,0,5,5
Damarlo,M,100,0,5,5
Damarrius,M,100,0,5,5
Damecia,F,100,5,0,5
Dameisha,F,100,5,0,5
Damerius,M,100,0,5,5
Dametrice,F,100,5,0,5
Damiean,M,100,0,5,5
Damiere,M,100,0,5,5
Damilare,M,100,0,5,5
Damina,F,100,5,0,5
Damine,M,100,0,5,5
Damione,M,100,0,5,5
Damiracle,F,100,5,0,5
Damiyon,M,100,0,5,5
Dammon,M,100,0,5,5
Damne,F,100,5,0,5
Damonee,M,100,0,5,5
Damonii,M,100,0,5,5
Damonni,M,100,0,5,5
Damori,M,100,0,5,5
Damorris,M,100,0,5,5
Danaejah,F,100,5,0,5
Danajha,F,100,5,0,5
Danautica,F,100,5,0,5
Danaye,F,100,5,0,5
Dancia,F,100,5,0,5
Daneah,F,100,5,0,5
Daneca,F,100,5,0,5
Daneika,F,100,5,0,5
Danelia,F,100,5,0,5
Daneya,F,100,5,0,5
Daniale,F,100,5,0,5
Danieliz,F,100,5,0,5
Danieljr,M,100,0,5,5
Daniely,F,100,5,0,5
Danis,M,100,0,5,5
Danishia,F,100,5,0,5
Daniylah,F,100,5,0,5
Dannalyn,F,100,5,0,5
Dannay,F,100,5,0,5
Dannesha,F,100,5,0,5
Dannilyn,F,100,5,0,5
Danquan,M,100,0,5,5
Danson,M,100,0,5,5
Dantee,M,100,0,5,5
Dantoni,M,100,0,5,5
Dantwan,M,100,0,5,5
Danyaal,M,100,0,5,5
Danyalle,F,100,5,0,5
Danyca,F,100,5,0,5
Danykah,F,100,5,0,5
Danziel,M,100,0,5,5
Daquandre,M,100,0,5,5
Daquavion,M,100,0,5,5
Daquesha,F,100,5,0,5
Daralene,F,100,5,0,5
Darden,M,100,0,5,5
Dareli,F,100,5,0,5
Dareth,F,100,5,0,5
Darico,M,100,0,5,5
Dariell,M,100,0,5,5
Daries,M,100,0,5,5
Daril,M,100,0,5,5
Darisley,F,100,5,0,5
Darletta,F,100,5,0,5
Darliss,F,100,5,0,5
Darmani,M,100,0,5,5
Darnaja,F,100,5,0,5
Darnay,M,100,0,5,5
Darnecia,F,100,5,0,5
Darone,M,100,0,5,5
Darquis,M,100,0,5,5
Darreld,M,100,0,5,5
Darrellyn,F,100,5,0,5
Darrias,M,100,0,5,5
Darric,M,100,0,5,5
Darryus,M,100,0,5,5
Darsey,F,100,5,0,5
Darshaun,M,100,0,5,5
Darshawn,M,100,0,5,5
Darshi,F,100,5,0,5
Darsie,F,100,5,0,5
Darsy,F,100,5,0,5
Dartavious,M,100,0,5,5
Darvens,M,100,0,5,5
Daryal,M,100,0,5,5
Daryk,M,100,0,5,5
Daryla,F,100,5,0,5
Darylene,F,100,5,0,5
Dashaan,M,100,0,5,5
Dashad,M,100,0,5,5
Dashane,F,100,5,0,5
Dashira,F,100,5,0,5
Datavious,M,100,0,5,5
Datrice,F,100,5,0,5
Daurice,F,100,5,0,5
Daury,M,100,0,5,5
Davaeh,F,100,5,0,5
Davana,F,100,5,0,5
Davantae,M,100,0,5,5
Davany,F,100,5,0,5
Daveda,F,100,5,0,5
Davelle,M,100,0,5,5
Daveona,F,100,5,0,5
Davidallen,M,100,0,5,5
Davilyn,F,100,5,0,5
Daviney,F,100,5,0,5
Davionn,M,100,0,5,5
Davious,M,100,0,5,5
Daviyana,F,100,5,0,5
Davod,M,100,0,5,5
Davonda,F,100,5,0,5
Davonia,F,100,5,0,5
Davontre,M,100,0,5,5
Davuan,M,100,0,5,5
Davud,M,100,0,5,5
Dawndi,F,100,5,0,5
Dawnel,F,100,5,0,5
Dawnett,F,100,5,0,5
Dawnta,F,100,5,0,5
Daxyn,M,100,0,5,5
Dayane,F,100,5,0,5
Dayanie,F,100,5,0,5
Dayasia,F,100,5,0,5
Dayjon,M,100,0,5,5
Dayland,M,100,0,5,5
Daylanie,F,100,5,0,5
Daylia,F,100,5,0,5
Daymein,M,100,0,5,5
Dayvanee,F,100,5,0,5
Dayvonne,M,100,0,5,5
Dayza,F,100,5,0,5
Dayzi,F,100,5,0,5
Dazani,F,100,5,0,5
Dazarion,M,100,0,5,5
Dazhan,M,100,0,5,5
Daziel,M,100,0,5,5
Dazjah,F,100,5,0,5
Dazzlyn,F,100,5,0,5
Deagen,M,100,0,5,5
Deair,M,100,0,5,5
Deajon,M,100,0,5,5
Deakyn,M,100,0,5,5
Deamontae,M,100,0,5,5
Deani,F,100,5,0,5
Deanjelo,M,100,0,5,5
Deantoine,M,100,0,5,5
Deashawn,M,100,0,5,5
Deashley,F,100,5,0,5
Deason,M,100,0,5,5
Deaudre,M,100,0,5,5
Deaundray,M,100,0,5,5
Deaundrea,F,100,5,0,5
Debany,F,100,5,0,5
Debbrah,F,100,5,0,5
Deborra,F,100,5,0,5
Debron,M,100,0,5,5
Decameron,M,100,0,5,5
Decedric,M,100,0,5,5
Decia,F,100,5,0,5
Decimus,M,100,0,5,5
Decorion,M,100,0,5,5
Decory,M,100,0,5,5
Dederick,M,100,0,5,5
Dedre,F,100,5,0,5
Dedriana,F,100,5,0,5
Deede,F,100,5,0,5
Deeken,M,100,0,5,5
Deenah,F,100,5,0,5
Deera,F,100,5,0,5
Deforrest,M,100,0,5,5
Deianeira,F,100,5,0,5
Deiara,F,100,5,0,5
Deida,F,100,5,0,5
Deijon,M,100,0,5,5
Deilani,F,100,5,0,5
Deilany,F,100,5,0,5
Deionta,M,100,0,5,5
Deiontre,M,100,0,5,5
Deira,F,100,5,0,5
Deisree,F,100,5,0,5
Deiveon,M,100,0,5,5
Deivi,M,100,0,5,5
Dejahn,M,100,0,5,5
Dejanaye,F,100,5,0,5
Dejavion,M,100,0,5,5
Dejoun,M,100,0,5,5
Dejuane,M,100,0,5,5
Dekara,F,100,5,0,5
Dekeisha,F,100,5,0,5
Dekevious,M,100,0,5,5
Dekiyah,F,100,5,0,5
Dekotah,F,100,5,0,5
Dekyra,F,100,5,0,5
Delacy,F,100,5,0,5
Delainah,F,100,5,0,5
Delandra,F,100,5,0,5
Delannie,F,100,5,0,5
Delauren,F,100,5,0,5
Delaylah,F,100,5,0,5
Delaysha,F,100,5,0,5
Delcan,M,100,0,5,5
Delcia,F,100,5,0,5
Delea,F,100,5,0,5
Deleshia,F,100,5,0,5
Deleta,F,100,5,0,5
Delice,F,100,5,0,5
Delilahrose,F,100,5,0,5
Delissia,F,100,5,0,5
Delite,F,100,5,0,5
Dellanie,F,100,5,0,5
Delle,F,100,5,0,5
Dellena,F,100,5,0,5
Dellie,F,100,5,0,5
Dellis,M,100,0,5,5
Delmarco,M,100,0,5,5
Delmonte,M,100,0,5,5
Deloni,M,100,0,5,5
Delquan,M,100,0,5,5
Delsy,F,100,5,0,5
Delva,F,100,5,0,5
Delynda,F,100,5,0,5
Demanuel,M,100,0,5,5
Demarcos,M,100,0,5,5
Demare,M,100,0,5,5
Demareo,M,100,0,5,5
Demariona,F,100,5,0,5
Demarkio,M,100,0,5,5
Demarus,M,100,0,5,5
Demas,M,100,0,5,5
Demeatrius,M,100,0,5,5
Demeca,F,100,5,0,5
Demecia,F,100,5,0,5
Demedrick,M,100,0,5,5
Demetrian,M,100,0,5,5
Demetriana,F,100,5,0,5
Demetrics,M,100,0,5,5
Demetrise,F,100,5,0,5
Demier,M,100,0,5,5
Demii,F,100,5,0,5
Demitrio,M,100,0,5,5
Demitrus,M,100,0,5,5
Demmie,F,100,5,0,5
Demonei,M,100,0,5,5
Demontrez,M,100,0,5,5
Demtrius,M,100,0,5,5
Denaeja,F,100,5,0,5
Denaiya,F,100,5,0,5
Denamarie,F,100,5,0,5
Denardo,M,100,0,5,5
Denaria,F,100,5,0,5
Denayah,F,100,5,0,5
Denaye,F,100,5,0,5
Denazia,F,100,5,0,5
Deneene,F,100,5,0,5
Denel,F,100,5,0,5
Denequa,F,100,5,0,5
Denerick,M,100,0,5,5
Denes,M,100,0,5,5
Denesia,F,100,5,0,5
Denetrice,F,100,5,0,5
Denico,M,100,0,5,5
Deniss,F,100,5,0,5
Denmark,M,100,0,5,5
Dennes,M,100,0,5,5
Dennia,F,100,5,0,5
Denya,F,100,5,0,5
Denzelle,M,100,0,5,5
Deola,F,100,5,0,5
Deondric,M,100,0,5,5
Deonica,F,100,5,0,5
Deontea,M,100,0,5,5
Deosha,F,100,5,0,5
Dequawn,M,100,0,5,5
Dequita,F,100,5,0,5
Derak,M,100,0,5,5
Derby,M,100,0,5,5
Dereginald,M,100,0,5,5
Deresha,F,100,5,0,5
Derex,M,100,0,5,5
Derez,M,100,0,5,5
Deri,F,100,5,0,5
Derique,M,100,0,5,5
Dermarr,M,100,0,5,5
Dermont,M,100,0,5,5
Derrelle,M,100,0,5,5
Derrice,M,100,0,5,5
Derrie,M,100,0,5,5
Derrione,M,100,0,5,5
Derrionna,F,100,5,0,5
Derrold,M,100,0,5,5
Derryk,M,100,0,5,5
Deryle,M,100,0,5,5
Desai,M,100,0,5,5
Desara,F,100,5,0,5
Desaraye,F,100,5,0,5
Desare,F,100,5,0,5
Deshanae,F,100,5,0,5
Deshanta,F,100,5,0,5
Deshara,F,100,5,0,5
Deshaunda,F,100,5,0,5
Deshawnda,F,100,5,0,5
Deshell,F,100,5,0,5
Deshia,F,100,5,0,5
Desinae,F,100,5,0,5
Desirai,F,100,5,0,5
Desirie,F,100,5,0,5
Desirree,F,100,5,0,5
Desja,F,100,5,0,5
Desmariah,F,100,5,0,5
Desmine,M,100,0,5,5
Desmona,F,100,5,0,5
Desseray,F,100,5,0,5
Destannie,F,100,5,0,5
Destene,F,100,5,0,5
Destined,M,100,0,5,5
Destinymarie,F,100,5,0,5
Destoni,F,100,5,0,5
Destri,F,100,5,0,5
Destyny,F,100,5,0,5
Deta,F,100,5,0,5
Detavion,M,100,0,5,5
Dettrick,M,100,0,5,5
Devanna,F,100,5,0,5
Devannie,F,100,5,0,5
Devanta,M,100,0,5,5
Devarus,M,100,0,5,5
Devaya,F,100,5,0,5
Devayah,F,100,5,0,5
Deveah,F,100,5,0,5
Develyn,F,100,5,0,5
Devena,F,100,5,0,5
Dever,M,100,0,5,5
Deverly,F,100,5,0,5
Devern,M,100,0,5,5
Deveshi,F,100,5,0,5
Devette,F,100,5,0,5
Devione,M,100,0,5,5
Devlen,M,100,0,5,5
Devn,M,100,0,5,5
Devohn,M,100,0,5,5
Devondra,F,100,5,0,5
Devonee,F,100,5,0,5
Devontaye,M,100,0,5,5
Devontez,M,100,0,5,5
Devontrey,M,100,0,5,5
Devraj,M,100,0,5,5
Devry,M,100,0,5,5
Devynne,F,100,5,0,5
Deyaneira,F,100,5,0,5
Deyja,F,100,5,0,5
Deyshawn,M,100,0,5,5
Deysia,F,100,5,0,5
Deyvi,M,100,0,5,5
Deyvid,M,100,0,5,5
Deyvion,M,100,0,5,5
Dezarai,F,100,5,0,5
Dezerea,F,100,5,0,5
Dezeree,F,100,5,0,5
Dezhaun,M,100,0,5,5
Dezhon,M,100,0,5,5
Dezion,M,100,0,5,5
Dezmund,M,100,0,5,5
Deztyni,F,100,5,0,5
Dezzarae,F,100,5,0,5
Dhanna,F,100,5,0,5
Dharmik,M,100,0,5,5
Dheera,M,100,0,5,5
Dhiago,M,100,0,5,5
Dhivya,F,100,5,0,5
Dhruthi,F,100,5,0,5
Dhruvan,M,100,0,5,5
Dhwani,F,100,5,0,5
Di,F,100,5,0,5
Dianaliz,F,100,5,0,5
Dianelly,F,100,5,0,5
Dianni,F,100,5,0,5
Diavione,F,100,5,0,5
Dibanhi,F,100,5,0,5
Dichelle,F,100,5,0,5
Diedrich,M,100,0,5,5
Diellza,F,100,5,0,5
Diena,F,100,5,0,5
Diera,F,100,5,0,5
Dierk,M,100,0,5,5
Dikran,M,100,0,5,5
Dilana,F,100,5,0,5
Dilann,M,100,0,5,5
Dilayla,F,100,5,0,5
Dillynn,F,100,5,0,5
Dilylah,F,100,5,0,5
Dimario,M,100,0,5,5
Dimesha,F,100,5,0,5
Dimitrie,M,100,0,5,5
Dinae,F,100,5,0,5
Dinnie,M,100,0,5,5
Diocelina,F,100,5,0,5
Dionah,F,100,5,0,5
Dioseline,F,100,5,0,5
Dioselyn,F,100,5,0,5
Dipa,F,100,5,0,5
Dipti,F,100,5,0,5
Dirrick,M,100,0,5,5
Dita,F,100,5,0,5
Divany,F,100,5,0,5
Divonte,M,100,0,5,5
Divyam,M,100,0,5,5
Divyesh,M,100,0,5,5
Dixee,F,100,5,0,5
Diyaa,F,100,5,0,5
Diyor,M,100,0,5,5
Diyora,F,100,5,0,5
Djene,F,100,5,0,5
Dkari,M,100,0,5,5
Dlana,F,100,5,0,5
Dlayna,F,100,5,0,5
Dlila,F,100,5,0,5
Dlilah,F,100,5,0,5
Dlorah,F,100,5,0,5
Dmar,M,100,0,5,5
Dmitrius,M,100,0,5,5
Dmiyah,F,100,5,0,5
Dmon,M,100,0,5,5
Dmontae,M,100,0,5,5
Dmyah,F,100,5,0,5
Dnae,F,100,5,0,5
Dnaiel,M,100,0,5,5
Dnaja,F,100,5,0,5
Dnylah,F,100,5,0,5
Doane,M,100,0,5,5
Doddie,F,100,5,0,5
Dodson,M,100,0,5,5
Doel,M,100,0,5,5
Dois,F,100,5,0,5
Domari,M,100,0,5,5
Domineque,M,100,0,5,5
Domingos,M,100,0,5,5
Dominicka,F,100,5,0,5
Domminic,M,100,0,5,5
Donalynn,F,100,5,0,5
Donathon,M,100,0,5,5
Dondrick,M,100,0,5,5
Doneva,F,100,5,0,5
Donique,M,100,0,5,5
Donivon,M,100,0,5,5
Donjanae,F,100,5,0,5
Donnavin,M,100,0,5,5
Donneisha,F,100,5,0,5
Donnelly,M,100,0,5,5
Donneta,F,100,5,0,5
Donsha,F,100,5,0,5
Dontario,M,100,0,5,5
Dontarious,M,100,0,5,5
Dontaysha,F,100,5,0,5
Donterious,M,100,0,5,5
Dontravious,M,100,0,5,5
Donza,F,100,5,0,5
Donzetta,F,100,5,0,5
Dor,F,100,5,0,5
Doranna,F,100,5,0,5
Doresha,F,100,5,0,5
Dorissa,F,100,5,0,5
Dorota,F,100,5,0,5
Dorotea,F,100,5,0,5
Dorothia,F,100,5,0,5
Dorothyann,F,100,5,0,5
Dorothye,F,100,5,0,5
Dorron,M,100,0,5,5
Doryce,F,100,5,0,5
Dover,M,100,0,5,5
Dovi,M,100,0,5,5
Down,F,100,5,0,5
Doyne,M,100,0,5,5
Dquarius,M,100,0,5,5
Draike,M,100,0,5,5
Draiman,M,100,0,5,5
Drason,M,100,0,5,5
Draylee,F,100,5,0,5
Drayon,M,100,0,5,5
Drazen,M,100,0,5,5
Dreamer,F,100,5,0,5
Dreana,F,100,5,0,5
Dreena,F,100,5,0,5
Dregan,M,100,0,5,5
Drekwon,M,100,0,5,5
Dreniyah,F,100,5,0,5
Dreux,M,100,0,5,5
Drewry,M,100,0,5,5
Dreylan,M,100,0,5,5
Dreylin,M,100,0,5,5
Dreysen,M,100,0,5,5
Dreyten,M,100,0,5,5
Driscilla,F,100,5,0,5
Drishya,F,100,5,0,5
Druanne,F,100,5,0,5
Druce,M,100,0,5,5
Drummond,M,100,0,5,5
Dshon,M,100,0,5,5
Dshun,M,100,0,5,5
Du,M,100,0,5,5
Duain,M,100,0,5,5
Dude,M,100,0,5,5
Duey,M,100,0,5,5
Duilio,M,100,0,5,5
Dujon,M,100,0,5,5
Duntae,M,100,0,5,5
Dureen,F,100,5,0,5
Durel,M,100,0,5,5
Durrel,M,100,0,5,5
Dusan,M,100,0,5,5
Dustinjames,M,100,0,5,5
Dut,M,100,0,5,5
Duvon,M,100,0,5,5
Duwaine,M,100,0,5,5
Dwuan,M,100,0,5,5
Dwyla,F,100,5,0,5
Dyante,M,100,0,5,5
Dyemond,F,100,5,0,5
Dyisha,F,100,5,0,5
Dylam,M,100,0,5,5
Dylanjacob,M,100,0,5,5
Dylian,M,100,0,5,5
Dymphna,F,100,5,0,5
Dyon,M,100,0,5,5
Dysean,M,100,0,5,5
Dyuthi,F,100,5,0,5
Dyvion,M,100,0,5,5
Dzeneta,F,100,5,0,5
Dziyah,F,100,5,0,5
Dzung,M,100,0,5,5
Eadyn,F,100,5,0,5
Eain,M,100,0,5,5
Earlesha,F,100,5,0,5
Earlis,M,100,0,5,5
Earlisa,F,100,5,0,5
Earna,F,100,5,0,5
Earney,M,100,0,5,5
Ebaristo,M,100,0,5,5
Ebonne,F,100,5,0,5
Ebonye,F,100,5,0,5
Edbert,M,100,0,5,5
Eddieberto,M,100,0,5,5
Eddye,F,100,5,0,5
Eddyson,M,100,0,5,5
Edelina,F,100,5,0,5
Edem,M,100,0,5,5
Edenilson,M,100,0,5,5
Ederson,M,100,0,5,5
Edica,F,100,5,0,5
Edika,F,100,5,0,5
Edilia,F,100,5,0,5
Edisa,F,100,5,0,5
Editha,F,100,5,0,5
Edrena,F,100,5,0,5
Eduarda,F,100,5,0,5
Edweina,F,100,5,0,5
Edword,M,100,0,5,5
Edwyna,F,100,5,0,5
Edzon,M,100,0,5,5
Eelijah,M,100,0,5,5
Effy,F,100,5,0,5
Efigenia,F,100,5,0,5
Efosa,M,100,0,5,5
Efram,M,100,0,5,5
Efrin,M,100,0,5,5
Eftihia,F,100,5,0,5
Egina,F,100,5,0,5
Egzon,M,100,0,5,5
Ehrin,F,100,5,0,5
Ehvan,M,100,0,5,5
Eileena,F,100,5,0,5
Eileene,F,100,5,0,5
Eileigh,F,100,5,0,5
Eillie,F,100,5,0,5
Eilonwy,F,100,5,0,5
Eilzabeth,F,100,5,0,5
Eimly,F,100,5,0,5
Eirian,F,100,5,0,5
Eizabeth,F,100,5,0,5
Eizley,F,100,5,0,5
Ejaz,M,100,0,5,5
Ekambir,M,100,0,5,5
Ekene,M,100,0,5,5
Eker,M,100,0,5,5
Eladia,F,100,5,0,5
Elaena,F,100,5,0,5
Elahna,F,100,5,0,5
Elainea,F,100,5,0,5
Elaini,F,100,5,0,5
Elandra,F,100,5,0,5
Elanny,F,100,5,0,5
Elayshia,F,100,5,0,5
Elbridge,M,100,0,5,5
Elcie,F,100,5,0,5
Elenah,F,100,5,0,5
Elexius,F,100,5,0,5
Elexys,F,100,5,0,5
Eleyah,F,100,5,0,5
Elfida,F,100,5,0,5
Elford,M,100,0,5,5
Elfreida,F,100,5,0,5
Elfriede,F,100,5,0,5
Elgar,M,100,0,5,5
Elhana,F,100,5,0,5
Elianagrace,F,100,5,0,5
Elianni,F,100,5,0,5
Eliannie,F,100,5,0,5
Eliase,M,100,0,5,5
Eliazbeth,F,100,5,0,5
Elica,F,100,5,0,5
Eliejah,M,100,0,5,5
Eliese,F,100,5,0,5
Elihue,M,100,0,5,5
Elijsha,M,100,0,5,5
Elikai,M,100,0,5,5
Elikem,M,100,0,5,5
Eliran,M,100,0,5,5
Elisabeta,F,100,5,0,5
Elishka,F,100,5,0,5
Eliverto,M,100,0,5,5
Elixander,M,100,0,5,5
Elixis,F,100,5,0,5
Eliyahna,F,100,5,0,5
Elizabeht,F,100,5,0,5
Elizabethgrace,F,100,5,0,5
Elizajane,F,100,5,0,5
Elizander,M,100,0,5,5
Elizandra,F,100,5,0,5
Elizette,F,100,5,0,5
Eljin,M,100,0,5,5
Ellabelle,F,100,5,0,5
Ellanah,F,100,5,0,5
Ellard,M,100,0,5,5
Ellasia,F,100,5,0,5
Ellasophia,F,100,5,0,5
Elleanora,F,100,5,0,5
Ellender,F,100,5,0,5
Ellesse,F,100,5,0,5
Ellicia,F,100,5,0,5
Elliekate,F,100,5,0,5
Ellisia,F,100,5,0,5
Elliyana,F,100,5,0,5
Ellymae,F,100,5,0,5
Ellyonna,F,100,5,0,5
Elner,F,100,5,0,5
Elnoria,F,100,5,0,5
Eloina,F,100,5,0,5
Eloiza,F,100,5,0,5
Elonna,F,100,5,0,5
Elpida,F,100,5,0,5
Elpidia,F,100,5,0,5
Elrick,M,100,0,5,5
Elvena,F,100,5,0,5
Elveria,F,100,5,0,5
Elvi,M,100,0,5,5
Elvir,M,100,0,5,5
Elvita,F,100,5,0,5
Elyja,M,100,0,5,5
Elynor,F,100,5,0,5
Elysian,F,100,5,0,5
Elysium,M,100,0,5,5
Elyus,M,100,0,5,5
Elzabeth,F,100,5,0,5
Emaje,M,100,0,5,5
Emalena,F,100,5,0,5
Emalin,F,100,5,0,5
Emanni,F,100,5,0,5
Emanuell,M,100,0,5,5
Emar,M,100,0,5,5
Emaria,F,100,5,0,5
Emee,F,100,5,0,5
Emeilia,F,100,5,0,5
Emerich,M,100,0,5,5
Emiel,M,100,0,5,5
Emier,M,100,0,5,5
Emijah,F,100,5,0,5
Emiliann,F,100,5,0,5
Emilianne,F,100,5,0,5
Emilliana,F,100,5,0,5
Emilye,F,100,5,0,5
Emilymarie,F,100,5,0,5
Emmabeth,F,100,5,0,5
Emmagene,F,100,5,0,5
Emmakay,F,100,5,0,5
Emmari,F,100,5,0,5
Emmauel,M,100,0,5,5
Emmee,F,100,5,0,5
Emmelene,F,100,5,0,5
Emmeric,M,100,0,5,5
Emmilou,F,100,5,0,5
Emond,M,100,0,5,5
Emontae,M,100,0,5,5
Emyri,F,100,5,0,5
Emzley,F,100,5,0,5
Enajah,F,100,5,0,5
Enari,F,100,5,0,5
Enasia,F,100,5,0,5
Enayah,F,100,5,0,5
Endsley,F,100,5,0,5
Enesa,F,100,5,0,5
Enessa,F,100,5,0,5
Engracia,F,100,5,0,5
Enio,M,100,0,5,5
Enisha,F,100,5,0,5
Enjolie,F,100,5,0,5
Enoe,M,100,0,5,5
Enolia,F,100,5,0,5
Ephrain,M,100,0,5,5
Ercilia,F,100,5,0,5
Erene,F,100,5,0,5
Erenest,M,100,0,5,5
Eria,F,100,5,0,5
Eriah,F,100,5,0,5
Erianny,F,100,5,0,5
Ericanicole,F,100,5,0,5
Ericjames,M,100,0,5,5
Eriella,F,100,5,0,5
Erihanna,F,100,5,0,5
Erikc,M,100,0,5,5
Erikia,F,100,5,0,5
Eriks,M,100,0,5,5
Erison,M,100,0,5,5
Eriyon,F,100,5,0,5
Ermalene,F,100,5,0,5
Ermina,F,100,5,0,5
Ernel,M,100,0,5,5
Erneshia,F,100,5,0,5
Ernestene,F,100,5,0,5
Ersula,F,100,5,0,5
Ervina,F,100,5,0,5
Esam,M,100,0,5,5
Escarlett,F,100,5,0,5
Esekiel,M,100,0,5,5
Eseosa,F,100,5,0,5
Eshaun,M,100,0,5,5
Eshton,M,100,0,5,5
Esiquio,M,100,0,5,5
Esmael,M,100,0,5,5
Esmarie,F,100,5,0,5
Esmerie,F,100,5,0,5
Essey,M,100,0,5,5
Essien,M,100,0,5,5
Esteffany,F,100,5,0,5
Estrada,M,100,0,5,5
Eszter,F,100,5,0,5
Etash,M,100,0,5,5
Eternal,M,100,0,5,5
Ethanael,M,100,0,5,5
Ethanial,M,100,0,5,5
Ethanmichael,M,100,0,5,5
Ethelle,F,100,5,0,5
Etnie,F,100,5,0,5
Etsub,F,100,5,0,5
Eual,M,100,0,5,5
Euclides,M,100,0,5,5
Euginia,F,100,5,0,5
Eustaquio,M,100,0,5,5
Evaeh,F,100,5,0,5
Evaney,F,100,5,0,5
Evangelita,F,100,5,0,5
Evangline,F,100,5,0,5
Eveanna,F,100,5,0,5
Evelinn,F,100,5,0,5
Everado,M,100,0,5,5
Everard,M,100,0,5,5
Everlei,F,100,5,0,5
Eversyn,F,100,5,0,5
Everth,M,100,0,5,5
Evins,M,100,0,5,5
Evlin,F,100,5,0,5
Evoni,F,100,5,0,5
Evorn,F,100,5,0,5
Evra,F,100,5,0,5
Evvy,F,100,5,0,5
Evylin,F,100,5,0,5
Ewaoluwa,F,100,5,0,5
Exar,M,100,0,5,5
Exavion,M,100,0,5,5
Ezariyah,F,100,5,0,5
Ezayah,M,100,0,5,5
Ezikiel,M,100,0,5,5
Eziquel,M,100,0,5,5
Ezlynn,F,100,5,0,5
Ezmariah,F,100,5,0,5
Ezme,F,100,5,0,5
Ezzah,F,100,5,0,5
Fabia,F,100,5,0,5
Fabiene,F,100,5,0,5
Fabiha,F,100,5,0,5
Fabrienne,F,100,5,0,5
Faeryn,F,100,5,0,5
Fahmida,F,100,5,0,5
Fain,M,100,0,5,5
Faina,F,100,5,0,5
Faiyaz,M,100,0,5,5
Fajar,F,100,5,0,5
Falina,F,100,5,0,5
Fallan,F,100,5,0,5
Fancie,F,100,5,0,5
Faneisha,F,100,5,0,5
Fantasha,F,100,5,0,5
Fany,F,100,5,0,5
Faraaz,M,100,0,5,5
Faraji,M,100,0,5,5
Farm,F,100,5,0,5
Farmer,M,100,0,5,5
Farra,F,100,5,0,5
Farshid,M,100,0,5,5
Fatemeh,F,100,5,0,5
Fathi,M,100,0,5,5
Fathia,F,100,5,0,5
Fatin,F,100,5,0,5
Fatmah,F,100,5,0,5
Faun,F,100,5,0,5
Fawzan,M,100,0,5,5
Fayann,F,100,5,0,5
Fayga,F,100,5,0,5
Fayha,F,100,5,0,5
Fayne,M,100,0,5,5
Fayola,F,100,5,0,5
Fedora,F,100,5,0,5
Feleica,F,100,5,0,5
Feleicia,F,100,5,0,5
Felicea,F,100,5,0,5
Felizardo,M,100,0,5,5
Fenn,M,100,0,5,5
Fennell,M,100,0,5,5
Fenner,M,100,0,5,5
Feona,F,100,5,0,5
Ferd,M,100,0,5,5
Ferdie,M,100,0,5,5
Ferguson,M,100,0,5,5
Ferid,M,100,0,5,5
Fernande,F,100,5,0,5
Ferol,F,100,5,0,5
Ferry,M,100,0,5,5
Fhernando,M,100,0,5,5
Fields,M,100,0,5,5
Fiifi,M,100,0,5,5
Filicity,F,100,5,0,5
Filipa,F,100,5,0,5
Filmon,M,100,0,5,5
Filomeno,M,100,0,5,5
Filza,F,100,5,0,5
Fineas,M,100,0,5,5
Finest,M,100,0,5,5
Fiorenza,F,100,5,0,5
Firdaws,F,100,5,0,5
Firdous,F,100,5,0,5
Firyal,F,100,5,0,5
Fishel,M,100,0,5,5
Fisnik,M,100,0,5,5
Fjolla,F,100,5,0,5
Flabio,M,100,0,5,5
Fleet,M,100,0,5,5
Flip,M,100,0,5,5
Florestine,F,100,5,0,5
Floridalma,F,100,5,0,5
Floyce,F,100,5,0,5
Floydene,F,100,5,0,5
Fonnie,F,100,5,0,5
Forde,M,100,0,5,5
Forum,F,100,5,0,5
Fouzia,F,100,5,0,5
Franchesco,M,100,0,5,5
Francico,M,100,0,5,5
Frankye,F,100,5,0,5
Franne,F,100,5,0,5
Frantzy,M,100,0,5,5
Franyelis,F,100,5,0,5
Frazer,M,100,0,5,5
Freddick,M,100,0,5,5
Frederika,F,100,5,0,5
Freidy,F,100,5,0,5
Fronie,F,100,5,0,5
Frutoso,M,100,0,5,5
Funmilayo,F,100,5,0,5
Furqan,M,100,0,5,5
Fuzail,M,100,0,5,5
Fynley,F,100,5,0,5
Gabija,F,100,5,0,5
Gabin,M,100,0,5,5
Gabina,F,100,5,0,5
Gabirel,M,100,0,5,5
Gabriala,F,100,5,0,5
Gabriely,F,100,5,0,5
Gaebriel,M,100,0,5,5
Gaetan,M,100,0,5,5
Gahel,M,100,0,5,5
Gailya,F,100,5,0,5
Gailyn,F,100,5,0,5
Gaitlin,F,100,5,0,5
Galinda,F,100,5,0,5
Galit,F,100,5,0,5
Galiyah,F,100,5,0,5
Galvester,M,100,0,5,5
Galynn,F,100,5,0,5
Gandalf,M,100,0,5,5
Ganell,F,100,5,0,5
Ganna,F,100,5,0,5
Gannicus,M,100,0,5,5
Gantt,M,100,0,5,5
Garan,M,100,0,5,5
Garbiel,M,100,0,5,5
Gareld,M,100,0,5,5
Garian,M,100,0,5,5
Garie,M,100,0,5,5
Gariella,F,100,5,0,5
Garran,M,100,0,5,5
Garrek,M,100,0,5,5
Garrel,M,100,0,5,5
Garrell,M,100,0,5,5
Garv,M,100,0,5,5
Garvey,M,100,0,5,5
Garwin,M,100,0,5,5
Garytt,M,100,0,5,5
Gatlen,M,100,0,5,5
Gator,M,100,0,5,5
Gattis,M,100,0,5,5
Gayna,F,100,5,0,5
Gaytha,F,100,5,0,5
Geannie,F,100,5,0,5
Gedaliah,M,100,0,5,5
Geff,M,100,0,5,5
Gemia,F,100,5,0,5
Genard,M,100,0,5,5
Genaveve,F,100,5,0,5
Genele,F,100,5,0,5
Generra,F,100,5,0,5
Geneveive,F,100,5,0,5
Genevy,F,100,5,0,5
Genica,F,100,5,0,5
Geniel,F,100,5,0,5
Geniene,F,100,5,0,5
Gennesys,F,100,5,0,5
Gennetta,F,100,5,0,5
Gennine,F,100,5,0,5
Gentrie,F,100,5,0,5
Geoge,M,100,0,5,5
Geon,M,100,0,5,5
Geordie,M,100,0,5,5
Georga,F,100,5,0,5
Georgenia,F,100,5,0,5
Georgett,F,100,5,0,5
Georgy,M,100,0,5,5
Geradine,F,100,5,0,5
Gerall,M,100,0,5,5
Geramie,M,100,0,5,5
Gerber,M,100,0,5,5
Gered,M,100,0,5,5
Gerek,M,100,0,5,5
Geremie,M,100,0,5,5
Gerhardt,M,100,0,5,5
Geriah,F,100,5,0,5
Gerimiah,M,100,0,5,5
Gerlad,M,100,0,5,5
Gerline,F,100,5,0,5
Germya,F,100,5,0,5
Gerniya,F,100,5,0,5
Gero,M,100,0,5,5
Gerrald,M,100,0,5,5
Gerred,M,100,0,5,5
Gerrid,M,100,0,5,5
Gerrika,F,100,5,0,5
Gerrilyn,F,100,5,0,5
Gervase,M,100,0,5,5
Geryl,F,100,5,0,5
Gevena,F,100,5,0,5
Gevorg,M,100,0,5,5
Gewel,F,100,5,0,5
Geza,M,100,0,5,5
Ghaida,F,100,5,0,5
Ghaith,M,100,0,5,5
Ghena,F,100,5,0,5
Giahan,F,100,5,0,5
Giahna,F,100,5,0,5
Giahnna,F,100,5,0,5
Gianinna,F,100,5,0,5
Giannarose,F,100,5,0,5
Gianne,F,100,5,0,5
Giara,F,100,5,0,5
Gibb,M,100,0,5,5
Gicela,F,100,5,0,5
Giddeon,M,100,0,5,5
Giezi,M,100,0,5,5
Gifty,F,100,5,0,5
Gilana,F,100,5,0,5
Gillan,F,100,5,0,5
Gillen,M,100,0,5,5
Gillermina,F,100,5,0,5
Gillette,M,100,0,5,5
Gillianna,F,100,5,0,5
Gineen,F,100,5,0,5
Ginnette,F,100,5,0,5
Giobany,M,100,0,5,5
Gioconda,F,100,5,0,5
Gionnie,M,100,0,5,5
Giovonie,M,100,0,5,5
Gipsy,F,100,5,0,5
Girish,M,100,0,5,5
Gitanjali,F,100,5,0,5
Givanna,F,100,5,0,5
Givon,M,100,0,5,5
Gizzel,F,100,5,0,5
Gladine,F,100,5,0,5
Gladiz,F,100,5,0,5
Gleason,M,100,0,5,5
Glendaly,F,100,5,0,5
Glenita,F,100,5,0,5
Glenne,F,100,5,0,5
Glo,F,100,5,0,5
Gloribel,F,100,5,0,5
Glorya,F,100,5,0,5
Gobind,M,100,0,5,5
Goble,M,100,0,5,5
Godrick,M,100,0,5,5
Gohar,F,100,5,0,5
Gomez,M,100,0,5,5
Gonzella,F,100,5,0,5
Goodness,F,100,5,0,5
Gordie,M,100,0,5,5
Gorje,M,100,0,5,5
Goshen,M,100,0,5,5
Governor,M,100,0,5,5
Govinda,M,100,0,5,5
Gowtham,M,100,0,5,5
Grabriela,F,100,5,0,5
Gracely,F,100,5,0,5
Gradey,M,100,0,5,5
Graer,M,100,0,5,5
Graesen,M,100,0,5,5
Graice,F,100,5,0,5
Grainne,F,100,5,0,5
Grantlee,M,100,0,5,5
Grasen,M,100,0,5,5
Graves,M,100,0,5,5
Graylynn,F,100,5,0,5
Graysie,F,100,5,0,5
Greenlea,F,100,5,0,5
Greidi,F,100,5,0,5
Greory,M,100,0,5,5
Gresia,F,100,5,0,5
Gretchan,F,100,5,0,5
Gretell,F,100,5,0,5
Greylynn,F,100,5,0,5
Griffey,M,100,0,5,5
Grigory,M,100,0,5,5
Grishma,F,100,5,0,5
Grzegorz,M,100,0,5,5
Guadlupe,F,100,5,0,5
Guardian,M,100,0,5,5
Gudelia,F,100,5,0,5
Gudrun,F,100,5,0,5
Guenevere,F,100,5,0,5
Guenther,M,100,0,5,5
Guerline,F,100,5,0,5
Guerry,M,100,0,5,5
Guinivere,F,100,5,0,5
Guinness,M,100,0,5,5
Guinnevere,F,100,5,0,5
Gurbani,F,100,5,0,5
Gurkamal,M,100,0,5,5
Gurnaaz,F,100,5,0,5
Gurseerat,F,100,5,0,5
Gursimar,F,100,5,0,5
Gurvinder,M,100,0,5,5
Guyann,F,100,5,0,5
Gwendlyon,F,100,5,0,5
Gwendoly,F,100,5,0,5
Gweneviere,F,100,5,0,5
Gwenyvere,F,100,5,0,5
Gwynda,F,100,5,0,5
Gyllian,F,100,5,0,5
Haaken,M,100,0,5,5
Haania,F,100,5,0,5
Haasan,M,100,0,5,5
Haby,F,100,5,0,5
Haddasah,F,100,5,0,5
Hadie,F,100,5,0,5
Hadilyn,F,100,5,0,5
Hadleyann,F,100,5,0,5
Hadya,F,100,5,0,5
Hael,M,100,0,5,5
Haevynn,F,100,5,0,5
Hafeeza,F,100,5,0,5
Haithem,M,100,0,5,5
Haji,M,100,0,5,5
Hajin,M,100,0,5,5
Haku,M,100,0,5,5
Haleah,F,100,5,0,5
Haleh,F,100,5,0,5
Halema,F,100,5,0,5
Halimatou,F,100,5,0,5
Hallel,F,100,5,0,5
Halleli,F,100,5,0,5
Hamidou,M,100,0,5,5
Hamsika,F,100,5,0,5
Hamze,M,100,0,5,5
Hanai,F,100,5,0,5
Hanalee,F,100,5,0,5
Hanane,F,100,5,0,5
Handy,F,100,5,0,5
Hannahlynn,F,100,5,0,5
Hanniel,M,100,0,5,5
Hansford,M,100,0,5,5
Hantz,M,100,0,5,5
Hany,M,100,0,5,5
Hardison,M,100,0,5,5
Harjaap,M,100,0,5,5
Harkaran,M,100,0,5,5
Harle,M,100,0,5,5
Harlequinn,F,100,5,0,5
Harliee,F,100,5,0,5
Harmany,F,100,5,0,5
Harneet,F,100,5,0,5
Haroldo,M,100,0,5,5
Harpar,F,100,5,0,5
Harpyr,F,100,5,0,5
Harrisen,M,100,0,5,5
Harrisson,M,100,0,5,5
Harseerat,F,100,5,0,5
Harshveer,M,100,0,5,5
Harsimar,M,100,0,5,5
Hartli,F,100,5,0,5
Hartly,F,100,5,0,5
Hartman,M,100,0,5,5
Haruko,F,100,5,0,5
Haruna,F,100,5,0,5
Harve,M,100,0,5,5
Harvel,M,100,0,5,5
Harvir,M,100,0,5,5
Hasanat,F,100,5,0,5
Hasin,M,100,0,5,5
Hasmik,F,100,5,0,5
Hassam,M,100,0,5,5
Hastiin,M,100,0,5,5
Hatsumi,F,100,5,0,5
Hatti,F,100,5,0,5
Havanah,F,100,5,0,5
Havery,M,100,0,5,5
Havier,M,100,0,5,5
Havok,M,100,0,5,5
Hawaii,F,100,5,0,5
Hawley,F,100,5,0,5
Hayliegh,F,100,5,0,5
Hayoon,F,100,5,0,5
Hayoung,F,100,5,0,5
Hayston,M,100,0,5,5
Hayvin,F,100,5,0,5
Hayzlie,F,100,5,0,5
Hazelmarie,F,100,5,0,5
Hazleigh,F,100,5,0,5
Heart,F,100,5,0,5
Heartly,F,100,5,0,5
Heathcliff,M,100,0,5,5
Heathe,F,100,5,0,5
Heatherlyn,F,100,5,0,5
Heathyr,F,100,5,0,5
Heavon,F,100,5,0,5
Heberto,M,100,0,5,5
Hedieh,F,100,5,0,5
Hee,F,100,5,0,5
Heida,F,100,5,0,5
Heiden,M,100,0,5,5
Heidiann,F,100,5,0,5
Heidimarie,F,100,5,0,5
Heilyn,F,100,5,0,5
Hektor,M,100,0,5,5
Heleana,F,100,5,0,5
Heleyna,F,100,5,0,5
Hellena,F,100,5,0,5
Helton,M,100,0,5,5
Hemali,F,100,5,0,5
Hemanth,M,100,0,5,5
Hend,F,100,5,0,5
Hennesie,F,100,5,0,5
Henon,M,100,0,5,5
Henrene,F,100,5,0,5
Henrey,M,100,0,5,5
Henrine,F,100,5,0,5
Henritta,F,100,5,0,5
Herbey,M,100,0,5,5
Herculano,M,100,0,5,5
Heri,M,100,0,5,5
Herica,F,100,5,0,5
Hermenia,F,100,5,0,5
Hernesto,M,100,0,5,5
Heven,F,100,5,0,5
Hevin,F,100,5,0,5
Hezakiah,M,100,0,5,5
Hidayah,F,100,5,0,5
Hiilei,F,100,5,0,5
Hikaru,M,100,0,5,5
Hilal,F,100,5,0,5
Hillman,M,100,0,5,5
Hillory,F,100,5,0,5
Hinson,M,100,0,5,5
Hipolita,F,100,5,0,5
Hiroko,F,100,5,0,5
Hirsch,M,100,0,5,5
Hitha,F,100,5,0,5
Hiwot,F,100,5,0,5
Hli,F,100,5,0,5
Hodalis,F,100,5,0,5
Hodari,M,100,0,5,5
Holder,M,100,0,5,5
Holdin,M,100,0,5,5
Holsten,M,100,0,5,5
Hongyu,M,100,0,5,5
Honore,F,100,5,0,5
Honoria,F,100,5,0,5
Hopie,F,100,5,0,5
Horald,M,100,0,5,5
Horton,M,100,0,5,5
Hoskie,M,100,0,5,5
Hossein,M,100,0,5,5
Hovanes,M,100,0,5,5
Hovsep,M,100,0,5,5
Howland,M,100,0,5,5
Hriday,M,100,0,5,5
Hridya,F,100,5,0,5
Hriyaan,M,100,0,5,5
Hudeyfa,M,100,0,5,5
Hudsynn,F,100,5,0,5
Hudy,F,100,5,0,5
Huel,M,100,0,5,5
Hughey,M,100,0,5,5
Humayra,F,100,5,0,5
Huzaifah,M,100,0,5,5
Hylan,M,100,0,5,5
Hyson,M,100,0,5,5
Hyung,M,100,0,5,5
Ianmichael,M,100,0,5,5
Iayana,F,100,5,0,5
Iba,F,100,5,0,5
Ibaad,M,100,0,5,5
Ibis,F,100,5,0,5
Ibiza,F,100,5,0,5
Ibon,F,100,5,0,5
Ibtihal,F,100,5,0,5
Icarus,M,100,0,5,5
Icee,F,100,5,0,5
Iceis,F,100,5,0,5
Ichiro,M,100,0,5,5
Idalynn,F,100,5,0,5
Iddo,M,100,0,5,5
Idelia,F,100,5,0,5
Idhant,M,100,0,5,5
Idrena,F,100,5,0,5
Ien,M,100,0,5,5
Iestyn,M,100,0,5,5
Iftu,F,100,5,0,5
Iiyana,F,100,5,0,5
Ijah,F,100,5,0,5
Ijaz,M,100,0,5,5
Ikie,M,100,0,5,5
Ikra,F,100,5,0,5
Ileia,F,100,5,0,5
Ilhana,F,100,5,0,5
Iliani,F,100,5,0,5
Ilicia,F,100,5,0,5
Iline,F,100,5,0,5
Ilise,F,100,5,0,5
Illia,F,100,5,0,5
Illyas,M,100,0,5,5
Ilsy,F,100,5,0,5
Ilysa,F,100,5,0,5
Ilze,F,100,5,0,5
Imanee,F,100,5,0,5
Imena,F,100,5,0,5
Imiyah,F,100,5,0,5
Imron,M,100,0,5,5
Imyah,F,100,5,0,5
Inaky,M,100,0,5,5
Inass,F,100,5,0,5
Inayat,F,100,5,0,5
Inetha,F,100,5,0,5
Iniko,M,100,0,5,5
Innis,M,100,0,5,5
Inoke,M,100,0,5,5
Insiyah,F,100,5,0,5
Ioana,F,100,5,0,5
Iokepa,M,100,0,5,5
Iory,M,100,0,5,5
Iqlas,F,100,5,0,5
Irah,F,100,5,0,5
Iralynn,F,100,5,0,5
Irbin,M,100,0,5,5
Ireana,F,100,5,0,5
Irelan,F,100,5,0,5
Iren,M,100,0,5,5
Ireon,M,100,0,5,5
Iresha,F,100,5,0,5
Iric,M,100,0,5,5
Iriee,F,100,5,0,5
Irit,F,100,5,0,5
Irna,F,100,5,0,5
Isabelita,F,100,5,0,5
Isabelo,M,100,0,5,5
Isah,M,100,0,5,5
Isahbella,F,100,5,0,5
Isahias,M,100,0,5,5
Isajah,M,100,0,5,5
Isalena,F,100,5,0,5
Isamari,F,100,5,0,5
Isamu,M,100,0,5,5
Isana,F,100,5,0,5
Isandro,M,100,0,5,5
Isay,M,100,0,5,5
Isen,M,100,0,5,5
Ises,F,100,5,0,5
Ishak,M,100,0,5,5
Ishaun,M,100,0,5,5
Ishbel,F,100,5,0,5
Ishraq,M,100,0,5,5
Ishta,F,100,5,0,5
Isias,M,100,0,5,5
Isidor,M,100,0,5,5
Isioma,F,100,5,0,5
Iskandar,M,100,0,5,5
Ismat,F,100,5,0,5
Israe,F,100,5,0,5
Israela,F,100,5,0,5
Issabela,F,100,5,0,5
Issabell,F,100,5,0,5
Issack,M,100,0,5,5
Isse,M,100,0,5,5
Iszak,M,100,0,5,5
Italya,F,100,5,0,5
Itayetzi,F,100,5,0,5
Ithalia,F,100,5,0,5
Itiel,M,100,0,5,5
Itzela,F,100,5,0,5
Itzy,F,100,5,0,5
Ivary,F,100,5,0,5
Ives,M,100,0,5,5
Ivymarie,F,100,5,0,5
Ivyona,F,100,5,0,5
Iyania,F,100,5,0,5
Iylan,F,100,5,0,5
Izah,M,100,0,5,5
Izaha,M,100,0,5,5
Izahia,M,100,0,5,5
Izalea,F,100,5,0,5
Izaria,F,100,5,0,5
Izeal,M,100,0,5,5
Izellah,F,100,5,0,5
Izna,F,100,5,0,5
Izsak,M,100,0,5,5
Izybella,F,100,5,0,5
Izzaiah,M,100,0,5,5
Izzybella,F,100,5,0,5
Jaad,M,100,0,5,5
Jaafar,M,100,0,5,5
Jaason,M,100,0,5,5
Jabaris,M,100,0,5,5
Jabbaar,M,100,0,5,5
Jaber,M,100,0,5,5
Jabora,F,100,5,0,5
Jabreon,M,100,0,5,5
Jabriah,F,100,5,0,5
Jacab,M,100,0,5,5
Jacaiden,M,100,0,5,5
Jacaleb,M,100,0,5,5
Jacarie,M,100,0,5,5
Jacarious,M,100,0,5,5
Jacarla,F,100,5,0,5
Jacarter,M,100,0,5,5
Jacauri,M,100,0,5,5
Jacaury,M,100,0,5,5
Jacbo,M,100,0,5,5
Jaceline,F,100,5,0,5
Jacelle,F,100,5,0,5
Jacere,M,100,0,5,5
Jaceton,M,100,0,5,5
Jacine,F,100,5,0,5
Jacione,M,100,0,5,5
Jaciya,F,100,5,0,5
Jackhenry,M,100,0,5,5
Jackielyn,F,100,5,0,5
Jacklon,F,100,5,0,5
Jacksin,M,100,0,5,5
Jaco,M,100,0,5,5
Jacobanthony,M,100,0,5,5
Jacobian,M,100,0,5,5
Jacole,F,100,5,0,5
Jacopo,M,100,0,5,5
Jacore,M,100,0,5,5
Jacorri,M,100,0,5,5
Jacoub,M,100,0,5,5
Jacqualyne,F,100,5,0,5
Jacquelinne,F,100,5,0,5
Jacquin,M,100,0,5,5
Jacquisha,F,100,5,0,5
Jacqulene,F,100,5,0,5
Jacynda,F,100,5,0,5
Jadaliz,F,100,5,0,5
Jadarrious,M,100,0,5,5
Jadasia,F,100,5,0,5
Jadayah,F,100,5,0,5
Jadean,F,100,5,0,5
Jadeen,F,100,5,0,5
Jadel,M,100,0,5,5
Jademarie,F,100,5,0,5
Jadeon,M,100,0,5,5
Jadielys,F,100,5,0,5
Jadir,M,100,0,5,5
Jadiss,M,100,0,5,5
Jadlyn,F,100,5,0,5
Jadonna,F,100,5,0,5
Jadonte,M,100,0,5,5
Jadyne,F,100,5,0,5
Jaeana,F,100,5,0,5
Jaeceion,M,100,0,5,5
Jaecia,F,100,5,0,5
Jaedalyn,F,100,5,0,5
Jaekob,M,100,0,5,5
Jaelea,F,100,5,0,5
Jaeline,F,100,5,0,5
Jaell,M,100,0,5,5
Jaemie,F,100,5,0,5
Jaems,M,100,0,5,5
Jaeon,M,100,0,5,5
Jaeron,M,100,0,5,5
Jaevaughn,M,100,0,5,5
Jaeven,M,100,0,5,5
Jagan,M,100,0,5,5
Jagdeep,M,100,0,5,5
Jaguar,M,100,0,5,5
Jagur,M,100,0,5,5
Jahaida,F,100,5,0,5
Jahair,M,100,0,5,5
Jaharri,M,100,0,5,5
Jahaun,M,100,0,5,5
Jahaven,M,100,0,5,5
Jahaziah,M,100,0,5,5
Jahdae,F,100,5,0,5
Jahlea,F,100,5,0,5
Jahliel,M,100,0,5,5
Jahlique,M,100,0,5,5
Jahmaal,M,100,0,5,5
Jahmali,M,100,0,5,5
Jahmiah,F,100,5,0,5
Jahmira,F,100,5,0,5
Jahmyah,F,100,5,0,5
Jahniece,F,100,5,0,5
Jahod,M,100,0,5,5
Jahri,M,100,0,5,5
Jahsi,M,100,0,5,5
Jahwan,M,100,0,5,5
Jahya,F,100,5,0,5
Jahzarah,F,100,5,0,5
Jahzlynn,F,100,5,0,5
Jailei,F,100,5,0,5
Jaili,F,100,5,0,5
Jailia,F,100,5,0,5
Jailynne,F,100,5,0,5
Jaimelynn,F,100,5,0,5
Jaimey,F,100,5,0,5
Jaimir,M,100,0,5,5
Jainah,F,100,5,0,5
Jainil,M,100,0,5,5
Jaiseon,M,100,0,5,5
Jaisley,F,100,5,0,5
Jaivin,M,100,0,5,5
Jaiylah,F,100,5,0,5
Jaja,M,100,0,5,5
Jajaun,M,100,0,5,5
Jajuane,M,100,0,5,5
Jakalah,F,100,5,0,5
Jakalya,F,100,5,0,5
Jakaree,M,100,0,5,5
Jakarious,M,100,0,5,5
Jakavian,M,100,0,5,5
Jakeith,M,100,0,5,5
Jakenya,F,100,5,0,5
Jakeriya,F,100,5,0,5
Jakevion,M,100,0,5,5
Jakeyla,F,100,5,0,5
Jakhya,F,100,5,0,5
Jakila,F,100,5,0,5
Jakima,F,100,5,0,5
Jaks,M,100,0,5,5
Jaksen,M,100,0,5,5
Jaksyn,M,100,0,5,5
Jakylee,F,100,5,0,5
Jakyren,M,100,0,5,5
Jakyriah,F,100,5,0,5
Jakyrin,M,100,0,5,5
Jalaila,F,100,5,0,5
Jalane,F,100,5,0,5
Jalaysha,F,100,5,0,5
Jalayshia,F,100,5,0,5
Jaleisha,F,100,5,0,5
Jalem,M,100,0,5,5
Jalencia,F,100,5,0,5
Jalenn,M,100,0,5,5
Jaleon,M,100,0,5,5
Jalese,F,100,5,0,5
Jalexa,F,100,5,0,5
Jalexie,F,100,5,0,5
Jalijah,M,100,0,5,5
Jalishia,F,100,5,0,5
Jalita,F,100,5,0,5
Jaliyha,F,100,5,0,5
Jallen,M,100,0,5,5
Jalonni,M,100,0,5,5
Jalycia,F,100,5,0,5
Jalyssia,F,100,5,0,5
Jamae,F,100,5,0,5
Jamaika,F,100,5,0,5
Jaman,M,100,0,5,5
Jamarah,F,100,5,0,5
Jamard,M,100,0,5,5
Jamarey,M,100,0,5,5
Jamariona,F,100,5,0,5
Jamarqus,M,100,0,5,5
Jamarre,M,100,0,5,5
Jamarrie,M,100,0,5,5
Jamarris,M,100,0,5,5
Jamayra,F,100,5,0,5
Jameerah,F,100,5,0,5
Jameiah,F,100,5,0,5
Jamequa,F,100,5,0,5
Jamerian,M,100,0,5,5
Jamesena,F,100,5,0,5
Jamesmatthew,M,100,0,5,5
Jamess,M,100,0,5,5
Jamessa,F,100,5,0,5
Jametrice,F,100,5,0,5
Jamette,F,100,5,0,5
Jamias,M,100,0,5,5
Jamiela,F,100,5,0,5
Jamiley,F,100,5,0,5
Jamirrah,F,100,5,0,5
Jamita,F,100,5,0,5
Jamoria,F,100,5,0,5
Janaea,F,100,5,0,5
Janahla,F,100,5,0,5
Janaii,F,100,5,0,5
Janalise,F,100,5,0,5
Janann,F,100,5,0,5
Janara,F,100,5,0,5
Janat,F,100,5,0,5
Janayiah,F,100,5,0,5
Jandee,F,100,5,0,5
Jandre,M,100,0,5,5
Jandriel,M,100,0,5,5
Janeanne,F,100,5,0,5
Janeeka,F,100,5,0,5
Janeesa,F,100,5,0,5
Janeia,F,100,5,0,5
Janeicia,F,100,5,0,5
Janeiry,F,100,5,0,5
Janellys,F,100,5,0,5
Janelyz,F,100,5,0,5
Janequa,F,100,5,0,5
Janick,M,100,0,5,5
Janieya,F,100,5,0,5
Janiha,F,100,5,0,5
Janill,F,100,5,0,5
Janko,M,100,0,5,5
Janluca,M,100,0,5,5
Janlucas,M,100,0,5,5
Janluis,M,100,0,5,5
Janlyn,F,100,5,0,5
Jannali,F,100,5,0,5
Jannalyn,F,100,5,0,5
Janni,F,100,5,0,5
Janorris,M,100,0,5,5
Janos,M,100,0,5,5
Janovia,F,100,5,0,5
Janvier,F,100,5,0,5
Janyne,F,100,5,0,5
Janzen,M,100,0,5,5
Japnoor,F,100,5,0,5
Jaqlyn,F,100,5,0,5
Jaqua,M,100,0,5,5
Jaqualine,F,100,5,0,5
Jaquella,F,100,5,0,5
Jaquinta,F,100,5,0,5
Jaquory,M,100,0,5,5
Jaqwon,M,100,0,5,5
Jarade,M,100,0,5,5
Jarai,M,100,0,5,5
Jardan,M,100,0,5,5
Jardyn,F,100,5,0,5
Jare,M,100,0,5,5
Jareem,M,100,0,5,5
Jaretsy,F,100,5,0,5
Jarette,M,100,0,5,5
Jarhett,M,100,0,5,5
Jarianna,F,100,5,0,5
Jarielis,F,100,5,0,5
Jariell,M,100,0,5,5
Jarlene,F,100,5,0,5
Jarlin,F,100,5,0,5
Jarmaris,M,100,0,5,5
Jarnell,M,100,0,5,5
Jarquis,M,100,0,5,5
Jarrah,F,100,5,0,5
Jarrion,M,100,0,5,5
Jarris,M,100,0,5,5
Jarrison,M,100,0,5,5
Jartavis,M,100,0,5,5
Jartavius,M,100,0,5,5
Jarvas,M,100,0,5,5
Jarvon,M,100,0,5,5
Jasaan,M,100,0,5,5
Jascha,M,100,0,5,5
Jashanna,F,100,5,0,5
Jashiya,F,100,5,0,5
Jashone,M,100,0,5,5
Jashonna,F,100,5,0,5
Jashya,F,100,5,0,5
Jashyra,F,100,5,0,5
Jasibe,F,100,5,0,5
Jasik,M,100,0,5,5
Jasirah,F,100,5,0,5
Jaskiran,F,100,5,0,5
Jasleene,F,100,5,0,5
Jasmien,F,100,5,0,5
Jasmijn,F,100,5,0,5
Jasna,F,100,5,0,5
Jaspal,M,100,0,5,5
Jassar,M,100,0,5,5
Jaswinder,M,100,0,5,5
Jasyiah,M,100,0,5,5
Jatarius,M,100,0,5,5
Jatasha,F,100,5,0,5
Jaten,M,100,0,5,5
Jathziry,F,100,5,0,5
Jatiana,F,100,5,0,5
Jatina,F,100,5,0,5
Jatiya,F,100,5,0,5
Jaton,F,100,5,0,5
Jatwan,M,100,0,5,5
Jaurice,M,100,0,5,5
Jaustin,M,100,0,5,5
Javale,M,100,0,5,5
Javaria,F,100,5,0,5
Javarous,M,100,0,5,5
Javean,M,100,0,5,5
Javeria,F,100,5,0,5
Javeya,F,100,5,0,5
Javez,M,100,0,5,5
Javianna,F,100,5,0,5
Javiera,F,100,5,0,5
Javione,M,100,0,5,5
Javyon,M,100,0,5,5
Jawaher,F,100,5,0,5
Jawanza,M,100,0,5,5
Jawone,M,100,0,5,5
Jaxel,M,100,0,5,5
Jaxlyn,F,100,5,0,5
Jaxom,M,100,0,5,5
Jaxs,M,100,0,5,5
Jaxsten,M,100,0,5,5
Jaxstin,M,100,0,5,5
Jayanah,F,100,5,0,5
Jayannah,F,100,5,0,5
Jayanne,F,100,5,0,5
Jaybriel,M,100,0,5,5
Jayc,M,100,0,5,5
Jaycek,M,100,0,5,5
Jayceonna,F,100,5,0,5
Jaydaliz,F,100,5,0,5
Jaydel,M,100,0,5,5
Jaydenalexander,M,100,0,5,5
Jaydenmichael,M,100,0,5,5
Jaydia,F,100,5,0,5
Jaydiel,M,100,0,5,5
Jaydun,M,100,0,5,5
Jayelin,M,100,0,5,5
Jayjuan,M,100,0,5,5
Jaykin,M,100,0,5,5
Jaykon,M,100,0,5,5
Jaykwon,M,100,0,5,5
Jaylaa,F,100,5,0,5
Jaylann,F,100,5,0,5
Jaylein,F,100,5,0,5
Jaylex,M,100,0,5,5
Jaylianiz,F,100,5,0,5
Jayliannie,F,100,5,0,5
Jaymis,M,100,0,5,5
Jaynalis,F,100,5,0,5
Jayni,F,100,5,0,5
Jaynice,F,100,5,0,5
Jayqwan,M,100,0,5,5
Jaysan,M,100,0,5,5
Jaytin,M,100,0,5,5
Jayvius,M,100,0,5,5
Jayvn,M,100,0,5,5
Jayziel,M,100,0,5,5
Jazabella,F,100,5,0,5
Jazaiya,F,100,5,0,5
Jazamine,F,100,5,0,5
Jazavian,M,100,0,5,5
Jazer,M,100,0,5,5
Jazib,M,100,0,5,5
Jazlee,F,100,5,0,5
Jazleene,F,100,5,0,5
Jazsmine,F,100,5,0,5
Jazyia,F,100,5,0,5
Jazzmene,F,100,5,0,5
Jazzmon,F,100,5,0,5
Jda,F,100,5,0,5
Jdah,F,100,5,0,5
Jdynn,M,100,0,5,5
Jeanea,F,100,5,0,5
Jeaneane,F,100,5,0,5
Jeanessa,F,100,5,0,5
Jeanete,F,100,5,0,5
Jeaneth,F,100,5,0,5
Jeanina,F,100,5,0,5
Jeanise,F,100,5,0,5
Jeanitta,F,100,5,0,5
Jeanjacques,M,100,0,5,5
Jeanmichael,M,100,0,5,5
Jeannell,F,100,5,0,5
Jecory,M,100,0,5,5
Jee,F,100,5,0,5
Jefery,M,100,0,5,5
Jeffray,M,100,0,5,5
Jeffy,M,100,0,5,5
Jehlani,M,100,0,5,5
Jeidan,M,100,0,5,5
Jeidyn,M,100,0,5,5
Jeileen,F,100,5,0,5
Jeilene,F,100,5,0,5
Jeimi,F,100,5,0,5
Jeinny,F,100,5,0,5
Jekari,M,100,0,5,5
Jelaine,F,100,5,0,5
Jelanie,F,100,5,0,5
Jeleah,F,100,5,0,5
Jelesia,F,100,5,0,5
Jeliah,F,100,5,0,5
Jelisia,F,100,5,0,5
Jelon,M,100,0,5,5
Jelynn,F,100,5,0,5
Jelyssa,F,100,5,0,5
Jemale,M,100,0,5,5
Jemelle,M,100,0,5,5
Jemere,M,100,0,5,5
Jemichael,M,100,0,5,5
Jemiya,F,100,5,0,5
Jemiyah,F,100,5,0,5
Jemmy,F,100,5,0,5
Jemond,M,100,0,5,5
Jenaiah,F,100,5,0,5
Jenavy,F,100,5,0,5
Jenet,F,100,5,0,5
Jeniene,F,100,5,0,5
Jeniveve,F,100,5,0,5
Jenkins,M,100,0,5,5
Jennabelle,F,100,5,0,5
Jennavicia,F,100,5,0,5
Jennean,F,100,5,0,5
Jennee,F,100,5,0,5
Jennelyn,F,100,5,0,5
Jennesis,F,100,5,0,5
Jennevy,F,100,5,0,5
Jennifere,F,100,5,0,5
Jennille,F,100,5,0,5
Jenniya,F,100,5,0,5
Jentezen,M,100,0,5,5
Jenyah,F,100,5,0,5
Jenyiah,F,100,5,0,5
Jenziel,M,100,0,5,5
Jeovana,F,100,5,0,5
Jeppie,M,100,0,5,5
Jepson,M,100,0,5,5
Jequetta,F,100,5,0,5
Jequita,F,100,5,0,5
Jerail,M,100,0,5,5
Jeraldene,F,100,5,0,5
Jeraldin,F,100,5,0,5
Jeraldo,M,100,0,5,5
Jeramiha,M,100,0,5,5
Jeramiyah,M,100,0,5,5
Jeremiahs,M,100,0,5,5
Jeremyiah,M,100,0,5,5
Jerena,F,100,5,0,5
Jerimiyah,M,100,0,5,5
Jerina,F,100,5,0,5
Jerisha,F,100,5,0,5
Jerit,M,100,0,5,5
Jerita,F,100,5,0,5
Jerius,M,100,0,5,5
Jerjuan,M,100,0,5,5
Jerl,M,100,0,5,5
Jermanee,F,100,5,0,5
Jerme,M,100,0,5,5
Jermeria,F,100,5,0,5
Jermyah,F,100,5,0,5
Jermyra,F,100,5,0,5
Jernei,F,100,5,0,5
Jerrae,F,100,5,0,5
Jerramie,M,100,0,5,5
Jerricho,M,100,0,5,5
Jerrik,M,100,0,5,5
Jerrlyn,F,100,5,0,5
Jerryd,M,100,0,5,5
Jerrye,F,100,5,0,5
Jersiah,M,100,0,5,5
Jeryiah,F,100,5,0,5
Jesean,M,100,0,5,5
Jesha,F,100,5,0,5
Jesie,F,100,5,0,5
Jesikah,F,100,5,0,5
Jesley,F,100,5,0,5
Jessalynne,F,100,5,0,5
Jessca,F,100,5,0,5
Jessiana,F,100,5,0,5
Jessicaanne,F,100,5,0,5
Jessical,F,100,5,0,5
Jessicalee,F,100,5,0,5
Jessican,F,100,5,0,5
Jessicarose,F,100,5,0,5
Jesstine,F,100,5,0,5
Jesusdaniel,M,100,0,5,5
Jesyca,F,100,5,0,5
Jetli,M,100,0,5,5
Jetlyn,F,100,5,0,5
Jettsen,M,100,0,5,5
Jetzabel,F,100,5,0,5
Jeudy,M,100,0,5,5
Jeveah,F,100,5,0,5
Jeveon,M,100,0,5,5
Jevonda,F,100,5,0,5
Jewan,M,100,0,5,5
Jewely,F,100,5,0,5
Jewl,F,100,5,0,5
Jewliana,F,100,5,0,5
Jeylan,M,100,0,5,5
Jeylanie,F,100,5,0,5
Jeylianis,F,100,5,0,5
Jeyline,F,100,5,0,5
Jezell,F,100,5,0,5
Jeziyah,F,100,5,0,5
Jezzel,F,100,5,0,5
Jguadalupe,M,100,0,5,5
Jhai,M,100,0,5,5
Jhalia,F,100,5,0,5
Jhalin,M,100,0,5,5
Jhamal,M,100,0,5,5
Jhared,M,100,0,5,5
Jhasmine,F,100,5,0,5
Jhayce,M,100,0,5,5
Jhayda,F,100,5,0,5
Jhaylen,M,100,0,5,5
Jherrica,F,100,5,0,5
Jhonna,F,100,5,0,5
Jhonnie,M,100,0,5,5
Jhoselin,F,100,5,0,5
Jhoseline,F,100,5,0,5
Jhoselyne,F,100,5,0,5
Jhosselyn,F,100,5,0,5
Jhovana,F,100,5,0,5
Jiani,F,100,5,0,5
Jiaqi,F,100,5,0,5
Jiara,F,100,5,0,5
Jiavanna,F,100,5,0,5
Jiayi,F,100,5,0,5
Jibrail,M,100,0,5,5
Jihoo,M,100,0,5,5
Jillanne,F,100,5,0,5
Jilliam,F,100,5,0,5
Jimari,M,100,0,5,5
Jimmia,F,100,5,0,5
Jimmya,F,100,5,0,5
Jimya,F,100,5,0,5
Jinal,F,100,5,0,5
Jinayah,F,100,5,0,5
Jinu,M,100,0,5,5
Jioni,M,100,0,5,5
Jionna,F,100,5,0,5
Jiovana,F,100,5,0,5
Jisoo,F,100,5,0,5
Jiyan,M,100,0,5,5
Jizele,F,100,5,0,5
Jkai,M,100,0,5,5
Jkhari,M,100,0,5,5
Jlaya,F,100,5,0,5
Jliyah,F,100,5,0,5
Jmarcus,M,100,0,5,5
Jmichael,M,100,0,5,5
Jmyra,F,100,5,0,5
Jnaya,F,100,5,0,5
Jnyla,F,100,5,0,5
Joahan,M,100,0,5,5
Joahn,M,100,0,5,5
Joahnna,F,100,5,0,5
Joanita,F,100,5,0,5
Joany,F,100,5,0,5
Jocabeth,F,100,5,0,5
Jocalynn,F,100,5,0,5
Jocinda,F,100,5,0,5
Joda,F,100,5,0,5
Jodiel,M,100,0,5,5
Jodyann,F,100,5,0,5
Joeanne,F,100,5,0,5
Joed,M,100,0,5,5
Joela,F,100,5,0,5
Joeliel,M,100,0,5,5
Joelys,F,100,5,0,5
Jogina,F,100,5,0,5
Johnas,M,100,0,5,5
Johnaven,M,100,0,5,5
Johnavin,M,100,0,5,5
Johnavon,M,100,0,5,5
Johncarter,M,100,0,5,5
Johneka,F,100,5,0,5
Johneshia,F,100,5,0,5
Johnia,F,100,5,0,5
Johniah,F,100,5,0,5
Johnine,F,100,5,0,5
Johnluis,M,100,0,5,5
Johnnathon,M,100,0,5,5
Johnnel,M,100,0,5,5
Johnnita,F,100,5,0,5
Johnpeter,M,100,0,5,5
Johnray,M,100,0,5,5
Johnrichard,M,100,0,5,5
Johnwesley,M,100,0,5,5
Johnye,F,100,5,0,5
Johrdan,M,100,0,5,5
Joiya,F,100,5,0,5
Jolana,F,100,5,0,5
Jolecia,F,100,5,0,5
Joleesa,F,100,5,0,5
Jolei,F,100,5,0,5
Jolen,M,100,0,5,5
Joleta,F,100,5,0,5
Jolia,F,100,5,0,5
Jolieann,F,100,5,0,5
Jollene,F,100,5,0,5
Jolonda,F,100,5,0,5
Jomara,F,100,5,0,5
Jomeka,F,100,5,0,5
Jonathanmichael,M,100,0,5,5
Joneen,F,100,5,0,5
Joneer,F,100,5,0,5
Jonice,F,100,5,0,5
Joniqua,F,100,5,0,5
Jonnatan,M,100,0,5,5
Jonnay,F,100,5,0,5
Jonnesha,F,100,5,0,5
Jonpierre,M,100,0,5,5
Jonquel,M,100,0,5,5
Jonson,M,100,0,5,5
Jontaye,M,100,0,5,5
Jontue,M,100,0,5,5
Jonya,F,100,5,0,5
Joo,M,100,0,5,5
Joplyn,F,100,5,0,5
Joquita,F,100,5,0,5
Jorddy,M,100,0,5,5
Jorga,F,100,5,0,5
Jorgie,F,100,5,0,5
Jorita,F,100,5,0,5
Jorman,M,100,0,5,5
Jorome,M,100,0,5,5
Jos,M,100,0,5,5
Josalina,F,100,5,0,5
Josaline,F,100,5,0,5
Josanna,F,100,5,0,5
Josealejandro,M,100,0,5,5
Joseandres,M,100,0,5,5
Joseduardo,M,100,0,5,5
Josefernando,M,100,0,5,5
Josejesus,M,100,0,5,5
Josephanthony,M,100,0,5,5
Josephdaniel,M,100,0,5,5
Joses,M,100,0,5,5
Josett,F,100,5,0,5
Joshalynn,F,100,5,0,5
Joshewa,M,100,0,5,5
Joshika,F,100,5,0,5
Joshlin,F,100,5,0,5
Joshuaaaron,M,100,0,5,5
Joshuadavid,M,100,0,5,5
Joshuajay,M,100,0,5,5
Joshuaryan,M,100,0,5,5
Joshuea,M,100,0,5,5
Joshuia,M,100,0,5,5
Josielynn,F,100,5,0,5
Josine,F,100,5,0,5
Josiphine,F,100,5,0,5
Josline,F,100,5,0,5
Joslyne,F,100,5,0,5
Josmel,M,100,0,5,5
Jossimar,M,100,0,5,5
Journeigh,F,100,5,0,5
Jovane,M,100,0,5,5
Jovaun,M,100,0,5,5
Jovey,F,100,5,0,5
Jovianna,F,100,5,0,5
Jovohn,M,100,0,5,5
Jovonda,F,100,5,0,5
Jowharah,F,100,5,0,5
Joyden,F,100,5,0,5
Jozeph,M,100,0,5,5
Jozephine,F,100,5,0,5
Jraya,F,100,5,0,5
Jshin,M,100,0,5,5
Juancarlo,M,100,0,5,5
Juanitta,F,100,5,0,5
Juanpedro,M,100,0,5,5
Juanramon,M,100,0,5,5
Juanye,M,100,0,5,5
Judianne,F,100,5,0,5
Judythe,F,100,5,0,5
Jugraj,M,100,0,5,5
Juhee,F,100,5,0,5
Juile,F,100,5,0,5
Juilianna,F,100,5,0,5
Julana,F,100,5,0,5
Julani,F,100,5,0,5
Julayne,F,100,5,0,5
Julep,F,100,5,0,5
Juliaette,F,100,5,0,5
Juliamarie,F,100,5,0,5
Juliannie,F,100,5,0,5
Julianys,F,100,5,0,5
Julica,F,100,5,0,5
Julicia,F,100,5,0,5
Julivette,F,100,5,0,5
Julliette,F,100,5,0,5
Jumal,M,100,0,5,5
Jumanne,M,100,0,5,5
Junae,F,100,5,0,5
Junah,M,100,0,5,5
Junayd,M,100,0,5,5
Junea,F,100,5,0,5
Junella,F,100,5,0,5
Junelle,F,100,5,0,5
Junhao,M,100,0,5,5
Junice,F,100,5,0,5
Junjie,M,100,0,5,5
Junxi,M,100,0,5,5
Junya,F,100,5,0,5
Jura,F,100,5,0,5
Jurell,M,100,0,5,5
Juris,M,100,0,5,5
Jurita,F,100,5,0,5
Justinmichael,M,100,0,5,5
Justy,F,100,5,0,5
Jusuf,M,100,0,5,5
Juztin,M,100,0,5,5
Jven,M,100,0,5,5
Jvonte,M,100,0,5,5
Jwana,F,100,5,0,5
Jyah,F,100,5,0,5
Jykeria,F,100,5,0,5
Jylen,M,100,0,5,5
Jylene,F,100,5,0,5
Jyme,F,100,5,0,5
Jynelle,F,100,5,0,5
Jynessa,F,100,5,0,5
Jyrah,F,100,5,0,5
Jyshawn,M,100,0,5,5
Kabren,M,100,0,5,5
Kaceson,M,100,0,5,5
Kaceyon,M,100,0,5,5
Kadaija,F,100,5,0,5
Kadari,M,100,0,5,5
Kadarious,M,100,0,5,5
Kaddy,F,100,5,0,5
Kadeidra,F,100,5,0,5
Kadenze,F,100,5,0,5
Kadesh,M,100,0,5,5
Kadesia,F,100,5,0,5
Kado,M,100,0,5,5
Kaedynn,F,100,5,0,5
Kaeman,M,100,0,5,5
Kaen,M,100,0,5,5
Kaena,F,100,5,0,5
Kaenon,M,100,0,5,5
Kaery,F,100,5,0,5
Kaeshon,M,100,0,5,5
Kaesin,M,100,0,5,5
Kaetlynn,F,100,5,0,5
Kager,M,100,0,5,5
Kahden,M,100,0,5,5
Kahley,F,100,5,0,5
Kahlif,M,100,0,5,5
Kahmel,M,100,0,5,5
Kahmiyah,F,100,5,0,5
Kahmyah,F,100,5,0,5
Kahtai,M,100,0,5,5
Kahyla,F,100,5,0,5
Kaian,M,100,0,5,5
Kaidee,F,100,5,0,5
Kaido,M,100,0,5,5
Kaii,M,100,0,5,5
Kailanie,F,100,5,0,5
Kailanni,F,100,5,0,5
Kainani,F,100,5,0,5
Kainin,M,100,0,5,5
Kairen,M,100,0,5,5
Kaisan,M,100,0,5,5
Kaisin,M,100,0,5,5
Kaitey,F,100,5,0,5
Kaithleen,F,100,5,0,5
Kaithlynn,F,100,5,0,5
Kaiti,F,100,5,0,5
Kaityln,F,100,5,0,5
Kaiven,M,100,0,5,5
Kaiwen,M,100,0,5,5
Kaiyana,F,100,5,0,5
Kaiza,F,100,5,0,5
Kaizleigh,F,100,5,0,5
Kajah,F,100,5,0,5
Kajon,M,100,0,5,5
Kakisha,F,100,5,0,5
Kalaiah,F,100,5,0,5
Kalaiyah,F,100,5,0,5
Kalecia,F,100,5,0,5
Kaleef,M,100,0,5,5
Kaleeya,F,100,5,0,5
Kaleina,F,100,5,0,5
Kalell,M,100,0,5,5
Kaleshia,F,100,5,0,5
Kalice,F,100,5,0,5
Kaliea,F,100,5,0,5
Kaliece,F,100,5,0,5
Kalique,M,100,0,5,5
Kalishia,F,100,5,0,5
Kaliyanna,F,100,5,0,5
Kallea,F,100,5,0,5
Kalleen,F,100,5,0,5
Kalliyah,F,100,5,0,5
Kalona,F,100,5,0,5
Kalonie,F,100,5,0,5
Kalun,M,100,0,5,5
Kalynda,F,100,5,0,5
Kalyne,F,100,5,0,5
Kamahri,M,100,0,5,5
Kamai,M,100,0,5,5
Kamaia,F,100,5,0,5
Kamaj,M,100,0,5,5
Kamakana,M,100,0,5,5
Kamarea,F,100,5,0,5
Kamareon,M,100,0,5,5
Kamarin,F,100,5,0,5
Kamarious,M,100,0,5,5
Kamaris,M,100,0,5,5
Kambrya,F,100,5,0,5
Kamery,F,100,5,0,5
Kamiaya,F,100,5,0,5
Kamielle,F,100,5,0,5
Kamiera,F,100,5,0,5
Kamijah,F,100,5,0,5
Kamill,F,100,5,0,5
Kamillia,F,100,5,0,5
Kamilly,F,100,5,0,5
Kamla,F,100,5,0,5
Kamm,M,100,0,5,5
Kamor,F,100,5,0,5
Kamorra,F,100,5,0,5
Kamrey,F,100,5,0,5
Kamsiyochi,F,100,5,0,5
Kamylla,F,100,5,0,5
Kamyrn,F,100,5,0,5
Kanaiya,F,100,5,0,5
Kanaloa,M,100,0,5,5
Kaname,F,100,5,0,5
Kande,F,100,5,0,5
Kandrea,F,100,5,0,5
Kandria,F,100,5,0,5
Kandyse,F,100,5,0,5
Kanedra,F,100,5,0,5
Kanesia,F,100,5,0,5
Kanetra,F,100,5,0,5
Kannin,M,100,0,5,5
Kanta,M,100,0,5,5
Kantrice,F,100,5,0,5
Kany,F,100,5,0,5
Kanyiah,F,100,5,0,5
Kaon,M,100,0,5,5
Karabella,F,100,5,0,5
Karac,M,100,0,5,5
Karaleigh,F,100,5,0,5
Karanda,F,100,5,0,5
Karaya,F,100,5,0,5
Karden,M,100,0,5,5
Kareese,F,100,5,0,5
Karenn,F,100,5,0,5
Karian,F,100,5,0,5
Karidee,F,100,5,0,5
Karieliz,F,100,5,0,5
Karinah,F,100,5,0,5
Karitza,F,100,5,0,5
Karleah,F,100,5,0,5
Karlotta,F,100,5,0,5
Karloz,M,100,0,5,5
Karm,M,100,0,5,5
Karmani,F,100,5,0,5
Karmann,F,100,5,0,5
Karmell,M,100,0,5,5
Karnecia,F,100,5,0,5
Karneisha,F,100,5,0,5
Karrell,M,100,0,5,5
Karrol,F,100,5,0,5
Karryn,F,100,5,0,5
Karvin,M,100,0,5,5
Karyana,F,100,5,0,5
Karyle,F,100,5,0,5
Karyne,F,100,5,0,5
Karyzma,F,100,5,0,5
Kasa,F,100,5,0,5
Kasahn,M,100,0,5,5
Kaselyn,F,100,5,0,5
Kasem,M,100,0,5,5
Kashanna,F,100,5,0,5
Kashari,F,100,5,0,5
Kashema,F,100,5,0,5
Kashika,F,100,5,0,5
Kashonda,F,100,5,0,5
Kashunda,F,100,5,0,5
Kashyra,F,100,5,0,5
Kasimir,M,100,0,5,5
Kassara,F,100,5,0,5
Kassee,F,100,5,0,5
Kastriot,M,100,0,5,5
Kastyn,M,100,0,5,5
Kasydi,F,100,5,0,5
Kasye,F,100,5,0,5
Kata,F,100,5,0,5
Katari,M,100,0,5,5
Katavion,M,100,0,5,5
Katedra,F,100,5,0,5
Katessa,F,100,5,0,5
Kathaline,F,100,5,0,5
Kathelene,F,100,5,0,5
Katheran,F,100,5,0,5
Kathiria,F,100,5,0,5
Kathleenann,F,100,5,0,5
Kathlyne,F,100,5,0,5
Kathrene,F,100,5,0,5
Kathry,F,100,5,0,5
Katieanne,F,100,5,0,5
Katlan,F,100,5,0,5
Katona,F,100,5,0,5
Katrece,F,100,5,0,5
Katrianna,F,100,5,0,5
Katriece,F,100,5,0,5
Katrien,F,100,5,0,5
Katriona,F,100,5,0,5
Katsumi,F,100,5,0,5
Katyana,F,100,5,0,5
Katylyn,F,100,5,0,5
Kaua,M,100,0,5,5
Kaui,F,100,5,0,5
Kausha,F,100,5,0,5
Kaustubh,M,100,0,5,5
Kava,F,100,5,0,5
Kavante,M,100,0,5,5
Kaveen,M,100,0,5,5
Kavien,M,100,0,5,5
Kaviya,F,100,5,0,5
Kaviyon,M,100,0,5,5
Kawai,M,100,0,5,5
Kawaski,M,100,0,5,5
Kawaun,M,100,0,5,5
Kawtar,F,100,5,0,5
Kayanne,F,100,5,0,5
Kaycey,F,100,5,0,5
Kaydia,F,100,5,0,5
Kaydree,F,100,5,0,5
Kaydren,M,100,0,5,5
Kayelin,F,100,5,0,5
Kayelle,F,100,5,0,5
Kaylaa,F,100,5,0,5
Kaylamae,F,100,5,0,5
Kaylany,F,100,5,0,5
Kayleeh,F,100,5,0,5
Kayliani,F,100,5,0,5
Kaylii,F,100,5,0,5
Kaylisa,F,100,5,0,5
Kaylissa,F,100,5,0,5
Kaylix,F,100,5,0,5
Kayliyah,F,100,5,0,5
Kaysaun,M,100,0,5,5
Kayvonna,F,100,5,0,5
Kayzia,F,100,5,0,5
Kazaria,F,100,5,0,5
Kazden,M,100,0,5,5
Kazir,M,100,0,5,5
Kazlyn,F,100,5,0,5
Keaire,F,100,5,0,5
Keaja,F,100,5,0,5
Keajah,F,100,5,0,5
Kealana,F,100,5,0,5
Kealee,F,100,5,0,5
Kealen,M,100,0,5,5
Keali,F,100,5,0,5
Kealohilani,F,100,5,0,5
Keason,M,100,0,5,5
Keavin,M,100,0,5,5
Keaysia,F,100,5,0,5
Keeaira,F,100,5,0,5
Keedra,F,100,5,0,5
Keeland,M,100,0,5,5
Keemon,M,100,0,5,5
Keenyn,M,100,0,5,5
Keeona,F,100,5,0,5
Keeshia,F,100,5,0,5
Keeson,M,100,0,5,5
Keeta,F,100,5,0,5
Keevis,M,100,0,5,5
Keeya,F,100,5,0,5
Keicha,F,100,5,0,5
Keidon,M,100,0,5,5
Keidyn,M,100,0,5,5
Keilanie,F,100,5,0,5
Keileb,M,100,0,5,5
Keiler,M,100,0,5,5
Keilia,F,100,5,0,5
Keimiyah,F,100,5,0,5
Keimoni,M,100,0,5,5
Keiner,M,100,0,5,5
Keiontae,M,100,0,5,5
Keiralee,F,100,5,0,5
Keiren,M,100,0,5,5
Keirnan,M,100,0,5,5
Keirrah,F,100,5,0,5
Keischa,F,100,5,0,5
Keisey,F,100,5,0,5
Keishauna,F,100,5,0,5
Keishona,F,100,5,0,5
Keison,M,100,0,5,5
Keivan,M,100,0,5,5
Keiwan,M,100,0,5,5
Keiyanna,F,100,5,0,5
Kelah,F,100,5,0,5
Kelaia,F,100,5,0,5
Kelanie,F,100,5,0,5
Kelisa,F,100,5,0,5
Kelleye,F,100,5,0,5
Kellise,F,100,5,0,5
Kellynn,F,100,5,0,5
Kelston,M,100,0,5,5
Kemariah,F,100,5,0,5
Kemarian,M,100,0,5,5
Kemarri,M,100,0,5,5
Kemaurie,M,100,0,5,5
Kemaury,M,100,0,5,5
Kemberley,F,100,5,0,5
Kemori,F,100,5,0,5
Kenadey,F,100,5,0,5
Kenaya,F,100,5,0,5
Kendalle,F,100,5,0,5
Kendayl,F,100,5,0,5
Kenderrick,M,100,0,5,5
Kendia,F,100,5,0,5
Kendl,F,100,5,0,5
Kendralyn,F,100,5,0,5
Kendraya,F,100,5,0,5
Kendree,F,100,5,0,5
Kendrie,F,100,5,0,5
Kendrya,F,100,5,0,5
Keneen,M,100,0,5,5
Kenenna,M,100,0,5,5
Kenethia,F,100,5,0,5
Kenetta,F,100,5,0,5
Kenil,M,100,0,5,5
Kenin,M,100,0,5,5
Kenjuan,M,100,0,5,5
Kennison,F,100,5,0,5
Kennlee,F,100,5,0,5
Kennydi,F,100,5,0,5
Kenra,F,100,5,0,5
Kenshawn,M,100,0,5,5
Kensyn,M,100,0,5,5
Kentara,F,100,5,0,5
Kenterrius,M,100,0,5,5
Kentin,M,100,0,5,5
Kently,F,100,5,0,5
Kentral,M,100,0,5,5
Kenyari,F,100,5,0,5
Kenyonna,F,100,5,0,5
Kenyun,M,100,0,5,5
Kenz,F,100,5,0,5
Kenze,F,100,5,0,5
Kenzlei,F,100,5,0,5
Kenzye,F,100,5,0,5
Keondrick,M,100,0,5,5
Keonni,F,100,5,0,5
Keontaye,M,100,0,5,5
Keresa,F,100,5,0,5
Kerian,M,100,0,5,5
Kerr,M,100,0,5,5
Kerrianna,F,100,5,0,5
Kerrilyn,F,100,5,0,5
Kershaw,M,100,0,5,5
Kerstan,F,100,5,0,5
Keshae,F,100,5,0,5
Keshanda,F,100,5,0,5
Kesiah,F,100,5,0,5
Kessley,F,100,5,0,5
Kestin,M,100,0,5,5
Ketch,M,100,0,5,5
Ketia,F,100,5,0,5
Ketric,M,100,0,5,5
Ketti,F,100,5,0,5
Kever,M,100,0,5,5
Kevinanthony,M,100,0,5,5
Kevinmatthew,M,100,0,5,5
Kevisha,F,100,5,0,5
Kevontre,M,100,0,5,5
Kevrick,M,100,0,5,5
Kevron,M,100,0,5,5
Kewaun,M,100,0,5,5
Keyandrea,F,100,5,0,5
Keyannah,F,100,5,0,5
Keydan,M,100,0,5,5
Keyetta,F,100,5,0,5
Keyland,M,100,0,5,5
Keymonie,M,100,0,5,5
Keysa,F,100,5,0,5
Keyshanna,F,100,5,0,5
Keyshonda,F,100,5,0,5
Keyth,M,100,0,5,5
Keyun,M,100,0,5,5
Keyvin,M,100,0,5,5
Keywan,M,100,0,5,5
Keywanda,F,100,5,0,5
Kezion,M,100,0,5,5
Khadafi,M,100,0,5,5
Khaelynn,F,100,5,0,5
Khailah,F,100,5,0,5
Khair,M,100,0,5,5
Khaleeq,M,100,0,5,5
Khaleesy,F,100,5,0,5
Khaleyah,F,100,5,0,5
Khalli,F,100,5,0,5
Khamel,M,100,0,5,5
Khamiah,F,100,5,0,5
Khamon,M,100,0,5,5
Khamyla,F,100,5,0,5
Khandi,F,100,5,0,5
Khaos,M,100,0,5,5
Kharee,M,100,0,5,5
Khareem,M,100,0,5,5
Kharissa,F,100,5,0,5
Kharley,F,100,5,0,5
Kharmen,F,100,5,0,5
Khaseem,M,100,0,5,5
Khawlah,F,100,5,0,5
Khaydin,M,100,0,5,5
Khendal,F,100,5,0,5
Khiandra,F,100,5,0,5
Khilan,M,100,0,5,5
Khimora,F,100,5,0,5
Khing,M,100,0,5,5
Khirey,M,100,0,5,5
Khloeann,F,100,5,0,5
Khloemae,F,100,5,0,5
Kholby,M,100,0,5,5
Kholie,F,100,5,0,5
Kholten,M,100,0,5,5
Khorey,M,100,0,5,5
Khory,M,100,0,5,5
Khristan,M,100,0,5,5
Khristiana,F,100,5,0,5
Khrysta,F,100,5,0,5
Khrystopher,M,100,0,5,5
Khuong,M,100,0,5,5
Khushal,M,100,0,5,5
Khyden,M,100,0,5,5
Khylah,F,100,5,0,5
Khylar,M,100,0,5,5
Khylia,F,100,5,0,5
Kiairra,F,100,5,0,5
Kialey,F,100,5,0,5
Kiamara,F,100,5,0,5
Kiane,F,100,5,0,5
Kiare,F,100,5,0,5
Kiaundra,F,100,5,0,5
Kiaura,F,100,5,0,5
Kiawna,F,100,5,0,5
Kiea,F,100,5,0,5
Kiean,M,100,0,5,5
Kieisha,F,100,5,0,5
Kielah,F,100,5,0,5
Kieralyn,F,100,5,0,5
Kierian,M,100,0,5,5
Kierson,M,100,0,5,5
Kierstynn,F,100,5,0,5
Kiesa,F,100,5,0,5
Kija,F,100,5,0,5
Kileah,F,100,5,0,5
Kiler,M,100,0,5,5
Kilik,M,100,0,5,5
Kimalee,F,100,5,0,5
Kimbal,M,100,0,5,5
Kimbrell,M,100,0,5,5
Kimchi,F,100,5,0,5
Kimella,F,100,5,0,5
Kimely,F,100,5,0,5
Kimily,F,100,5,0,5
Kimira,F,100,5,0,5
Kimlee,F,100,5,0,5
Kimlyn,F,100,5,0,5
Kimore,F,100,5,0,5
Kimorra,F,100,5,0,5
Kimyada,F,100,5,0,5
Kinberli,F,100,5,0,5
Kinberlin,F,100,5,0,5
Kindrea,F,100,5,0,5
Kindy,F,100,5,0,5
Kineshia,F,100,5,0,5
Kinganthony,M,100,0,5,5
Kingdon,M,100,0,5,5
Kingjoseph,M,100,0,5,5
Kingstan,M,100,0,5,5
Kinisha,F,100,5,0,5
Kinson,M,100,0,5,5
Kinyon,M,100,0,5,5
Kinzer,M,100,0,5,5
Kiomara,F,100,5,0,5
Kiriakos,M,100,0,5,5
Kirian,M,100,0,5,5
Kirianna,F,100,5,0,5
Kirklyn,F,100,5,0,5
Kirkwood,M,100,0,5,5
Kirolos,M,100,0,5,5
Kirstian,F,100,5,0,5
Kirstien,F,100,5,0,5
Kiser,M,100,0,5,5
Kishana,F,100,5,0,5
Kishanna,F,100,5,0,5
Kison,M,100,0,5,5
Kissey,F,100,5,0,5
Kiswanna,F,100,5,0,5
Kito,M,100,0,5,5
Kiyler,M,100,0,5,5
Kjay,M,100,0,5,5
Klevis,M,100,0,5,5
Klowey,F,100,5,0,5
Kmiya,F,100,5,0,5
Kmyah,F,100,5,0,5
Knova,F,100,5,0,5
Knoxville,M,100,0,5,5
Koan,M,100,0,5,5
Kobina,M,100,0,5,5
Koebe,M,100,0,5,5
Koharu,F,100,5,0,5
Kohlee,F,100,5,0,5
Kohlten,M,100,0,5,5
Kohyn,M,100,0,5,5
Kokomi,F,100,5,0,5
Kollier,M,100,0,5,5
Koorosh,M,100,0,5,5
Koraleigh,F,100,5,0,5
Korilynn,F,100,5,0,5
Kornelia,F,100,5,0,5
Korrigan,M,100,0,5,5
Kortana,F,100,5,0,5
Korvyn,M,100,0,5,5
Kostandinos,M,100,0,5,5
Kourtny,F,100,5,0,5
Kovan,M,100,0,5,5
Kowanna,F,100,5,0,5
Koya,F,100,5,0,5
Kreighton,M,100,0,5,5
Krimsyn,F,100,5,0,5
Krisalynn,F,100,5,0,5
Krischan,M,100,0,5,5
Krisean,M,100,0,5,5
Kriselda,F,100,5,0,5
Krishal,M,100,0,5,5
Krishanna,F,100,5,0,5
Krishawna,F,100,5,0,5
Krishelle,F,100,5,0,5
Krishil,M,100,0,5,5
Krisia,F,100,5,0,5
Krisley,F,100,5,0,5
Krisstina,F,100,5,0,5
Krisstopher,M,100,0,5,5
Kristabel,F,100,5,0,5
Kristabella,F,100,5,0,5
Kristalee,F,100,5,0,5
Kristara,F,100,5,0,5
Kristhian,M,100,0,5,5
Kristifer,M,100,0,5,5
Kristilynn,F,100,5,0,5
Kristlyn,F,100,5,0,5
Kristn,F,100,5,0,5
Kristyann,F,100,5,0,5
Kriyansh,M,100,0,5,5
Krrish,M,100,0,5,5
Kruize,M,100,0,5,5
Krya,F,100,5,0,5
Kryslynn,F,100,5,0,5
Krystah,F,100,5,0,5
Krystalee,F,100,5,0,5
Krystalin,F,100,5,0,5
Krystalle,F,100,5,0,5
Krystalynne,F,100,5,0,5
Krystn,F,100,5,0,5
Krystol,F,100,5,0,5
Kt,F,100,5,0,5
Kulsum,F,100,5,0,5
Kumail,M,100,0,5,5
Kunaal,M,100,0,5,5
Kuol,M,100,0,5,5
Kupono,M,100,0,5,5
Kuron,M,100,0,5,5
Kurosh,M,100,0,5,5
Kursty,F,100,5,0,5
Kuwana,F,100,5,0,5
Kwanisha,F,100,5,0,5
Kwanzaa,F,100,5,0,5
Kwayera,F,100,5,0,5
Kweisi,M,100,0,5,5
Kwinn,F,100,5,0,5
Kwuan,M,100,0,5,5
Kyal,M,100,0,5,5
Kyari,F,100,5,0,5
Kyerstin,F,100,5,0,5
Kyhir,M,100,0,5,5
Kyianna,F,100,5,0,5
Kyiren,M,100,0,5,5
Kyja,F,100,5,0,5
Kylenn,F,100,5,0,5
Kylepatrick,M,100,0,5,5
Kylesha,F,100,5,0,5
Kylissa,F,100,5,0,5
Kyly,F,100,5,0,5
Kylynne,F,100,5,0,5
Kymberle,F,100,5,0,5
Kymberley,F,100,5,0,5
Kymberlyn,F,100,5,0,5
Kymesha,F,100,5,0,5
Kymira,F,100,5,0,5
Kymorra,F,100,5,0,5
Kyndyl,F,100,5,0,5
Kyomi,F,100,5,0,5
Kyong,F,100,5,0,5
Kyonne,M,100,0,5,5
Kyosuke,M,100,0,5,5
Kyptin,M,100,0,5,5
Kyriel,F,100,5,0,5
Kyrien,M,100,0,5,5
Kyris,M,100,0,5,5
Kyrstan,F,100,5,0,5
Kystin,M,100,0,5,5
Kyten,M,100,0,5,5
Kyus,M,100,0,5,5
Kyvin,M,100,0,5,5
Kywan,M,100,0,5,5
Kywanna,F,100,5,0,5
Laanthony,M,100,0,5,5
Labrenda,F,100,5,0,5
Labreyah,F,100,5,0,5
Labryan,M,100,0,5,5
Labryant,M,100,0,5,5
Lacci,F,100,5,0,5
Lacen,M,100,0,5,5
Lachina,F,100,5,0,5
Lachrisa,F,100,5,0,5
Lacrista,F,100,5,0,5
Lacynda,F,100,5,0,5
Ladaija,F,100,5,0,5
Ladaijah,F,100,5,0,5
Ladajia,F,100,5,0,5
Ladanian,M,100,0,5,5
Ladaniel,M,100,0,5,5
Ladara,F,100,5,0,5
Ladashia,F,100,5,0,5
Ladenna,F,100,5,0,5
Laderricka,F,100,5,0,5
Ladia,F,100,5,0,5
Ladonne,F,100,5,0,5
Ladreama,F,100,5,0,5
Laelyn,F,100,5,0,5
Lafay,F,100,5,0,5
Lafrance,F,100,5,0,5
Lafredrick,M,100,0,5,5
Lagenia,F,100,5,0,5
Lagregory,M,100,0,5,5
Laguana,F,100,5,0,5
Lahla,F,100,5,0,5
Lahonda,F,100,5,0,5
Laighton,F,100,5,0,5
Laihla,F,100,5,0,5
Laika,F,100,5,0,5
Lailey,F,100,5,0,5
Lailiana,F,100,5,0,5
Lainah,F,100,5,0,5
Laiyana,F,100,5,0,5
Lajavion,M,100,0,5,5
Lajayceon,M,100,0,5,5
Lajeanna,F,100,5,0,5
Lajoya,F,100,5,0,5
Lajuanda,F,100,5,0,5
Lakaya,F,100,5,0,5
Lakayden,M,100,0,5,5
Lakaysha,F,100,5,0,5
Lakeba,F,100,5,0,5
Lakeira,F,100,5,0,5
Lakelee,F,100,5,0,5
Lakelia,F,100,5,0,5
Lakema,F,100,5,0,5
Lakeyda,F,100,5,0,5
Lakhia,F,100,5,0,5
Lakieshia,F,100,5,0,5
Lakietha,F,100,5,0,5
Lakinya,F,100,5,0,5
Lakosha,F,100,5,0,5
Lakrystal,F,100,5,0,5
Lakshmy,F,100,5,0,5
Lakyndra,F,100,5,0,5
Lal,M,100,0,5,5
Lale,F,100,5,0,5
Lamare,M,100,0,5,5
Lamareon,M,100,0,5,5
Lamarria,F,100,5,0,5
Lamart,M,100,0,5,5
Lameir,M,100,0,5,5
Lamell,M,100,0,5,5
Lamica,F,100,5,0,5
Lamier,M,100,0,5,5
Lamora,F,100,5,0,5
Lamour,M,100,0,5,5
Lanaea,F,100,5,0,5
Lanaeya,F,100,5,0,5
Lanaja,F,100,5,0,5
Lananh,F,100,5,0,5
Lanasha,F,100,5,0,5
Lanayja,F,100,5,0,5
Landdon,M,100,0,5,5
Landenn,M,100,0,5,5
Landers,M,100,0,5,5
Landric,M,100,0,5,5
Laneice,F,100,5,0,5
Lanequa,F,100,5,0,5
Lanequia,F,100,5,0,5
Lanetra,F,100,5,0,5
Lanett,F,100,5,0,5
Laneva,F,100,5,0,5
Langstyn,F,100,5,0,5
Laniaya,F,100,5,0,5
Lanikai,F,100,5,0,5
Lank,M,100,0,5,5
Lanning,M,100,0,5,5
Lansana,M,100,0,5,5
Lanvy,F,100,5,0,5
Lany,F,100,5,0,5
Lanye,F,100,5,0,5
Lanylah,F,100,5,0,5
Lanz,M,100,0,5,5
Laporchea,F,100,5,0,5
Laporshe,F,100,5,0,5
Laprincess,F,100,5,0,5
Laquaisha,F,100,5,0,5
Laquanya,F,100,5,0,5
Laquavious,M,100,0,5,5
Laquaya,F,100,5,0,5
Laqueda,F,100,5,0,5
Laquez,M,100,0,5,5
Laquise,F,100,5,0,5
Larain,F,100,5,0,5
Larayna,F,100,5,0,5
Larelle,F,100,5,0,5
Larey,M,100,0,5,5
Lariel,F,100,5,0,5
Larika,F,100,5,0,5
Larod,M,100,0,5,5
Larome,M,100,0,5,5
Laronn,M,100,0,5,5
Laronzo,M,100,0,5,5
Laroya,F,100,5,0,5
Larrell,M,100,0,5,5
Larsyn,F,100,5,0,5
Laryan,M,100,0,5,5
Lasanya,F,100,5,0,5
Lashanette,F,100,5,0,5
Lashanya,F,100,5,0,5
Lashari,F,100,5,0,5
Lasharra,F,100,5,0,5
Lashaunna,F,100,5,0,5
Lashaunta,F,100,5,0,5
Lashayna,F,100,5,0,5
Lashelia,F,100,5,0,5
Lasheryl,F,100,5,0,5
Lashiya,F,100,5,0,5
Lashonya,F,100,5,0,5
Lashurn,F,100,5,0,5
Lasundra,F,100,5,0,5
Latacia,F,100,5,0,5
Lataivia,F,100,5,0,5
Latarcha,F,100,5,0,5
Latarra,F,100,5,0,5
Latascha,F,100,5,0,5
Latavea,F,100,5,0,5
Latee,M,100,0,5,5
Lateena,F,100,5,0,5
Latefa,F,100,5,0,5
Latenya,F,100,5,0,5
Laterius,M,100,0,5,5
Laterrell,M,100,0,5,5
Laterrika,F,100,5,0,5
Latiah,F,100,5,0,5
Latieka,F,100,5,0,5
Latierra,F,100,5,0,5
Latigra,F,100,5,0,5
Latijera,F,100,5,0,5
Latinya,F,100,5,0,5
Latoisha,F,100,5,0,5
Laton,M,100,0,5,5
Latonnia,F,100,5,0,5
Latony,M,100,0,5,5
Latousha,F,100,5,0,5
Latracy,F,100,5,0,5
Latravis,M,100,0,5,5
Latray,M,100,0,5,5
Latraya,F,100,5,0,5
Latrea,F,100,5,0,5
Latreasa,F,100,5,0,5
Latrevious,M,100,0,5,5
Latrey,M,100,0,5,5
Latrishia,F,100,5,0,5
Latsha,F,100,5,0,5
Latundra,F,100,5,0,5
Latunia,F,100,5,0,5
Latusha,F,100,5,0,5
Latwanda,F,100,5,0,5
Lauchlin,M,100,0,5,5
Launda,F,100,5,0,5
Launie,F,100,5,0,5
Laurae,F,100,5,0,5
Lauralai,F,100,5,0,5
Lauramarie,F,100,5,0,5
Laurea,F,100,5,0,5
Laurelai,F,100,5,0,5
Laurens,M,100,0,5,5
Laurianna,F,100,5,0,5
Lauriano,M,100,0,5,5
Laurn,F,100,5,0,5
Lauryne,F,100,5,0,5
Lavae,F,100,5,0,5
Lavarious,M,100,0,5,5
Lavarus,M,100,0,5,5
Lavaun,F,100,5,0,5
Laverle,F,100,5,0,5
Lavia,F,100,5,0,5
Lavonnia,F,100,5,0,5
Lavontre,M,100,0,5,5
Lawarence,M,100,0,5,5
Lawence,M,100,0,5,5
Lawrenc,M,100,0,5,5
Lawrene,F,100,5,0,5
Laxmi,F,100,5,0,5
Layiah,F,100,5,0,5
Laylanna,F,100,5,0,5
Layle,F,100,5,0,5
Laylen,M,100,0,5,5
Layli,F,100,5,0,5
Layliah,F,100,5,0,5
Laylianna,F,100,5,0,5
Laylon,M,100,0,5,5
Laylonnie,F,100,5,0,5
Laynah,F,100,5,0,5
Layona,F,100,5,0,5
Layvonne,F,100,5,0,5
Lazareth,M,100,0,5,5
Lazarick,M,100,0,5,5
Laziah,F,100,5,0,5
Laziya,F,100,5,0,5
Leafy,F,100,5,0,5
Leagh,F,100,5,0,5
Leal,F,100,5,0,5
Leamsi,F,100,5,0,5
Learta,F,100,5,0,5
Leaysia,F,100,5,0,5
Lecresha,F,100,5,0,5
Ledawn,F,100,5,0,5
Ledia,F,100,5,0,5
Leelani,F,100,5,0,5
Leelee,F,100,5,0,5
Leelen,M,100,0,5,5
Leemon,M,100,0,5,5
Leeo,M,100,0,5,5
Leevon,M,100,0,5,5
Legacie,F,100,5,0,5
Legendary,M,100,0,5,5
Leha,F,100,5,0,5
Lehanna,F,100,5,0,5
Leiahna,F,100,5,0,5
Leianne,F,100,5,0,5
Leiasia,F,100,5,0,5
Leicia,F,100,5,0,5
Leighlynn,F,100,5,0,5
Leihla,F,100,5,0,5
Leihlani,F,100,5,0,5
Leihum,M,100,0,5,5
Leilamarie,F,100,5,0,5
Leilaney,F,100,5,0,5
Leileen,F,100,5,0,5
Leilia,F,100,5,0,5
Leinani,F,100,5,0,5
Leisly,F,100,5,0,5
Leithan,M,100,0,5,5
Leiyana,F,100,5,0,5
Lekai,M,100,0,5,5
Lekethia,F,100,5,0,5
Lekeysha,F,100,5,0,5
Lelanie,F,100,5,0,5
Lelu,F,100,5,0,5
Lemario,M,100,0,5,5
Lemia,F,100,5,0,5
Lenayah,F,100,5,0,5
Lency,F,100,5,0,5
Lenelle,F,100,5,0,5
Lenford,M,100,0,5,5
Lennea,F,100,5,0,5
Lennel,M,100,0,5,5
Lennice,F,100,5,0,5
Lenoria,F,100,5,0,5
Lenoris,M,100,0,5,5
Lenorris,M,100,0,5,5
Lens,M,100,0,5,5
Lenuel,M,100,0,5,5
Leocadia,F,100,5,0,5
Leonice,F,100,5,0,5
Leonita,F,100,5,0,5
Leonydus,M,100,0,5,5
Leoul,M,100,0,5,5
Lequitta,F,100,5,0,5
Leresa,F,100,5,0,5
Leriyah,F,100,5,0,5
Lesbia,F,100,5,0,5
Leshaunda,F,100,5,0,5
Leshawnda,F,100,5,0,5
Lesheka,F,100,5,0,5
Leshon,F,100,5,0,5
Leshunda,F,100,5,0,5
Lesie,F,100,5,0,5
Lesile,F,100,5,0,5
Lessley,F,100,5,0,5
Lessli,F,100,5,0,5
Lethaniel,M,100,0,5,5
Letita,F,100,5,0,5
Letonia,F,100,5,0,5
Levada,F,100,5,0,5
Levaughn,M,100,0,5,5
Levenia,F,100,5,0,5
Leveon,M,100,0,5,5
Levera,F,100,5,0,5
Leverette,M,100,0,5,5
Levertis,M,100,0,5,5
Levian,M,100,0,5,5
Levion,M,100,0,5,5
Levone,M,100,0,5,5
Levonia,F,100,5,0,5
Levontae,M,100,0,5,5
Leward,M,100,0,5,5
Lewayne,M,100,0,5,5
Lexandro,M,100,0,5,5
Lexcee,F,100,5,0,5
Lexiann,F,100,5,0,5
Lexiee,F,100,5,0,5
Lexx,M,100,0,5,5
Leylanni,F,100,5,0,5
Leyonna,F,100,5,0,5
Leyre,F,100,5,0,5
Liamalexander,M,100,0,5,5
Libertee,F,100,5,0,5
Lica,F,100,5,0,5
Liddy,F,100,5,0,5
Lieselotte,F,100,5,0,5
Liezl,F,100,5,0,5
Lilan,F,100,5,0,5
Lilana,F,100,5,0,5
Lilani,F,100,5,0,5
Lilica,F,100,5,0,5
Lilien,F,100,5,0,5
Lilika,F,100,5,0,5
Lilikoi,F,100,5,0,5
Lilirose,F,100,5,0,5
Lilium,F,100,5,0,5
Liliyanna,F,100,5,0,5
Lill,F,100,5,0,5
Lilliani,F,100,5,0,5
Lilliaunna,F,100,5,0,5
Lilliyan,F,100,5,0,5
Lilliyn,F,100,5,0,5
Lillyin,F,100,5,0,5
Lillykate,F,100,5,0,5
Lillynn,F,100,5,0,5
Lillyrose,F,100,5,0,5
Lilyane,F,100,5,0,5
Lilyani,F,100,5,0,5
Lilyaunna,F,100,5,0,5
Lilykate,F,100,5,0,5
Lilymarie,F,100,5,0,5
Lindaann,F,100,5,0,5
Lindajean,F,100,5,0,5
Lindajo,F,100,5,0,5
Lindalou,F,100,5,0,5
Lindamarie,F,100,5,0,5
Linday,F,100,5,0,5
Lindberg,M,100,0,5,5
Lindbergh,M,100,0,5,5
Lindly,F,100,5,0,5
Lindwood,M,100,0,5,5
Linita,F,100,5,0,5
Linnda,F,100,5,0,5
Linne,F,100,5,0,5
Linneah,F,100,5,0,5
Linnetta,F,100,5,0,5
Linward,M,100,0,5,5
Linze,F,100,5,0,5
Lional,M,100,0,5,5
Lirio,F,100,5,0,5
Liron,M,100,0,5,5
Lisah,F,100,5,0,5
Lisander,M,100,0,5,5
Lisbed,F,100,5,0,5
Lisbett,F,100,5,0,5
Lismarie,F,100,5,0,5
Lissianna,F,100,5,0,5
Lital,F,100,5,0,5
Litia,F,100,5,0,5
Litzie,F,100,5,0,5
Livio,M,100,0,5,5
Lizaida,F,100,5,0,5
Lizmar,F,100,5,0,5
Lizzieann,F,100,5,0,5
Llecenia,F,100,5,0,5
Lloana,F,100,5,0,5
Lobsang,M,100,0,5,5
Lochlainn,M,100,0,5,5
Lockie,F,100,5,0,5
Logahn,M,100,0,5,5
Logon,M,100,0,5,5
Loi,M,100,0,5,5
Lokesh,M,100,0,5,5
Lolla,F,100,5,0,5
Lomont,M,100,0,5,5
Londrea,F,100,5,0,5
Lonnesha,F,100,5,0,5
Lonyea,F,100,5,0,5
Loralea,F,100,5,0,5
Loralynn,F,100,5,0,5
Lorde,F,100,5,0,5
Loreana,F,100,5,0,5
Loreatha,F,100,5,0,5
Loreda,F,100,5,0,5
Loriah,F,100,5,0,5
Lorilai,F,100,5,0,5
Lorilie,F,100,5,0,5
Lorrae,F,100,5,0,5
Lorree,F,100,5,0,5
Lorrenda,F,100,5,0,5
Lorrianne,F,100,5,0,5
Lorrieann,F,100,5,0,5
Lorrinda,F,100,5,0,5
Lotasha,F,100,5,0,5
Lotti,F,100,5,0,5
Louana,F,100,5,0,5
Lourene,F,100,5,0,5
Lousia,F,100,5,0,5
Louvella,F,100,5,0,5
Lovel,M,100,0,5,5
Loveleen,F,100,5,0,5
Lowana,F,100,5,0,5
Loyola,F,100,5,0,5
Lucchese,F,100,5,0,5
Lucea,F,100,5,0,5
Lucenda,F,100,5,0,5
Lucetta,F,100,5,0,5
Lucillie,F,100,5,0,5
Lucino,M,100,0,5,5
Luckas,M,100,0,5,5
Luckie,F,100,5,0,5
Lucricia,F,100,5,0,5
Ludovic,M,100,0,5,5
Ludwin,M,100,0,5,5
Luelle,F,100,5,0,5
Luigina,F,100,5,0,5
Luisafernanda,F,100,5,0,5
Luisito,M,100,0,5,5
Lukan,M,100,0,5,5
Lukeus,M,100,0,5,5
Lukkas,M,100,0,5,5
Lulabelle,F,100,5,0,5
Lulah,F,100,5,0,5
Luley,F,100,5,0,5
Lunamarie,F,100,5,0,5
Lunette,F,100,5,0,5
Lurlean,F,100,5,0,5
Luserito,F,100,5,0,5
Lutrica,F,100,5,0,5
Luvern,M,100,0,5,5
Luvia,F,100,5,0,5
Luxanna,F,100,5,0,5
Luxie,F,100,5,0,5
Luxton,M,100,0,5,5
Luxy,F,100,5,0,5
Luzdari,F,100,5,0,5
Luzmary,F,100,5,0,5
Luzviminda,F,100,5,0,5
Lyandra,F,100,5,0,5
Lyani,F,100,5,0,5
Lyiam,M,100,0,5,5
Lyka,F,100,5,0,5
Lyli,F,100,5,0,5
Lyliann,F,100,5,0,5
Lylybell,F,100,5,0,5
Lynder,F,100,5,0,5
Lyndle,M,100,0,5,5
Lyndze,F,100,5,0,5
Lyndzey,F,100,5,0,5
Lynesha,F,100,5,0,5
Lyneshia,F,100,5,0,5
Lynessa,F,100,5,0,5
Lynkon,M,100,0,5,5
Lynlie,F,100,5,0,5
Lynnia,F,100,5,0,5
Lynzey,F,100,5,0,5
Lyrix,F,100,5,0,5
Lysha,F,100,5,0,5
Lytina,F,100,5,0,5
Lytle,M,100,0,5,5
Maadhav,M,100,0,5,5
Maahira,F,100,5,0,5
Maariyah,F,100,5,0,5
Maaseiah,M,100,0,5,5
Maaya,F,100,5,0,5
Mabeline,F,100,5,0,5
Mabelle,F,100,5,0,5
Macaiah,F,100,5,0,5
Macailyn,F,100,5,0,5
Macaire,F,100,5,0,5
Macalister,M,100,0,5,5
Macara,F,100,5,0,5
Macedonio,M,100,0,5,5
Macel,F,100,5,0,5
Macelynn,F,100,5,0,5
Maceon,M,100,0,5,5
Mach,M,100,0,5,5
Macheal,M,100,0,5,5
Macheala,F,100,5,0,5
Machiah,F,100,5,0,5
Macii,F,100,5,0,5
Macilyn,F,100,5,0,5
Mackenley,F,100,5,0,5
Mackinnley,M,100,0,5,5
Maclayne,F,100,5,0,5
Maclyn,F,100,5,0,5
Macolm,M,100,0,5,5
Macynn,F,100,5,0,5
Madalaine,F,100,5,0,5
Madalie,F,100,5,0,5
Madaly,F,100,5,0,5
Madasin,F,100,5,0,5
Madaya,F,100,5,0,5
Maddielyn,F,100,5,0,5
Madee,F,100,5,0,5
Madelinne,F,100,5,0,5
Madelline,F,100,5,0,5
Maden,M,100,0,5,5
Madhumitha,F,100,5,0,5
Madiba,M,100,0,5,5
Madilen,F,100,5,0,5
Madisongrace,F,100,5,0,5
Madisonrose,F,100,5,0,5
Madolin,F,100,5,0,5
Madoxx,M,100,0,5,5
Madyline,F,100,5,0,5
Maebrie,F,100,5,0,5
Maelina,F,100,5,0,5
Maelynne,F,100,5,0,5
Maesen,F,100,5,0,5
Maevry,F,100,5,0,5
Maevyn,F,100,5,0,5
Magarita,F,100,5,0,5
Magdalina,F,100,5,0,5
Mahadi,M,100,0,5,5
Mahali,F,100,5,0,5
Mahdia,F,100,5,0,5
Mahdy,M,100,0,5,5
Mahith,M,100,0,5,5
Mahli,F,100,5,0,5
Mahliyah,F,100,5,0,5
Maho,F,100,5,0,5
Mahria,F,100,5,0,5
Mahveen,F,100,5,0,5
Mahyar,M,100,0,5,5
Maiara,F,100,5,0,5
Maide,F,100,5,0,5
Maigen,F,100,5,0,5
Maikia,F,100,5,0,5
Maimoona,F,100,5,0,5
Mainor,M,100,0,5,5
Maireli,F,100,5,0,5
Maissa,F,100,5,0,5
Maitlin,F,100,5,0,5
Majestie,F,100,5,0,5
Majik,M,100,0,5,5
Makaden,M,100,0,5,5
Makaelynn,F,100,5,0,5
Makaih,M,100,0,5,5
Makailynn,F,100,5,0,5
Makalee,F,100,5,0,5
Makali,F,100,5,0,5
Makamae,F,100,5,0,5
Makeena,F,100,5,0,5
Makeia,F,100,5,0,5
Makelah,F,100,5,0,5
Makensi,F,100,5,0,5
Makenzly,F,100,5,0,5
Maketa,F,100,5,0,5
Makeya,F,100,5,0,5
Makhaila,F,100,5,0,5
Makhila,F,100,5,0,5
Makinlie,F,100,5,0,5
Makinly,F,100,5,0,5
Makinnley,F,100,5,0,5
Makirah,F,100,5,0,5
Makiylah,F,100,5,0,5
Makoy,M,100,0,5,5
Makson,M,100,0,5,5
Makston,M,100,0,5,5
Malaena,F,100,5,0,5
Malaine,F,100,5,0,5
Malaisia,F,100,5,0,5
Malajia,F,100,5,0,5
Malanii,F,100,5,0,5
Malany,F,100,5,0,5
Malary,F,100,5,0,5
Malay,F,100,5,0,5
Malayha,F,100,5,0,5
Maleaya,F,100,5,0,5
Malei,F,100,5,0,5
Maleika,F,100,5,0,5
Malekia,F,100,5,0,5
Malery,F,100,5,0,5
Malesha,F,100,5,0,5
Malessa,F,100,5,0,5
Maliana,F,100,5,0,5
Maliayah,F,100,5,0,5
Malicka,F,100,5,0,5
Malieka,F,100,5,0,5
Malikhai,M,100,0,5,5
Maliyha,F,100,5,0,5
Malke,F,100,5,0,5
Malkolm,M,100,0,5,5
Mallina,F,100,5,0,5
Malloy,M,100,0,5,5
Malonda,F,100,5,0,5
Malva,F,100,5,0,5
Malyha,F,100,5,0,5
Malyka,F,100,5,0,5
Mamadu,M,100,0,5,5
Manasvini,F,100,5,0,5
Manesha,F,100,5,0,5
Manessa,F,100,5,0,5
Manh,M,100,0,5,5
Manina,F,100,5,0,5
Manique,F,100,5,0,5
Manit,M,100,0,5,5
Mann,M,100,0,5,5
Manroop,F,100,5,0,5
Manton,M,100,0,5,5
Manus,M,100,0,5,5
Manvik,M,100,0,5,5
Maquan,M,100,0,5,5
Marabeth,F,100,5,0,5
Maraina,F,100,5,0,5
Marali,F,100,5,0,5
Marasia,F,100,5,0,5
Marat,M,100,0,5,5
Marbel,F,100,5,0,5
Marbeya,F,100,5,0,5
Marcellius,M,100,0,5,5
Marcenia,F,100,5,0,5
Marchele,F,100,5,0,5
Marchetta,F,100,5,0,5
Marcilla,F,100,5,0,5
Marcis,M,100,0,5,5
Marckus,M,100,0,5,5
Marcques,M,100,0,5,5
Marcquez,M,100,0,5,5
Marcquise,M,100,0,5,5
Marcum,M,100,0,5,5
Marden,M,100,0,5,5
Mardochee,M,100,0,5,5
Mareah,F,100,5,0,5
Mareck,M,100,0,5,5
Marelli,F,100,5,0,5
Maressia,F,100,5,0,5
Marey,F,100,5,0,5
Mareya,F,100,5,0,5
Marfa,F,100,5,0,5
Margarida,F,100,5,0,5
Margarie,F,100,5,0,5
Margean,F,100,5,0,5
Margee,F,100,5,0,5
Margette,F,100,5,0,5
Margreta,F,100,5,0,5
Marguis,M,100,0,5,5
Margus,M,100,0,5,5
Mariaantonia,F,100,5,0,5
Mariachristina,F,100,5,0,5
Mariadel,F,100,5,0,5
Mariaelizabeth,F,100,5,0,5
Mariaemilia,F,100,5,0,5
Marial,F,100,5,0,5
Marialice,F,100,5,0,5
Mariarosa,F,100,5,0,5
Maribela,F,100,5,0,5
Maricely,F,100,5,0,5
Maricelys,F,100,5,0,5
Marichelle,F,100,5,0,5
Marick,M,100,0,5,5
Mariclare,F,100,5,0,5
Marida,F,100,5,0,5
Marideth,F,100,5,0,5
Marieelena,F,100,5,0,5
Marieka,F,100,5,0,5
Marietherese,F,100,5,0,5
Marihanna,F,100,5,0,5
Marilinda,F,100,5,0,5
Mariliz,F,100,5,0,5
Marim,F,100,5,0,5
Marimar,F,100,5,0,5
Marinus,M,100,0,5,5
Marioalberto,M,100,0,5,5
Marirose,F,100,5,0,5
Marise,F,100,5,0,5
Marisleysi,F,100,5,0,5
Marivell,F,100,5,0,5
Mariyani,F,100,5,0,5
Markail,M,100,0,5,5
Markallen,M,100,0,5,5
Markangelo,M,100,0,5,5
Markavion,M,100,0,5,5
Markeice,M,100,0,5,5
Markeria,F,100,5,0,5
Markevion,M,100,0,5,5
Markeys,M,100,0,5,5
Markian,M,100,0,5,5
Markiest,M,100,0,5,5
Markki,F,100,5,0,5
Markous,M,100,0,5,5
Markuz,M,100,0,5,5
Markwan,M,100,0,5,5
Markyla,F,100,5,0,5
Marlaena,F,100,5,0,5
Marlem,F,100,5,0,5
Marlenea,F,100,5,0,5
Marleyann,F,100,5,0,5
Marlicia,F,100,5,0,5
Marliee,F,100,5,0,5
Marliese,F,100,5,0,5
Marlii,F,100,5,0,5
Marlone,M,100,0,5,5
Marlos,M,100,0,5,5
Marquea,F,100,5,0,5
Marqueis,M,100,0,5,5
Marquella,F,100,5,0,5
Marquil,M,100,0,5,5
Marquin,M,100,0,5,5
Marrianna,F,100,5,0,5
Marrie,F,100,5,0,5
Marrietta,F,100,5,0,5
Marrisha,F,100,5,0,5
Marselino,M,100,0,5,5
Marsena,F,100,5,0,5
Marshai,F,100,5,0,5
Marsinah,F,100,5,0,5
Martay,M,100,0,5,5
Marteeka,F,100,5,0,5
Marth,F,100,5,0,5
Marthena,F,100,5,0,5
Marthenia,F,100,5,0,5
Martrail,M,100,0,5,5
Martravious,M,100,0,5,5
Marval,F,100,5,0,5
Marveen,F,100,5,0,5
Marvena,F,100,5,0,5
Marvie,F,100,5,0,5
Marvita,F,100,5,0,5
Maryagnes,F,100,5,0,5
Maryeileen,F,100,5,0,5
Maryjeanne,F,100,5,0,5
Maryjune,F,100,5,0,5
Marykaye,F,100,5,0,5
Maryke,F,100,5,0,5
Marylen,F,100,5,0,5
Maryrita,F,100,5,0,5
Marysusan,F,100,5,0,5
Maryterese,F,100,5,0,5
Maryury,F,100,5,0,5
Marzena,F,100,5,0,5
Marzette,F,100,5,0,5
Marzia,F,100,5,0,5
Masada,F,100,5,0,5
Masal,F,100,5,0,5
Masao,M,100,0,5,5
Mascen,M,100,0,5,5
Mashiya,F,100,5,0,5
Masina,F,100,5,0,5
Masiya,F,100,5,0,5
Maslyn,F,100,5,0,5
Masood,M,100,0,5,5
Masoud,M,100,0,5,5
Massen,M,100,0,5,5
Massi,M,100,0,5,5
Massie,F,100,5,0,5
Mata,F,100,5,0,5
Matalynn,F,100,5,0,5
Matao,M,100,0,5,5
Matas,M,100,0,5,5
Mathais,M,100,0,5,5
Maticia,F,100,5,0,5
Matilee,F,100,5,0,5
Matis,M,100,0,5,5
Matisyahu,M,100,0,5,5
Matrice,F,100,5,0,5
Matricia,F,100,5,0,5
Matteen,M,100,0,5,5
Matthais,M,100,0,5,5
Mattheau,M,100,0,5,5
Matther,M,100,0,5,5
Matthiew,M,100,0,5,5
Matvei,M,100,0,5,5
Mau,M,100,0,5,5
Maulik,M,100,0,5,5
Maulin,M,100,0,5,5
Maureena,F,100,5,0,5
Maurey,M,100,0,5,5
Mauria,F,100,5,0,5
Maurianna,F,100,5,0,5
Maurielle,F,100,5,0,5
Maurya,M,100,0,5,5
Mavie,F,100,5,0,5
Maxxen,M,100,0,5,5
Maxymilian,M,100,0,5,5
Mayani,F,100,5,0,5
Maybeline,F,100,5,0,5
Mayel,M,100,0,5,5
Mayely,F,100,5,0,5
Mayerlin,F,100,5,0,5
Mayha,F,100,5,0,5
Maykol,M,100,0,5,5
Mayleah,F,100,5,0,5
Maylet,F,100,5,0,5
Maylina,F,100,5,0,5
Mayly,F,100,5,0,5
Mayolo,M,100,0,5,5
Mayowa,M,100,0,5,5
Mayrely,F,100,5,0,5
Maysn,M,100,0,5,5
Maysun,F,100,5,0,5
Maytee,F,100,5,0,5
Maythe,F,100,5,0,5
Mazarine,F,100,5,0,5
Mazee,F,100,5,0,5
Mazon,M,100,0,5,5
Mccarthy,M,100,0,5,5
Mccauley,F,100,5,0,5
Mcconnell,M,100,0,5,5
Mccormick,M,100,0,5,5
Mccray,M,100,0,5,5
Mckee,M,100,0,5,5
Mckeon,M,100,0,5,5
Mckinly,F,100,5,0,5
Mckinsie,F,100,5,0,5
Mckynzi,F,100,5,0,5
Mclaren,M,100,0,5,5
Meahgan,F,100,5,0,5
Mearah,F,100,5,0,5
Mechella,F,100,5,0,5
Mecia,F,100,5,0,5
Mecole,F,100,5,0,5
Medeline,F,100,5,0,5
Medhansh,M,100,0,5,5
Medley,F,100,5,0,5
Medrick,M,100,0,5,5
Meenah,F,100,5,0,5
Meganmarie,F,100,5,0,5
Meggen,F,100,5,0,5
Meghanne,F,100,5,0,5
Meguel,M,100,0,5,5
Mehakpreet,F,100,5,0,5
Mehana,F,100,5,0,5
Mehtaab,M,100,0,5,5
Mehwish,F,100,5,0,5
Meilan,F,100,5,0,5
Meilanie,F,100,5,0,5
Meiqi,F,100,5,0,5
Mekalah,F,100,5,0,5
Mekenzi,F,100,5,0,5
Mekeshia,F,100,5,0,5
Mekiya,F,100,5,0,5
Melakai,M,100,0,5,5
Melanni,F,100,5,0,5
Melasia,F,100,5,0,5
Melburn,M,100,0,5,5
Meleigha,F,100,5,0,5
Melenaite,F,100,5,0,5
Melene,F,100,5,0,5
Meliana,F,100,5,0,5
Melicent,F,100,5,0,5
Meliha,F,100,5,0,5
Melinah,F,100,5,0,5
Melisande,F,100,5,0,5
Melise,F,100,5,0,5
Melky,M,100,0,5,5
Mellani,F,100,5,0,5
Melodey,F,100,5,0,5
Melodia,F,100,5,0,5
Melvon,M,100,0,5,5
Memarie,F,100,5,0,5
Meme,F,100,5,0,5
Memoree,F,100,5,0,5
Menah,F,100,5,0,5
Menal,F,100,5,0,5
Mendell,M,100,0,5,5
Meradith,F,100,5,0,5
Meridth,F,100,5,0,5
Meril,M,100,0,5,5
Meris,F,100,5,0,5
Merjem,F,100,5,0,5
Merriah,F,100,5,0,5
Merriam,F,100,5,0,5
Merrianne,F,100,5,0,5
Merrideth,F,100,5,0,5
Mertha,F,100,5,0,5
Meshal,M,100,0,5,5
Meshea,F,100,5,0,5
Mesiyah,M,100,0,5,5
Messias,M,100,0,5,5
Messyah,M,100,0,5,5
Meti,F,100,5,0,5
Mey,F,100,5,0,5
Meygan,F,100,5,0,5
Meyla,F,100,5,0,5
Mhia,F,100,5,0,5
Miakayla,F,100,5,0,5
Mialee,F,100,5,0,5
Miamarie,F,100,5,0,5
Miamour,F,100,5,0,5
Miasha,F,100,5,0,5
Miatta,F,100,5,0,5
Micahjoseph,M,100,0,5,5
Micahla,F,100,5,0,5
Micahya,F,100,5,0,5
Micaih,M,100,0,5,5
Micale,M,100,0,5,5
Micaleb,M,100,0,5,5
Micaya,F,100,5,0,5
Michaelee,F,100,5,0,5
Michaelina,F,100,5,0,5
Michaelray,M,100,0,5,5
Michaelthomas,M,100,0,5,5
Michaelynn,F,100,5,0,5
Michea,F,100,5,0,5
Micheil,M,100,0,5,5
Michelli,F,100,5,0,5
Michelyn,F,100,5,0,5
Michieal,M,100,0,5,5
Michoel,M,100,0,5,5
Michol,F,100,5,0,5
Michole,F,100,5,0,5
Michone,F,100,5,0,5
Michonne,F,100,5,0,5
Mickale,M,100,0,5,5
Mickiel,M,100,0,5,5
Mickinley,F,100,5,0,5
Micquel,M,100,0,5,5
Midhuna,F,100,5,0,5
Mieisha,F,100,5,0,5
Mignonne,F,100,5,0,5
Miguelantonio,M,100,0,5,5
Mihael,M,100,0,5,5
Mihaela,F,100,5,0,5
Miika,F,100,5,0,5
Mikalya,F,100,5,0,5
Mikalynn,F,100,5,0,5
Mikaylie,F,100,5,0,5
Mikaylla,F,100,5,0,5
Mikecia,F,100,5,0,5
Mikele,M,100,0,5,5
Mikena,F,100,5,0,5
Mikenley,F,100,5,0,5
Miketa,F,100,5,0,5
Mikhale,M,100,0,5,5
Mikhia,F,100,5,0,5
Mikila,F,100,5,0,5
Mikio,M,100,0,5,5
Mikle,M,100,0,5,5
Mikyia,F,100,5,0,5
Milbert,M,100,0,5,5
Milderd,F,100,5,0,5
Milett,F,100,5,0,5
Mileva,F,100,5,0,5
Mileyshka,F,100,5,0,5
Milian,F,100,5,0,5
Mililani,F,100,5,0,5
Milisha,F,100,5,0,5
Milisia,F,100,5,0,5
Milissia,F,100,5,0,5
Millenna,F,100,5,0,5
Millian,F,100,5,0,5
Millinia,F,100,5,0,5
Milus,M,100,0,5,5
Minelva,F,100,5,0,5
Minesha,F,100,5,0,5
Minetta,F,100,5,0,5
Minhtri,M,100,0,5,5
Minique,F,100,5,0,5
Minji,F,100,5,0,5
Minjoon,M,100,0,5,5
Minus,M,100,0,5,5
Miosoti,F,100,5,0,5
Miquez,M,100,0,5,5
Mirajane,F,100,5,0,5
Mirandy,F,100,5,0,5
Mirca,F,100,5,0,5
Mircale,F,100,5,0,5
Mircle,F,100,5,0,5
Mireily,F,100,5,0,5
Mirelys,F,100,5,0,5
Mirena,F,100,5,0,5
Miria,F,100,5,0,5
Miricle,F,100,5,0,5
Mirlinda,F,100,5,0,5
Mirsa,F,100,5,0,5
Mirsab,M,100,0,5,5
Mirya,F,100,5,0,5
Mishaal,F,100,5,0,5
Mishalay,F,100,5,0,5
Mishaun,M,100,0,5,5
Misri,F,100,5,0,5
Missey,F,100,5,0,5
Mistelle,F,100,5,0,5
Mistyann,F,100,5,0,5
Mithil,M,100,0,5,5
Mitsuki,F,100,5,0,5
Miyesha,F,100,5,0,5
Miylah,F,100,5,0,5
Mkaila,F,100,5,0,5
Mleah,F,100,5,0,5
Mlynn,F,100,5,0,5
Moath,M,100,0,5,5
Mobeen,M,100,0,5,5
Mocha,F,100,5,0,5
Modestine,F,100,5,0,5
Moeez,M,100,0,5,5
Mofiyinfoluwa,F,100,5,0,5
Mohamedamiin,M,100,0,5,5
Mohaned,M,100,0,5,5
Mohmad,M,100,0,5,5
Moices,M,100,0,5,5
Mojolaoluwa,F,100,5,0,5
Mojtaba,M,100,0,5,5
Mokshith,M,100,0,5,5
Mokshitha,F,100,5,0,5
Monalee,F,100,5,0,5
Monce,F,100,5,0,5
Moncerath,F,100,5,0,5
Moncerrad,F,100,5,0,5
Mondale,M,100,0,5,5
Moneeka,F,100,5,0,5
Moneik,F,100,5,0,5
Monetta,F,100,5,0,5
Moni,F,100,5,0,5
Moniece,F,100,5,0,5
Monina,F,100,5,0,5
Moniquea,F,100,5,0,5
Monira,F,100,5,0,5
Monish,M,100,0,5,5
Monreaux,F,100,5,0,5
Monseratt,F,100,5,0,5
Monserrad,F,100,5,0,5
Montaz,M,100,0,5,5
Montego,M,100,0,5,5
Montisha,F,100,5,0,5
Montrese,F,100,5,0,5
Montressa,F,100,5,0,5
Montserrad,F,100,5,0,5
Morah,F,100,5,0,5
Mordechi,M,100,0,5,5
Mordekai,M,100,0,5,5
Morea,F,100,5,0,5
Morio,M,100,0,5,5
Morolaoluwa,F,100,5,0,5
Morpheus,M,100,0,5,5
Morrissey,M,100,0,5,5
Mort,M,100,0,5,5
Mortez,M,100,0,5,5
Morticia,F,100,5,0,5
Mory,M,100,0,5,5
Moselle,F,100,5,0,5
Mosses,M,100,0,5,5
Motley,M,100,0,5,5
Motunrayo,F,100,5,0,5
Mouhammad,M,100,0,5,5
Moukthika,F,100,5,0,5
Mourya,M,100,0,5,5
Mozart,M,100,0,5,5
Mubin,M,100,0,5,5
Mugdha,F,100,5,0,5
Mugen,M,100,0,5,5
Mugisha,M,100,0,5,5
Muhammadamin,M,100,0,5,5
Muizz,M,100,0,5,5
Mukarram,M,100,0,5,5
Muktar,M,100,0,5,5
Muneerah,F,100,5,0,5
Munro,M,100,0,5,5
Muntasir,M,100,0,5,5
Muntaz,F,100,5,0,5
Murali,M,100,0,5,5
Murdock,M,100,0,5,5
Murel,M,100,0,5,5
Murrie,F,100,5,0,5
Musaab,M,100,0,5,5
Musashi,M,100,0,5,5
Muslimah,F,100,5,0,5
Myaira,F,100,5,0,5
Myalyn,F,100,5,0,5
Myami,F,100,5,0,5
Myanni,F,100,5,0,5
Mycol,M,100,0,5,5
Myha,F,100,5,0,5
Myjah,F,100,5,0,5
Mykalla,F,100,5,0,5
Myke,M,100,0,5,5
Mykeia,F,100,5,0,5
Mykeil,M,100,0,5,5
Mykelle,F,100,5,0,5
Mykerria,F,100,5,0,5
Mykhi,M,100,0,5,5
Mykisha,F,100,5,0,5
Mykl,M,100,0,5,5
Mykyah,F,100,5,0,5
Mylicia,F,100,5,0,5
Mylina,F,100,5,0,5
Mylisha,F,100,5,0,5
Mynasia,F,100,5,0,5
Mynesha,F,100,5,0,5
Mynette,F,100,5,0,5
Myniah,F,100,5,0,5
Myrene,F,100,5,0,5
Myrlene,F,100,5,0,5
Myunique,F,100,5,0,5
Naadir,M,100,0,5,5
Naadira,F,100,5,0,5
Nabhan,M,100,0,5,5
Nabhya,M,100,0,5,5
Nadalia,F,100,5,0,5
Nadara,F,100,5,0,5
Nadaya,F,100,5,0,5
Naelle,F,100,5,0,5
Naely,F,100,5,0,5
Naema,F,100,5,0,5
Naeyli,F,100,5,0,5
Nafees,M,100,0,5,5
Nafiz,M,100,0,5,5
Nagee,M,100,0,5,5
Nahari,F,100,5,0,5
Nahila,F,100,5,0,5
Nahir,M,100,0,5,5
Nahje,F,100,5,0,5
Nahlah,F,100,5,0,5
Nahya,F,100,5,0,5
Naiesha,F,100,5,0,5
Nailyn,F,100,5,0,5
Naiomy,F,100,5,0,5
Nairoby,F,100,5,0,5
Naissa,F,100,5,0,5
Naithyn,M,100,0,5,5
Najaya,F,100,5,0,5
Najilah,F,100,5,0,5
Najirah,F,100,5,0,5
Najmah,F,100,5,0,5
Nakala,F,100,5,0,5
Nakeeta,F,100,5,0,5
Nakesia,F,100,5,0,5
Nakiera,F,100,5,0,5
Nakina,F,100,5,0,5
Nakisa,F,100,5,0,5
Nakishia,F,100,5,0,5
Nakitta,F,100,5,0,5
Nakshatra,F,100,5,0,5
Nakylah,F,100,5,0,5
Nalee,F,100,5,0,5
Nalen,M,100,0,5,5
Nalene,F,100,5,0,5
Nalisa,F,100,5,0,5
Nalissa,F,100,5,0,5
Nalley,F,100,5,0,5
Nalya,F,100,5,0,5
Nanaadwoa,F,100,5,0,5
Nanaakua,F,100,5,0,5
Nanakwame,M,100,0,5,5
Nanda,F,100,5,0,5
Nandhan,M,100,0,5,5
Nandy,F,100,5,0,5
Nanett,F,100,5,0,5
Nanine,F,100,5,0,5
Narcissa,F,100,5,0,5
Narges,F,100,5,0,5
Narriah,F,100,5,0,5
Narvel,M,100,0,5,5
Naryia,F,100,5,0,5
Nasere,M,100,0,5,5
Nashanda,F,100,5,0,5
Nashanti,F,100,5,0,5
Nashaya,F,100,5,0,5
Nashell,F,100,5,0,5
Nashid,M,100,0,5,5
Nashiyah,F,100,5,0,5
Nashlly,F,100,5,0,5
Nashua,M,100,0,5,5
Nasiha,F,100,5,0,5
Nasrudin,M,100,0,5,5
Nastasja,F,100,5,0,5
Nasyr,M,100,0,5,5
Natae,F,100,5,0,5
Nataija,F,100,5,0,5
Nataja,F,100,5,0,5
Natara,F,100,5,0,5
Natasa,F,100,5,0,5
Natavius,M,100,0,5,5
Nateesha,F,100,5,0,5
Nathain,M,100,0,5,5
Natiana,F,100,5,0,5
Naticia,F,100,5,0,5
Natrice,F,100,5,0,5
Naudica,F,100,5,0,5
Nauman,M,100,0,5,5
Navaeha,F,100,5,0,5
Navay,F,100,5,0,5
Navian,M,100,0,5,5
Navika,F,100,5,0,5
Navleen,F,100,5,0,5
Navpreet,F,100,5,0,5
Navtej,M,100,0,5,5
Naweed,M,100,0,5,5
Nayalis,F,100,5,0,5
Nayani,F,100,5,0,5
Naydeline,F,100,5,0,5
Nayha,F,100,5,0,5
Nayleah,F,100,5,0,5
Naylene,F,100,5,0,5
Nayo,F,100,5,0,5
Nayzeth,F,100,5,0,5
Nazarene,F,100,5,0,5
Nazariyah,F,100,5,0,5
Nazere,M,100,0,5,5
Nazih,M,100,0,5,5
Nazire,M,100,0,5,5
Neaven,M,100,0,5,5
Necha,F,100,5,0,5
Nechemya,M,100,0,5,5
Nedda,F,100,5,0,5
Neelan,M,100,0,5,5
Neemah,F,100,5,0,5
Neesa,F,100,5,0,5
Negar,F,100,5,0,5
Nehan,M,100,0,5,5
Nehemyah,M,100,0,5,5
Neidra,F,100,5,0,5
Neilla,F,100,5,0,5
Neilpatrick,M,100,0,5,5
Neithen,M,100,0,5,5
Nejra,F,100,5,0,5
Nekiyah,F,100,5,0,5
Nekki,F,100,5,0,5
Nelcy,F,100,5,0,5
Neliah,F,100,5,0,5
Nelliel,F,100,5,0,5
Nelsi,F,100,5,0,5
Nemecio,M,100,0,5,5
Nenad,M,100,0,5,5
Nenah,F,100,5,0,5
Neno,M,100,0,5,5
Nerick,M,100,0,5,5
Nerisa,F,100,5,0,5
Neron,M,100,0,5,5
Nerrissa,F,100,5,0,5
Nerys,F,100,5,0,5
Neshelle,F,100,5,0,5
Nesma,F,100,5,0,5
Ness,M,100,0,5,5
Nester,M,100,0,5,5
Nestora,F,100,5,0,5
Nevaehmarie,F,100,5,0,5
Nevaehtnes,F,100,5,0,5
Nevon,M,100,0,5,5
Neydi,F,100,5,0,5
Ngawang,M,100,0,5,5
Nhyla,F,100,5,0,5
Ni,F,100,5,0,5
Niaisha,F,100,5,0,5
Nial,M,100,0,5,5
Nialani,F,100,5,0,5
Niayla,F,100,5,0,5
Nic,M,100,0,5,5
Niccola,F,100,5,0,5
Nicere,M,100,0,5,5
Nichalus,M,100,0,5,5
Nichaolas,M,100,0,5,5
Nichcole,F,100,5,0,5
Nicie,F,100,5,0,5
Nickalis,M,100,0,5,5
Nickelas,M,100,0,5,5
Nickesha,F,100,5,0,5
Niclaus,M,100,0,5,5
Nicle,F,100,5,0,5
Nicloe,F,100,5,0,5
Nicoel,F,100,5,0,5
Nicohlas,M,100,0,5,5
Nicoleta,F,100,5,0,5
Nicolett,F,100,5,0,5
Nicolus,M,100,0,5,5
Nicquan,M,100,0,5,5
Nieva,F,100,5,0,5
Nigella,F,100,5,0,5
Nigiel,M,100,0,5,5
Nihad,F,100,5,0,5
Nijal,M,100,0,5,5
Nijee,M,100,0,5,5
Nijha,F,100,5,0,5
Nijia,F,100,5,0,5
Nikhila,F,100,5,0,5
Nikina,F,100,5,0,5
Nikira,F,100,5,0,5
Nikishia,F,100,5,0,5
Nikolett,F,100,5,0,5
Nikolle,F,100,5,0,5
Nikte,F,100,5,0,5
Nilayah,F,100,5,0,5
Nimalan,M,100,0,5,5
Nimit,M,100,0,5,5
Ninasimone,F,100,5,0,5
Ninive,F,100,5,0,5
Nipun,M,100,0,5,5
Nirek,M,100,0,5,5
Nirja,F,100,5,0,5
Nirmal,M,100,0,5,5
Nisaa,F,100,5,0,5
Nish,M,100,0,5,5
Nishay,F,100,5,0,5
Nishitha,F,100,5,0,5
Nishta,F,100,5,0,5
Nisma,F,100,5,0,5
Nitaya,F,100,5,0,5
Nitesh,M,100,0,5,5
Nitoya,F,100,5,0,5
Nivayah,F,100,5,0,5
Nived,M,100,0,5,5
Niveditha,F,100,5,0,5
Nivin,M,100,0,5,5
Nixin,M,100,0,5,5
Niyomi,F,100,5,0,5
Nkenge,F,100,5,0,5
Nkiru,F,100,5,0,5
Noan,M,100,0,5,5
Noberto,M,100,0,5,5
Noellie,F,100,5,0,5
Nohe,M,100,0,5,5
Nohl,M,100,0,5,5
Nolene,F,100,5,0,5
Noli,F,100,5,0,5
Nolia,F,100,5,0,5
Nonah,F,100,5,0,5
Nonda,F,100,5,0,5
Noomi,F,100,5,0,5
Noon,F,100,5,0,5
Noorjahan,F,100,5,0,5
Noralie,F,100,5,0,5
Noralynn,F,100,5,0,5
Noran,F,100,5,0,5
Norb,M,100,0,5,5
Norean,F,100,5,0,5
Norena,F,100,5,0,5
Noriel,M,100,0,5,5
Normalinda,F,100,5,0,5
Normie,F,100,5,0,5
Norrie,F,100,5,0,5
Noshin,F,100,5,0,5
Noureen,F,100,5,0,5
Nourhan,F,100,5,0,5
Novel,M,100,0,5,5
Nowah,M,100,0,5,5
Nthony,M,100,0,5,5
Numair,M,100,0,5,5
Nureen,F,100,5,0,5
Nuriah,F,100,5,0,5
Nuzhat,F,100,5,0,5
Nyalah,F,100,5,0,5
Nyangel,F,100,5,0,5
Nyauna,F,100,5,0,5
Nyeasia,F,100,5,0,5
Nyemiah,F,100,5,0,5
Nyha,F,100,5,0,5
Nyiema,F,100,5,0,5
Nyier,M,100,0,5,5
Nyjel,M,100,0,5,5
Nykeemah,F,100,5,0,5
Nykeia,F,100,5,0,5
Nykel,M,100,0,5,5
Nylajah,F,100,5,0,5
Nyleen,F,100,5,0,5
Nylie,F,100,5,0,5
Nyliyah,F,100,5,0,5
Nyome,F,100,5,0,5
Nysaiah,M,100,0,5,5
Nyshaun,M,100,0,5,5
Nyshon,M,100,0,5,5
Nyzeria,F,100,5,0,5
Oaken,M,100,0,5,5
Oakly,M,100,0,5,5
Obada,M,100,0,5,5
Obeth,M,100,0,5,5
Obianuju,F,100,5,0,5
Ocasio,M,100,0,5,5
Octave,M,100,0,5,5
Odaly,F,100,5,0,5
Ohad,M,100,0,5,5
Ok,F,100,5,0,5
Okan,M,100,0,5,5
Olachi,F,100,5,0,5
Oladele,M,100,0,5,5
Olajuwan,M,100,0,5,5
Olea,F,100,5,0,5
Oleksiy,M,100,0,5,5
Olethea,F,100,5,0,5
Olinka,F,100,5,0,5
Olisha,F,100,5,0,5
Olivet,F,100,5,0,5
Olivette,F,100,5,0,5
Oliviaann,F,100,5,0,5
Oliviyah,F,100,5,0,5
Olly,M,100,0,5,5
Ololade,F,100,5,0,5
Olukayode,M,100,0,5,5
Olutoyin,F,100,5,0,5
Oluwabusola,F,100,5,0,5
Oluwadabira,F,100,5,0,5
Oluwafolajimi,M,100,0,5,5
Oluwafunmilola,F,100,5,0,5
Oluwajoba,M,100,0,5,5
Oluwakayode,M,100,0,5,5
Oluwamayomikun,M,100,0,5,5
Oluwapelumi,M,100,0,5,5
Oluwatise,F,100,5,0,5
Oluwatomi,M,100,0,5,5
Oluwatomilola,F,100,5,0,5
Olvia,F,100,5,0,5
Oman,M,100,0,5,5
Omani,M,100,0,5,5
Omi,M,100,0,5,5
Ong,F,100,5,0,5
Onia,F,100,5,0,5
Onnah,F,100,5,0,5
Onnaleigh,F,100,5,0,5
Onnika,F,100,5,0,5
Onterio,M,100,0,5,5
Onyekachi,M,100,0,5,5
Oralee,F,100,5,0,5
Orazio,M,100,0,5,5
Orene,F,100,5,0,5
Orianne,F,100,5,0,5
Orlyn,M,100,0,5,5
Orpah,F,100,5,0,5
Orris,M,100,0,5,5
Orryn,M,100,0,5,5
Orvan,M,100,0,5,5
Orvetta,F,100,5,0,5
Orvilla,F,100,5,0,5
Orya,F,100,5,0,5
Osamu,M,100,0,5,5
Osanna,F,100,5,0,5
Oshae,M,100,0,5,5
Osheanna,F,100,5,0,5
Oshua,M,100,0,5,5
Osinachi,M,100,0,5,5
Osker,M,100,0,5,5
Osmund,M,100,0,5,5
Osnas,F,100,5,0,5
Ostyn,M,100,0,5,5
Osyris,M,100,0,5,5
Otylia,F,100,5,0,5
Ouinton,M,100,0,5,5
Oval,M,100,0,5,5
Ovee,F,100,5,0,5
Oyuky,F,100,5,0,5
Oza,M,100,0,5,5
Ozair,M,100,0,5,5
Ozara,F,100,5,0,5
Pabel,M,100,0,5,5
Packer,M,100,0,5,5
Pader,F,100,5,0,5
Paedyn,F,100,5,0,5
Paelynn,F,100,5,0,5
Paig,F,100,5,0,5
Paitin,F,100,5,0,5
Pala,F,100,5,0,5
Palani,M,100,0,5,5
Pallas,F,100,5,0,5
Pamler,F,100,5,0,5
Panav,M,100,0,5,5
Pandi,F,100,5,0,5
Pandra,F,100,5,0,5
Pantaleon,M,100,0,5,5
Panthea,F,100,5,0,5
Panyia,F,100,5,0,5
Para,F,100,5,0,5
Pardis,F,100,5,0,5
Paresh,M,100,0,5,5
Pariis,F,100,5,0,5
Parinita,F,100,5,0,5
Parishay,F,100,5,0,5
Parmeet,M,100,0,5,5
Parthena,F,100,5,0,5
Parv,M,100,0,5,5
Pashance,F,100,5,0,5
Pashia,F,100,5,0,5
Pasqua,F,100,5,0,5
Pasqualino,M,100,0,5,5
Pataricia,F,100,5,0,5
Patia,F,100,5,0,5
Patiance,F,100,5,0,5
Patick,M,100,0,5,5
Paton,M,100,0,5,5
Patreece,F,100,5,0,5
Patrena,F,100,5,0,5
Patrenia,F,100,5,0,5
Patresa,F,100,5,0,5
Patriciann,F,100,5,0,5
Patriece,F,100,5,0,5
Patriot,M,100,0,5,5
Pattye,F,100,5,0,5
Patyn,F,100,5,0,5
Patzy,F,100,5,0,5
Paull,M,100,0,5,5
Paullina,F,100,5,0,5
Pavlo,M,100,0,5,5
Pavlos,M,100,0,5,5
Payce,M,100,0,5,5
Pearletha,F,100,5,0,5
Pearley,F,100,5,0,5
Pearlina,F,100,5,0,5
Pedrito,M,100,0,5,5
Pedrohenrique,M,100,0,5,5
Peirce,M,100,0,5,5
Peja,F,100,5,0,5
Pela,F,100,5,0,5
Penda,F,100,5,0,5
Penelopea,F,100,5,0,5
Peola,F,100,5,0,5
Peony,F,100,5,0,5
Peretz,M,100,0,5,5
Perianne,F,100,5,0,5
Perkins,M,100,0,5,5
Perryn,M,100,0,5,5
Persayis,F,100,5,0,5
Persephany,F,100,5,0,5
Pesach,M,100,0,5,5
Pessel,F,100,5,0,5
Pessi,F,100,5,0,5
Pessie,F,100,5,0,5
Petite,F,100,5,0,5
Petre,M,100,0,5,5
Petronilo,M,100,0,5,5
Petter,M,100,0,5,5
Petunia,F,100,5,0,5
Peyden,M,100,0,5,5
Peydon,M,100,0,5,5
Peytonn,F,100,5,0,5
Phaith,F,100,5,0,5
Phalicia,F,100,5,0,5
Phalon,M,100,0,5,5
Phanuel,M,100,0,5,5
Pharez,M,100,0,5,5
Pharyn,F,100,5,0,5
Phatima,F,100,5,0,5
Phelicity,F,100,5,0,5
Phelps,M,100,0,5,5
Philecia,F,100,5,0,5
Phillipp,M,100,0,5,5
Philomene,F,100,5,0,5
Phuonganh,F,100,5,0,5
Phylisia,F,100,5,0,5
Piera,F,100,5,0,5
Piere,M,100,0,5,5
Pierina,F,100,5,0,5
Pierston,M,100,0,5,5
Pleasant,M,100,0,5,5
Ples,M,100,0,5,5
Polaris,F,100,5,0,5
Policarpio,M,100,0,5,5
Pollux,M,100,0,5,5
Pomaikai,F,100,5,0,5
Poncho,M,100,0,5,5
Ponda,F,100,5,0,5
Poppi,F,100,5,0,5
Porshay,F,100,5,0,5
Prabhas,M,100,0,5,5
Prabin,M,100,0,5,5
Pradhyun,M,100,0,5,5
Prajin,M,100,0,5,5
Prajit,M,100,0,5,5
Prakrit,M,100,0,5,5
Pranati,F,100,5,0,5
Pranesh,M,100,0,5,5
Pranil,M,100,0,5,5
Pratyusha,F,100,5,0,5
Praveer,M,100,0,5,5
Pravin,M,100,0,5,5
Prayag,M,100,0,5,5
Prayan,M,100,0,5,5
Prayash,M,100,0,5,5
Preana,F,100,5,0,5
Precius,F,100,5,0,5
Precyous,F,100,5,0,5
Preesha,F,100,5,0,5
Premal,M,100,0,5,5
Premier,M,100,0,5,5
Prescious,F,100,5,0,5
Presilla,F,100,5,0,5
Prestan,M,100,0,5,5
Prestina,F,100,5,0,5
Preya,F,100,5,0,5
Prianna,F,100,5,0,5
Pricillia,F,100,5,0,5
Prima,F,100,5,0,5
Princecharles,M,100,0,5,5
Princes,F,100,5,0,5
Princetin,M,100,0,5,5
Princetta,F,100,5,0,5
Priyanshi,F,100,5,0,5
Proctor,M,100,0,5,5
Promize,F,100,5,0,5
Prynn,F,100,5,0,5
Ptosha,F,100,5,0,5
Purab,M,100,0,5,5
Purva,F,100,5,0,5
Qadirah,F,100,5,0,5
Qaiden,M,100,0,5,5
Quaashie,M,100,0,5,5
Quadere,M,100,0,5,5
Quamar,M,100,0,5,5
Quameer,M,100,0,5,5
Quanae,F,100,5,0,5
Quanetra,F,100,5,0,5
Quaniesha,F,100,5,0,5
Quanna,F,100,5,0,5
Quantay,M,100,0,5,5
Quantel,M,100,0,5,5
Quantella,F,100,5,0,5
Quanterius,M,100,0,5,5
Quanterrious,M,100,0,5,5
Quatez,M,100,0,5,5
Quatia,F,100,5,0,5
Quayshawn,M,100,0,5,5
Queency,F,100,5,0,5
Quenetta,F,100,5,0,5
Quenette,F,100,5,0,5
Quentine,M,100,0,5,5
Quesha,F,100,5,0,5
Queston,M,100,0,5,5
Quetcy,F,100,5,0,5
Quetzalcoatl,M,100,0,5,5
Quetzally,F,100,5,0,5
Quetzy,F,100,5,0,5
Quill,M,100,0,5,5
Quilla,F,100,5,0,5
Quillian,M,100,0,5,5
Quinasia,F,100,5,0,5
Quinell,M,100,0,5,5
Quineshia,F,100,5,0,5
Quinleigh,F,100,5,0,5
Quinna,F,100,5,0,5
Quinshay,F,100,5,0,5
Quintarus,M,100,0,5,5
Quintavia,F,100,5,0,5
Quinterria,F,100,5,0,5
Quintesha,F,100,5,0,5
Quintia,F,100,5,0,5
Quintrel,M,100,0,5,5
Quinya,F,100,5,0,5
Quiton,M,100,0,5,5
Quiyana,F,100,5,0,5
Quortney,F,100,5,0,5
Quynhnhu,F,100,5,0,5
Qwynn,F,100,5,0,5
Ra,F,100,5,0,5
Raaid,M,100,0,5,5
Rabekka,F,100,5,0,5
Rabi,M,100,0,5,5
Rabih,M,100,0,5,5
Rabiya,F,100,5,0,5
Rabon,M,100,0,5,5
Racen,M,100,0,5,5
Rachad,M,100,0,5,5
Raciel,M,100,0,5,5
Racin,M,100,0,5,5
Radcliffe,M,100,0,5,5
Radeen,M,100,0,5,5
Radene,F,100,5,0,5
Radia,F,100,5,0,5
Radyn,M,100,0,5,5
Raeah,F,100,5,0,5
Raegin,F,100,5,0,5
Raejon,M,100,0,5,5
Raelean,F,100,5,0,5
Raelyne,F,100,5,0,5
Raemon,M,100,0,5,5
Raenada,F,100,5,0,5
Raenesha,F,100,5,0,5
Raenette,F,100,5,0,5
Raesean,M,100,0,5,5
Raeshelle,F,100,5,0,5
Raevan,F,100,5,0,5
Raevynn,F,100,5,0,5
Rafat,M,100,0,5,5
Rafid,M,100,0,5,5
Raford,M,100,0,5,5
Ragena,F,100,5,0,5
Rahab,F,100,5,0,5
Rahanna,F,100,5,0,5
Rahcel,F,100,5,0,5
Rahmeek,M,100,0,5,5
Rahniyah,F,100,5,0,5
Rahshon,M,100,0,5,5
Raiah,F,100,5,0,5
Raika,F,100,5,0,5
Raileen,F,100,5,0,5
Railynne,F,100,5,0,5
Raimond,M,100,0,5,5
Raines,M,100,0,5,5
Rajae,M,100,0,5,5
Rajahn,M,100,0,5,5
Rajat,M,100,0,5,5
Raji,M,100,0,5,5
Rajni,F,100,5,0,5
Rakhia,F,100,5,0,5
Rakiah,F,100,5,0,5
Rakya,F,100,5,0,5
Rakye,M,100,0,5,5
Raland,M,100,0,5,5
Raliegh,M,100,0,5,5
Ralinda,F,100,5,0,5
Ralisha,F,100,5,0,5
Ramaj,M,100,0,5,5
Ramandeep,F,100,5,0,5
Ramarion,M,100,0,5,5
Rameel,M,100,0,5,5
Ramero,M,100,0,5,5
Ramisa,F,100,5,0,5
Ramisha,F,100,5,0,5
Ramos,M,100,0,5,5
Ranaa,F,100,5,0,5
Ranald,M,100,0,5,5
Ranard,M,100,0,5,5
Randalynn,F,100,5,0,5
Randeen,F,100,5,0,5
Randene,F,100,5,0,5
Randey,M,100,0,5,5
Randloph,M,100,0,5,5
Randoph,M,100,0,5,5
Raniel,M,100,0,5,5
Rannie,F,100,5,0,5
Ranylah,F,100,5,0,5
Raquita,F,100,5,0,5
Rasan,M,100,0,5,5
Raschad,M,100,0,5,5
Rashele,F,100,5,0,5
Rashema,F,100,5,0,5
Rashia,F,100,5,0,5
Rashieka,F,100,5,0,5
Rashiem,M,100,0,5,5
Rashiyah,F,100,5,0,5
Rashya,F,100,5,0,5
Rasiyah,F,100,5,0,5
Ratan,M,100,0,5,5
Ratha,M,100,0,5,5
Ratzy,F,100,5,0,5
Raushana,F,100,5,0,5
Ravina,F,100,5,0,5
Ravinder,M,100,0,5,5
Ravine,F,100,5,0,5
Ravya,F,100,5,0,5
Rawda,F,100,5,0,5
Rawland,M,100,0,5,5
Rawle,M,100,0,5,5
Rayborn,M,100,0,5,5
Raycin,M,100,0,5,5
Raydene,F,100,5,0,5
Rayelyn,F,100,5,0,5
Rayfe,M,100,0,5,5
Raylah,F,100,5,0,5
Raylean,F,100,5,0,5
Raylend,M,100,0,5,5
Raylenn,F,100,5,0,5
Raymoni,F,100,5,0,5
Rayniah,F,100,5,0,5
Raynier,M,100,0,5,5
Raynika,F,100,5,0,5
Rayquon,M,100,0,5,5
Rayqwon,M,100,0,5,5
Rayshod,M,100,0,5,5
Rayvion,M,100,0,5,5
Rayyaan,M,100,0,5,5
Raz,M,100,0,5,5
Razel,F,100,5,0,5
Razia,F,100,5,0,5
Reachel,F,100,5,0,5
Reaganne,F,100,5,0,5
Reagin,F,100,5,0,5
Realynn,F,100,5,0,5
Reanee,F,100,5,0,5
Reannen,F,100,5,0,5
Rebekha,F,100,5,0,5
Rebella,F,100,5,0,5
Rececca,F,100,5,0,5
Reche,M,100,0,5,5
Rechele,F,100,5,0,5
Reddick,M,100,0,5,5
Redena,F,100,5,0,5
Redgie,M,100,0,5,5
Redia,F,100,5,0,5
Reeder,M,100,0,5,5
Reeselyn,F,100,5,0,5
Reeyan,M,100,0,5,5
Reford,M,100,0,5,5
Regen,F,100,5,0,5
Regenna,F,100,5,0,5
Reginea,F,100,5,0,5
Regional,M,100,0,5,5
Regla,F,100,5,0,5
Rehgan,F,100,5,0,5
Reiana,F,100,5,0,5
Reicher,M,100,0,5,5
Reimundo,M,100,0,5,5
Reinna,F,100,5,0,5
Reisa,F,100,5,0,5
Reiter,M,100,0,5,5
Rem,M,100,0,5,5
Rembert,M,100,0,5,5
Remey,F,100,5,0,5
Remick,M,100,0,5,5
Remone,M,100,0,5,5
Remonica,F,100,5,0,5
Renaee,F,100,5,0,5
Renaud,M,100,0,5,5
Rendall,M,100,0,5,5
Renecia,F,100,5,0,5
Renegade,M,100,0,5,5
Renetha,F,100,5,0,5
Renezmay,F,100,5,0,5
Renezme,F,100,5,0,5
Renica,F,100,5,0,5
Rennis,M,100,0,5,5
Reona,F,100,5,0,5
Resham,F,100,5,0,5
Reshawna,F,100,5,0,5
Reshmi,F,100,5,0,5
Reus,M,100,0,5,5
Rev,M,100,0,5,5
Rexie,M,100,0,5,5
Reyce,M,100,0,5,5
Reyd,M,100,0,5,5
Reyelle,F,100,5,0,5
Reyez,M,100,0,5,5
Reylene,F,100,5,0,5
Reymi,M,100,0,5,5
Reyon,M,100,0,5,5
Rezon,M,100,0,5,5
Rhae,F,100,5,0,5
Rhanada,F,100,5,0,5
Rhanda,F,100,5,0,5
Rhapsody,F,100,5,0,5
Rhaven,F,100,5,0,5
Rhileigh,F,100,5,0,5
Rhoads,M,100,0,5,5
Rhoan,M,100,0,5,5
Rhoderick,M,100,0,5,5
Rhodia,F,100,5,0,5
Rhodora,F,100,5,0,5
Rhoen,M,100,0,5,5
Rhonald,M,100,0,5,5
Rhondalyn,F,100,5,0,5
Rhondi,F,100,5,0,5
Rhye,M,100,0,5,5
Rhyin,F,100,5,0,5
Rhyla,F,100,5,0,5
Rianshi,F,100,5,0,5
Rickeisha,F,100,5,0,5
Riddik,M,100,0,5,5
Ridger,M,100,0,5,5
Ridgley,M,100,0,5,5
Ridlee,F,100,5,0,5
Rie,F,100,5,0,5
Riella,F,100,5,0,5
Ries,M,100,0,5,5
Riesa,F,100,5,0,5
Riggen,M,100,0,5,5
Rigsby,M,100,0,5,5
Riha,F,100,5,0,5
Rihab,F,100,5,0,5
Rihansh,M,100,0,5,5
Rihonna,F,100,5,0,5
Riis,M,100,0,5,5
Rija,F,100,5,0,5
Rijad,M,100,0,5,5
Riketa,F,100,5,0,5
Rikkia,F,100,5,0,5
Rikyah,F,100,5,0,5
Rilah,F,100,5,0,5
Rilea,F,100,5,0,5
Rileyanne,F,100,5,0,5
Riloh,F,100,5,0,5
Rilwan,M,100,0,5,5
Rinad,F,100,5,0,5
Rintaro,M,100,0,5,5
Ripal,M,100,0,5,5
Risako,F,100,5,0,5
Rishona,F,100,5,0,5
Ristina,F,100,5,0,5
Riston,M,100,0,5,5
Ritch,M,100,0,5,5
Rithanya,F,100,5,0,5
Ritta,F,100,5,0,5
Rittal,F,100,5,0,5
Ritvika,F,100,5,0,5
Riyanshi,F,100,5,0,5
Riyaq,F,100,5,0,5
Riyaz,M,100,0,5,5
Riyon,M,100,0,5,5
Roary,M,100,0,5,5
Robertlee,M,100,0,5,5
Robertmichael,M,100,0,5,5
Robia,F,100,5,0,5
Robinann,F,100,5,0,5
Robine,F,100,5,0,5
Robins,M,100,0,5,5
Robroy,M,100,0,5,5
Rocelyn,F,100,5,0,5
Rochely,F,100,5,0,5
Rocker,M,100,0,5,5
Rockson,M,100,0,5,5
Rodas,F,100,5,0,5
Rodena,F,100,5,0,5
Rodeny,M,100,0,5,5
Roderrick,M,100,0,5,5
Rodick,M,100,0,5,5
Rodneshia,F,100,5,0,5
Rodnie,M,100,0,5,5
Rodolph,M,100,0,5,5
Rodregus,M,100,0,5,5
Rodrekus,M,100,0,5,5
Rodrigus,M,100,0,5,5
Rodrion,M,100,0,5,5
Roetta,F,100,5,0,5
Roget,M,100,0,5,5
Rohanpreet,M,100,0,5,5
Rohman,M,100,0,5,5
Rohnda,F,100,5,0,5
Rokaya,F,100,5,0,5
Rokeisha,F,100,5,0,5
Rokeya,F,100,5,0,5
Rolen,M,100,0,5,5
Rollene,F,100,5,0,5
Romaldo,M,100,0,5,5
Romane,M,100,0,5,5
Romania,F,100,5,0,5
Romare,M,100,0,5,5
Romere,M,100,0,5,5
Rometta,F,100,5,0,5
Romia,F,100,5,0,5
Romika,F,100,5,0,5
Romil,M,100,0,5,5
Romilly,F,100,5,0,5
Romiyah,F,100,5,0,5
Ronalyn,F,100,5,0,5
Rondarious,M,100,0,5,5
Rondia,F,100,5,0,5
Rondre,M,100,0,5,5
Ronea,F,100,5,0,5
Roneesha,F,100,5,0,5
Ronicia,F,100,5,0,5
Ronishia,F,100,5,0,5
Ronne,M,100,0,5,5
Ronnee,F,100,5,0,5
Ronneka,F,100,5,0,5
Ronnella,F,100,5,0,5
Ronreco,M,100,0,5,5
Rontae,M,100,0,5,5
Rontavia,F,100,5,0,5
Rooks,M,100,0,5,5
Roqaya,F,100,5,0,5
Rorick,M,100,0,5,5
Rorry,M,100,0,5,5
Rosalei,F,100,5,0,5
Rosaliyah,F,100,5,0,5
Rosalynd,F,100,5,0,5
Rosandra,F,100,5,0,5
Rosangel,F,100,5,0,5
Roschell,F,100,5,0,5
Rosea,F,100,5,0,5
Rosealie,F,100,5,0,5
Roseellen,F,100,5,0,5
Rosemond,F,100,5,0,5
Rosh,M,100,0,5,5
Roshaud,M,100,0,5,5
Roshika,F,100,5,0,5
Roshonna,F,100,5,0,5
Rosilynn,F,100,5,0,5
Rosmarie,F,100,5,0,5
Rosselin,F,100,5,0,5
Rotem,F,100,5,0,5
Rotunda,F,100,5,0,5
Rouchelle,F,100,5,0,5
Rouguiatou,F,100,5,0,5
Rovenia,F,100,5,0,5
Rowann,F,100,5,0,5
Roxeann,F,100,5,0,5
Roxen,M,100,0,5,5
Roxsana,F,100,5,0,5
Royaltee,F,100,5,0,5
Royan,M,100,0,5,5
Roye,M,100,0,5,5
Rozalee,F,100,5,0,5
Rozalin,F,100,5,0,5
Rozaria,F,100,5,0,5
Rozay,M,100,0,5,5
Rozie,F,100,5,0,5
Rozilyn,F,100,5,0,5
Rozina,F,100,5,0,5
Roziya,F,100,5,0,5
Rozzlyn,F,100,5,0,5
Ruban,M,100,0,5,5
Rubena,F,100,5,0,5
Rubia,F,100,5,0,5
Rubisela,F,100,5,0,5
Rubith,F,100,5,0,5
Rubyrose,F,100,5,0,5
Ruchika,F,100,5,0,5
Ruddie,M,100,0,5,5
Rudyard,M,100,0,5,5
Ruiqi,F,100,5,0,5
Rumalda,F,100,5,0,5
Ruman,F,100,5,0,5
Rumer,F,100,5,0,5
Runda,F,100,5,0,5
Runell,F,100,5,0,5
Rusbel,M,100,0,5,5
Rushad,M,100,0,5,5
Rushank,M,100,0,5,5
Rushie,F,100,5,0,5
Ruthell,F,100,5,0,5
Ruthellen,F,100,5,0,5
Ruthi,F,100,5,0,5
Ruthine,F,100,5,0,5
Rutvik,M,100,0,5,5
Ruxton,M,100,0,5,5
Ruzanna,F,100,5,0,5
Ryanjames,M,100,0,5,5
Ryanjay,M,100,0,5,5
Ryanjoseph,M,100,0,5,5
Ryanpatrick,M,100,0,5,5
Ryanpaul,M,100,0,5,5
Ryat,M,100,0,5,5
Ryeisha,F,100,5,0,5
Ryel,M,100,0,5,5
Rykan,M,100,0,5,5
Ryna,F,100,5,0,5
Ryniah,F,100,5,0,5
Rynleigh,F,100,5,0,5
Ryuichi,M,100,0,5,5
Ryyan,M,100,0,5,5
Saadiyah,F,100,5,0,5
Saajan,M,100,0,5,5
Saajida,F,100,5,0,5
Saalih,M,100,0,5,5
Saamya,F,100,5,0,5
Saaniya,F,100,5,0,5
Saaniyah,F,100,5,0,5
Saanjh,F,100,5,0,5
Saavan,M,100,0,5,5
Sabatino,M,100,0,5,5
Sabela,F,100,5,0,5
Sabirah,F,100,5,0,5
Sabriana,F,100,5,0,5
Sabrielle,F,100,5,0,5
Sabrinah,F,100,5,0,5
Sadan,F,100,5,0,5
Sadaya,F,100,5,0,5
Saddiq,M,100,0,5,5
Sadeem,F,100,5,0,5
Sadhvi,F,100,5,0,5
Sadiah,F,100,5,0,5
Sadiee,F,100,5,0,5
Sadman,M,100,0,5,5
Saedi,F,100,5,0,5
Saelah,F,100,5,0,5
Safah,F,100,5,0,5
Safal,M,100,0,5,5
Safee,M,100,0,5,5
Safeerah,F,100,5,0,5
Saffa,F,100,5,0,5
Saffiya,F,100,5,0,5
Safiye,F,100,5,0,5
Sahaan,M,100,0,5,5
Sahaana,F,100,5,0,5
Saheb,M,100,0,5,5
Saheli,F,100,5,0,5
Sahitya,F,100,5,0,5
Sahiyah,F,100,5,0,5
Sahni,F,100,5,0,5
Sahnnon,F,100,5,0,5
Sahr,M,100,0,5,5
Saidou,M,100,0,5,5
Saied,M,100,0,5,5
Saifaldeen,M,100,0,5,5
Saija,F,100,5,0,5
Sainabou,F,100,5,0,5
Saion,M,100,0,5,5
Saith,M,100,0,5,5
Saiyuri,F,100,5,0,5
Sajah,F,100,5,0,5
Saji,M,100,0,5,5
Sajidah,F,100,5,0,5
Sakhia,F,100,5,0,5
Sakora,F,100,5,0,5
Sakthi,F,100,5,0,5
Salaam,M,100,0,5,5
Saleha,F,100,5,0,5
Saliou,M,100,0,5,5
Salisa,F,100,5,0,5
Salita,F,100,5,0,5
Salsabeel,F,100,5,0,5
Salyna,F,100,5,0,5
Samaah,F,100,5,0,5
Samaara,F,100,5,0,5
Samahj,M,100,0,5,5
Samanthe,F,100,5,0,5
Samare,F,100,5,0,5
Samarpreet,M,100,0,5,5
Sameen,F,100,5,0,5
Sameena,F,100,5,0,5
Sameika,F,100,5,0,5
Samentha,F,100,5,0,5
Samet,M,100,0,5,5
Sameyah,F,100,5,0,5
Samiel,M,100,0,5,5
Samihah,F,100,5,0,5
Samisoni,M,100,0,5,5
Samiullah,M,100,0,5,5
Sammiyah,F,100,5,0,5
Sammyjo,F,100,5,0,5
Samory,M,100,0,5,5
Samridh,M,100,0,5,5
Samrudh,M,100,0,5,5
Samuela,M,100,0,5,5
Samueldavid,M,100,0,5,5
Samuil,M,100,0,5,5
Samyla,F,100,5,0,5
Samyr,M,100,0,5,5
Sanaaya,F,100,5,0,5
Sanaria,F,100,5,0,5
Sand,F,100,5,0,5
Sandara,F,100,5,0,5
Sandia,F,100,5,0,5
Sandre,F,100,5,0,5
Sandye,F,100,5,0,5
Sangria,F,100,5,0,5
Saniy,F,100,5,0,5
Saniyaa,F,100,5,0,5
Sanjida,F,100,5,0,5
Santavious,M,100,0,5,5
Santeria,F,100,5,0,5
Santez,M,100,0,5,5
Santoi,M,100,0,5,5
Santosha,F,100,5,0,5
Santoya,F,100,5,0,5
Santrell,F,100,5,0,5
Santrice,F,100,5,0,5
Santricia,F,100,5,0,5
Sanyu,F,100,5,0,5
Sapan,M,100,0,5,5
Saphirah,F,100,5,0,5
Saqqara,F,100,5,0,5
Saquoya,F,100,5,0,5
Sarahlyn,F,100,5,0,5
Sarahmae,F,100,5,0,5
Sarahrose,F,100,5,0,5
Saraina,F,100,5,0,5
Sarajo,F,100,5,0,5
Sarang,F,100,5,0,5
Saratha,F,100,5,0,5
Sareli,F,100,5,0,5
Sarem,F,100,5,0,5
Sarenna,F,100,5,0,5
Sarh,F,100,5,0,5
Sariaha,F,100,5,0,5
Sarii,F,100,5,0,5
Sarine,F,100,5,0,5
Sarmad,M,100,0,5,5
Sarom,M,100,0,5,5
Saronda,F,100,5,0,5
Saroya,F,100,5,0,5
Sarp,M,100,0,5,5
Sashae,F,100,5,0,5
Sashi,F,100,5,0,5
Satish,M,100,0,5,5
Satomi,F,100,5,0,5
Satoshi,M,100,0,5,5
Satyam,M,100,0,5,5
Satyana,F,100,5,0,5
Saumil,M,100,0,5,5
Sauna,F,100,5,0,5
Savannahgrace,F,100,5,0,5
Savannahjo,F,100,5,0,5
Savannahrose,F,100,5,0,5
Savant,M,100,0,5,5
Savilla,F,100,5,0,5
Savy,F,100,5,0,5
Savya,F,100,5,0,5
Sayani,F,100,5,0,5
Saylee,F,100,5,0,5
Saylem,F,100,5,0,5
Sayumi,F,100,5,0,5
Scarlytt,F,100,5,0,5
Schafer,M,100,0,5,5
Schlonda,F,100,5,0,5
Schmeka,F,100,5,0,5
Schwanna,F,100,5,0,5
Scottia,F,100,5,0,5
Scottland,M,100,0,5,5
Scyler,F,100,5,0,5
Seabron,M,100,0,5,5
Seamon,M,100,0,5,5
Seananthony,M,100,0,5,5
Seattle,F,100,5,0,5
Sebatian,M,100,0,5,5
Sebrenia,F,100,5,0,5
Sebron,M,100,0,5,5
Seela,F,100,5,0,5
Segen,F,100,5,0,5
Seianna,F,100,5,0,5
Selden,M,100,0,5,5
Selenne,F,100,5,0,5
Selest,F,100,5,0,5
Selman,M,100,0,5,5
Selmer,M,100,0,5,5
Selso,M,100,0,5,5
Semajae,F,100,5,0,5
Semaria,F,100,5,0,5
Semirah,F,100,5,0,5
Semra,F,100,5,0,5
Senaca,M,100,0,5,5
Senada,F,100,5,0,5
Sendi,F,100,5,0,5
Senequa,F,100,5,0,5
Senetra,F,100,5,0,5
Senon,M,100,0,5,5
Senteria,F,100,5,0,5
Sephra,F,100,5,0,5
Seqouia,F,100,5,0,5
Sequena,F,100,5,0,5
Sequina,F,100,5,0,5
Serafima,F,100,5,0,5
Seraph,M,100,0,5,5
Seras,F,100,5,0,5
Serenia,F,100,5,0,5
Serhat,M,100,0,5,5
Seriena,F,100,5,0,5
Serigo,M,100,0,5,5
Serine,F,100,5,0,5
Seritta,F,100,5,0,5
Serrah,F,100,5,0,5
Serriah,F,100,5,0,5
Seslie,F,100,5,0,5
Setara,F,100,5,0,5
Seung,M,100,0,5,5
Sevaeh,F,100,5,0,5
Sevak,M,100,0,5,5
Severine,F,100,5,0,5
Severus,M,100,0,5,5
Sevion,M,100,0,5,5
Sevrin,M,100,0,5,5
Sevryn,M,100,0,5,5
Sevynn,F,100,5,0,5
Sewell,M,100,0,5,5
Seyha,M,100,0,5,5
Shaana,F,100,5,0,5
Shaba,M,100,0,5,5
Shabina,F,100,5,0,5
Shabrea,F,100,5,0,5
Shacole,F,100,5,0,5
Shacourtney,F,100,5,0,5
Shadaja,F,100,5,0,5
Shadasha,F,100,5,0,5
Shadeja,F,100,5,0,5
Shadiyah,F,100,5,0,5
Shadon,M,100,0,5,5
Shadrika,F,100,5,0,5
Shaedon,M,100,0,5,5
Shaghayegh,F,100,5,0,5
Shahaan,M,100,0,5,5
Shahbaz,M,100,0,5,5
Shaheeda,F,100,5,0,5
Shaheerah,F,100,5,0,5
Shaherah,F,100,5,0,5
Shahnawaz,M,100,0,5,5
Shahnaz,F,100,5,0,5
Shahriar,M,100,0,5,5
Shahryar,M,100,0,5,5
Shahzoda,F,100,5,0,5
Shaia,F,100,5,0,5
Shaiquan,M,100,0,5,5
Shaiya,F,100,5,0,5
Shakaira,F,100,5,0,5
Shakaiya,F,100,5,0,5
Shakaria,F,100,5,0,5
Shakaya,F,100,5,0,5
Shakeenah,F,100,5,0,5
Shakethia,F,100,5,0,5
Shakeyia,F,100,5,0,5
Shaki,M,100,0,5,5
Shakib,M,100,0,5,5
Shakiria,F,100,5,0,5
Shakota,F,100,5,0,5
Shalanna,F,100,5,0,5
Shalece,F,100,5,0,5
Shaleigha,F,100,5,0,5
Shaleka,F,100,5,0,5
Shaleshia,F,100,5,0,5
Shalla,F,100,5,0,5
Shalone,F,100,5,0,5
Shalya,F,100,5,0,5
Shalynne,F,100,5,0,5
Shalyssa,F,100,5,0,5
Shamaar,M,100,0,5,5
Shamala,F,100,5,0,5
Shaman,M,100,0,5,5
Shamanique,F,100,5,0,5
Shamariah,F,100,5,0,5
Shamarria,F,100,5,0,5
Shameia,F,100,5,0,5
Shamella,F,100,5,0,5
Shamese,F,100,5,0,5
Shamise,F,100,5,0,5
Shamma,F,100,5,0,5
Shammara,F,100,5,0,5
Shamonia,F,100,5,0,5
Shamora,F,100,5,0,5
Shamsa,F,100,5,0,5
Shamyiah,F,100,5,0,5
Shanasha,F,100,5,0,5
Shanaz,F,100,5,0,5
Shandiin,F,100,5,0,5
Shanean,F,100,5,0,5
Shanella,F,100,5,0,5
Shaneqwa,F,100,5,0,5
Shanetria,F,100,5,0,5
Shaniaya,F,100,5,0,5
Shaniel,F,100,5,0,5
Shanila,F,100,5,0,5
Shanitta,F,100,5,0,5
Shanmukh,M,100,0,5,5
Shannara,F,100,5,0,5
Shanque,F,100,5,0,5
Shanquel,F,100,5,0,5
Shanquil,F,100,5,0,5
Shantania,F,100,5,0,5
Shantanique,F,100,5,0,5
Shantasha,F,100,5,0,5
Shantey,F,100,5,0,5
Shanteya,F,100,5,0,5
Shanthi,F,100,5,0,5
Shantih,F,100,5,0,5
Shantiqua,F,100,5,0,5
Shantoya,F,100,5,0,5
Shantrelle,F,100,5,0,5
Shantrese,F,100,5,0,5
Shanygne,F,100,5,0,5
Shanylah,F,100,5,0,5
Shanza,F,100,5,0,5
Shaphan,M,100,0,5,5
Shaqua,F,100,5,0,5
Shaquale,F,100,5,0,5
Shaquania,F,100,5,0,5
Shaque,F,100,5,0,5
Shaquesha,F,100,5,0,5
Shaquette,F,100,5,0,5
Shaquin,F,100,5,0,5
Shaquina,F,100,5,0,5
Shaqwana,F,100,5,0,5
Sharal,F,100,5,0,5
Shardea,F,100,5,0,5
Shardee,F,100,5,0,5
Shareema,F,100,5,0,5
Shareeta,F,100,5,0,5
Sharema,F,100,5,0,5
Sharette,F,100,5,0,5
Sharey,F,100,5,0,5
Sharian,F,100,5,0,5
Shariq,M,100,0,5,5
Sharl,F,100,5,0,5
Sharlita,F,100,5,0,5
Sharlot,F,100,5,0,5
Sharn,M,100,0,5,5
Sharnece,F,100,5,0,5
Sharnisha,F,100,5,0,5
Sharrah,F,100,5,0,5
Sharrel,F,100,5,0,5
Sharrieff,M,100,0,5,5
Sharrika,F,100,5,0,5
Sharunda,F,100,5,0,5
Shashona,F,100,5,0,5
Shatell,F,100,5,0,5
Shatema,F,100,5,0,5
Shatila,F,100,5,0,5
Shatiqua,F,100,5,0,5
Shatique,M,100,0,5,5
Shatorria,F,100,5,0,5
Shaughnessy,F,100,5,0,5
Shaundale,M,100,0,5,5
Shaundell,M,100,0,5,5
Shaundreka,F,100,5,0,5
Shaundria,F,100,5,0,5
Shaunti,F,100,5,0,5
Shauntina,F,100,5,0,5
Shaurice,F,100,5,0,5
Shavada,F,100,5,0,5
Shavae,F,100,5,0,5
Shawday,F,100,5,0,5
Shawen,M,100,0,5,5
Shawnacy,F,100,5,0,5
Shawnay,F,100,5,0,5
Shawndel,M,100,0,5,5
Shawnea,F,100,5,0,5
Shawntal,F,100,5,0,5
Shawntaya,F,100,5,0,5
Shawntea,F,100,5,0,5
Shawntika,F,100,5,0,5
Shawona,F,100,5,0,5
Shaylor,M,100,0,5,5
Shayni,F,100,5,0,5
Shaza,F,100,5,0,5
Shearl,M,100,0,5,5
Sheffield,M,100,0,5,5
Sheik,M,100,0,5,5
Sheikha,F,100,5,0,5
Sheilda,F,100,5,0,5
Sheindel,F,100,5,0,5
Sheketa,F,100,5,0,5
Sheku,M,100,0,5,5
Sheldrick,M,100,0,5,5
Shelea,F,100,5,0,5
Shelette,F,100,5,0,5
Sheley,F,100,5,0,5
Shelinda,F,100,5,0,5
Sheliya,F,100,5,0,5
Sheliza,F,100,5,0,5
Shellbie,F,100,5,0,5
Shellsea,F,100,5,0,5
Shellyann,F,100,5,0,5
Shelon,F,100,5,0,5
Shely,F,100,5,0,5
Shemariah,F,100,5,0,5
Shemeeka,F,100,5,0,5
Shemera,F,100,5,0,5
Shemita,F,100,5,0,5
Shenai,F,100,5,0,5
Shenan,F,100,5,0,5
Shenaye,F,100,5,0,5
Sheniah,F,100,5,0,5
Shenitra,F,100,5,0,5
Sheniyah,F,100,5,0,5
Shennan,F,100,5,0,5
Shep,M,100,0,5,5
Shephanie,F,100,5,0,5
Shequilla,F,100,5,0,5
Sheraton,M,100,0,5,5
Sherdina,F,100,5,0,5
Shereca,F,100,5,0,5
Shereeta,F,100,5,0,5
Sherelyn,F,100,5,0,5
Sheretha,F,100,5,0,5
Sherial,F,100,5,0,5
Sherlon,F,100,5,0,5
Shernard,M,100,0,5,5
Sherrae,F,100,5,0,5
Sherreka,F,100,5,0,5
Sherrena,F,100,5,0,5
Sherrilee,F,100,5,0,5
Sherris,F,100,5,0,5
Sherrl,F,100,5,0,5
Sherryle,F,100,5,0,5
Sherwanda,F,100,5,0,5
Sherye,F,100,5,0,5
Shevella,F,100,5,0,5
Shevi,F,100,5,0,5
Shevin,M,100,0,5,5
Shewana,F,100,5,0,5
Shiena,F,100,5,0,5
Shiheim,M,100,0,5,5
Shiho,F,100,5,0,5
Shikera,F,100,5,0,5
Shikeria,F,100,5,0,5
Shilyn,F,100,5,0,5
Shima,F,100,5,0,5
Shimeek,M,100,0,5,5
Shimya,F,100,5,0,5
Shindana,F,100,5,0,5
Shinequa,F,100,5,0,5
Shingo,M,100,0,5,5
Shiphrah,F,100,5,0,5
Shirae,F,100,5,0,5
Shirletta,F,100,5,0,5
Shiron,M,100,0,5,5
Shirron,F,100,5,0,5
Shiryl,F,100,5,0,5
Shishir,M,100,0,5,5
Shivaansh,M,100,0,5,5
Shivraj,M,100,0,5,5
Shley,F,100,5,0,5
Shmeil,M,100,0,5,5
Shmya,F,100,5,0,5
Shogo,M,100,0,5,5
Shoko,F,100,5,0,5
Shonae,F,100,5,0,5
Shondreka,F,100,5,0,5
Shonnell,F,100,5,0,5
Shonnetta,F,100,5,0,5
Shonni,F,100,5,0,5
Shontal,F,100,5,0,5
Shontea,F,100,5,0,5
Shontez,M,100,0,5,5
Shontrice,F,100,5,0,5
Shoran,F,100,5,0,5
Shoshone,F,100,5,0,5
Shovonne,F,100,5,0,5
Shreehan,M,100,0,5,5
Shreen,F,100,5,0,5
Shreyasi,F,100,5,0,5
Shrinidhi,F,100,5,0,5
Shriram,M,100,0,5,5
Shrita,F,100,5,0,5
Shriyaan,M,100,0,5,5
Shryl,F,100,5,0,5
Shulanda,F,100,5,0,5
Shulonda,F,100,5,0,5
Shuntavia,F,100,5,0,5
Shureka,F,100,5,0,5
Shuronda,F,100,5,0,5
Shwana,F,100,5,0,5
Shye,F,100,5,0,5
Shyera,F,100,5,0,5
Shykeim,M,100,0,5,5
Shykia,F,100,5,0,5
Shylan,F,100,5,0,5
Shylei,F,100,5,0,5
Shylyn,F,100,5,0,5
Shyma,F,100,5,0,5
Shyneka,F,100,5,0,5
Shynese,F,100,5,0,5
Shyrah,F,100,5,0,5
Shyrene,F,100,5,0,5
Shytavia,F,100,5,0,5
Shyteria,F,100,5,0,5
Siaka,M,100,0,5,5
Siam,M,100,0,5,5
Siannah,F,100,5,0,5
Siany,F,100,5,0,5
Sibelle,F,100,5,0,5
Siboney,F,100,5,0,5
Sidahmed,M,100,0,5,5
Sidona,F,100,5,0,5
Sidora,F,100,5,0,5
Silberio,M,100,0,5,5
Silena,F,100,5,0,5
Silpa,F,100,5,0,5
Silvan,M,100,0,5,5
Simarpreet,F,100,5,0,5
Simba,M,100,0,5,5
Sime,M,100,0,5,5
Simia,F,100,5,0,5
Simion,M,100,0,5,5
Simitrio,M,100,0,5,5
Simms,M,100,0,5,5
Simranpreet,F,100,5,0,5
Simryn,F,100,5,0,5
Simyah,F,100,5,0,5
Sindie,F,100,5,0,5
Sing,F,100,5,0,5
Siryah,F,100,5,0,5
Sisi,F,100,5,0,5
Sisilia,F,100,5,0,5
Sissie,F,100,5,0,5
Siyam,F,100,5,0,5
Siyon,M,100,0,5,5
Sj,M,100,0,5,5
Ski,F,100,5,0,5
Skky,F,100,5,0,5
Skya,F,100,5,0,5
Skyah,F,100,5,0,5
Skyana,F,100,5,0,5
Skyela,F,100,5,0,5
Skyelee,F,100,5,0,5
Skylaar,F,100,5,0,5
Skylair,F,100,5,0,5
Skylia,F,100,5,0,5
Skyller,M,100,0,5,5
Skylr,F,100,5,0,5
Skyshun,M,100,0,5,5
Slevin,M,100,0,5,5
Smitha,F,100,5,0,5
Snayder,M,100,0,5,5
Snehal,M,100,0,5,5
So,F,100,5,0,5
Sochil,F,100,5,0,5
Soda,F,100,5,0,5
Sofee,F,100,5,0,5
Soffie,F,100,5,0,5
Sofiana,F,100,5,0,5
Sofiyah,F,100,5,0,5
Sohini,F,100,5,0,5
Solach,F,100,5,0,5
Solarah,F,100,5,0,5
Solaya,F,100,5,0,5
Solie,F,100,5,0,5
Solmari,F,100,5,0,5
Solmary,F,100,5,0,5
Solmon,M,100,0,5,5
Somaiya,F,100,5,0,5
Somaly,F,100,5,0,5
Somiah,F,100,5,0,5
Sommar,F,100,5,0,5
Somnang,M,100,0,5,5
Sondria,F,100,5,0,5
Songa,F,100,5,0,5
Sonie,F,100,5,0,5
Sonjay,M,100,0,5,5
Sonnya,F,100,5,0,5
Sonovia,F,100,5,0,5
Sonum,F,100,5,0,5
Soobin,F,100,5,0,5
Soojin,F,100,5,0,5
Soomin,F,100,5,0,5
Sophieann,F,100,5,0,5
Sophiyah,F,100,5,0,5
Sopia,F,100,5,0,5
Soran,M,100,0,5,5
Sorelle,F,100,5,0,5
Soroya,F,100,5,0,5
Sourya,M,100,0,5,5
Southern,F,100,5,0,5
Sovann,M,100,0,5,5
Soyini,F,100,5,0,5
Spiridon,M,100,0,5,5
Sravani,F,100,5,0,5
Sreeya,F,100,5,0,5
Sreyas,M,100,0,5,5
Srihaan,M,100,0,5,5
Sriharsha,M,100,0,5,5
Srihith,M,100,0,5,5
Srikrithi,F,100,5,0,5
Srithan,M,100,0,5,5
Sriyansh,M,100,0,5,5
Ssirley,F,100,5,0,5
Sstephanie,F,100,5,0,5
Staffon,M,100,0,5,5
Staney,M,100,0,5,5
Stann,M,100,0,5,5
Stanson,M,100,0,5,5
Starley,F,100,5,0,5
Starlisa,F,100,5,0,5
Starlita,F,100,5,0,5
Starrla,F,100,5,0,5
Starrlynn,F,100,5,0,5
Starshemah,F,100,5,0,5
Stas,M,100,0,5,5
Stathan,M,100,0,5,5
Statler,M,100,0,5,5
Staton,M,100,0,5,5
Stavon,M,100,0,5,5
Stavro,M,100,0,5,5
Steely,M,100,0,5,5
Stefannie,F,100,5,0,5
Steffin,M,100,0,5,5
Stehen,M,100,0,5,5
Steicy,F,100,5,0,5
Stepehn,M,100,0,5,5
Stephanic,F,100,5,0,5
Stephenson,M,100,0,5,5
Stephinie,F,100,5,0,5
Stetsen,M,100,0,5,5
Steva,F,100,5,0,5
Stevanie,F,100,5,0,5
Stevenmichael,M,100,0,5,5
Stevphen,M,100,0,5,5
Sthefany,F,100,5,0,5
Sthephanie,F,100,5,0,5
Stig,M,100,0,5,5
Stinson,M,100,0,5,5
Stokely,M,100,0,5,5
Stokes,M,100,0,5,5
Stonie,F,100,5,0,5
Stpehen,M,100,0,5,5
Stphen,M,100,0,5,5
Striker,M,100,0,5,5
Suada,F,100,5,0,5
Sucdi,F,100,5,0,5
Suchi,F,100,5,0,5
Sudeys,M,100,0,5,5
Sudha,F,100,5,0,5
Sueanna,F,100,5,0,5
Suelynn,F,100,5,0,5
Suen,M,100,0,5,5
Sugeily,F,100,5,0,5
Suhailey,F,100,5,0,5
Suhavi,F,100,5,0,5
Suheily,F,100,5,0,5
Sujeily,F,100,5,0,5
Sujin,F,100,5,0,5
Sujit,M,100,0,5,5
Sujood,F,100,5,0,5
Sulaf,F,100,5,0,5
Suli,F,100,5,0,5
Suma,F,100,5,0,5
Sumin,F,100,5,0,5
Sumire,F,100,5,0,5
Sumukh,M,100,0,5,5
Suna,F,100,5,0,5
Sundari,F,100,5,0,5
Sunie,F,100,5,0,5
Suniya,F,100,5,0,5
Surayah,F,100,5,0,5
Susane,F,100,5,0,5
Suset,F,100,5,0,5
Suyash,M,100,0,5,5
Suzonne,F,100,5,0,5
Suzzanna,F,100,5,0,5
Swan,M,100,0,5,5
Swanda,F,100,5,0,5
Sweet,F,100,5,0,5
Syah,F,100,5,0,5
Syasia,F,100,5,0,5
Sybastian,M,100,0,5,5
Sybrena,F,100,5,0,5
Sybrina,F,100,5,0,5
Sydeny,F,100,5,0,5
Syeeda,F,100,5,0,5
Syer,M,100,0,5,5
Syere,M,100,0,5,5
Syheem,M,100,0,5,5
Syid,M,100,0,5,5
Syion,M,100,0,5,5
Syl,M,100,0,5,5
Sylah,F,100,5,0,5
Sylee,F,100,5,0,5
Sylester,M,100,0,5,5
Sylinda,F,100,5,0,5
Sylviana,F,100,5,0,5
Sylvio,M,100,0,5,5
Sylwia,F,100,5,0,5
Symara,F,100,5,0,5
Symari,F,100,5,0,5
Syndia,F,100,5,0,5
Syndie,F,100,5,0,5
Synetta,F,100,5,0,5
Synneva,F,100,5,0,5
Synovia,F,100,5,0,5
Syntia,F,100,5,0,5
Syr,M,100,0,5,5
Syrae,F,100,5,0,5
Syrette,F,100,5,0,5
Syritta,F,100,5,0,5
Syvannah,F,100,5,0,5
Szofia,F,100,5,0,5
Taaliba,F,100,5,0,5
Taana,F,100,5,0,5
Taavon,M,100,0,5,5
Tabiatha,F,100,5,0,5
Tabish,M,100,0,5,5
Tabrea,F,100,5,0,5
Tace,M,100,0,5,5
Tacha,F,100,5,0,5
Tacia,F,100,5,0,5
Tacori,F,100,5,0,5
Tacory,M,100,0,5,5
Tadajah,F,100,5,0,5
Tadarious,M,100,0,5,5
Taeghan,F,100,5,0,5
Taelee,F,100,5,0,5
Taemon,M,100,0,5,5
Taeson,M,100,0,5,5
Taeven,M,100,0,5,5
Taeyang,M,100,0,5,5
Taeyon,M,100,0,5,5
Taffney,F,100,5,0,5
Tahina,F,100,5,0,5
Tahiya,F,100,5,0,5
Tahjir,M,100,0,5,5
Tahlaya,F,100,5,0,5
Tahnya,F,100,5,0,5
Tahreem,F,100,5,0,5
Tahriq,M,100,0,5,5
Taijha,F,100,5,0,5
Tailah,F,100,5,0,5
Tailar,F,100,5,0,5
Taisia,F,100,5,0,5
Taiton,M,100,0,5,5
Taizley,F,100,5,0,5
Tajahne,F,100,5,0,5
Tajay,F,100,5,0,5
Tajee,M,100,0,5,5
Tajhanae,F,100,5,0,5
Tajohn,M,100,0,5,5
Tajudeen,M,100,0,5,5
Tajveer,M,100,0,5,5
Taka,F,100,5,0,5
Takaia,F,100,5,0,5
Takaiya,F,100,5,0,5
Takaria,F,100,5,0,5
Takaylah,F,100,5,0,5
Takedra,F,100,5,0,5
Takeela,F,100,5,0,5
Takeira,F,100,5,0,5
Takemia,F,100,5,0,5
Takendra,F,100,5,0,5
Takerra,F,100,5,0,5
Taketa,F,100,5,0,5
Takhia,F,100,5,0,5
Takina,F,100,5,0,5
Takiyla,F,100,5,0,5
Talae,F,100,5,0,5
Talajah,F,100,5,0,5
Talat,M,100,0,5,5
Talayla,F,100,5,0,5
Talayna,F,100,5,0,5
Talayshia,F,100,5,0,5
Taleaha,F,100,5,0,5
Taleesha,F,100,5,0,5
Taler,F,100,5,0,5
Taley,F,100,5,0,5
Talhah,M,100,0,5,5
Talianna,F,100,5,0,5
Talie,F,100,5,0,5
Taliek,M,100,0,5,5
Talisia,F,100,5,0,5
Talore,F,100,5,0,5
Taly,F,100,5,0,5
Talyiah,F,100,5,0,5
Tamah,F,100,5,0,5
Tamanika,F,100,5,0,5
Tamarae,F,100,5,0,5
Tamarisk,F,100,5,0,5
Tamberlyn,F,100,5,0,5
Tambrey,F,100,5,0,5
Tamecca,F,100,5,0,5
Tameer,M,100,0,5,5
Tameira,F,100,5,0,5
Tamerah,F,100,5,0,5
Tamere,M,100,0,5,5
Tamichael,M,100,0,5,5
Tamicia,F,100,5,0,5
Tamikah,F,100,5,0,5
Taminka,F,100,5,0,5
Tamisa,F,100,5,0,5
Tammmy,F,100,5,0,5
Tamoni,F,100,5,0,5
Tanaeja,F,100,5,0,5
Tanaijah,F,100,5,0,5
Tanairi,F,100,5,0,5
Tanaiyah,F,100,5,0,5
Tanaka,F,100,5,0,5
Tanavia,F,100,5,0,5
Tanayjah,F,100,5,0,5
Taneal,F,100,5,0,5
Tanedra,F,100,5,0,5
Taneesh,M,100,0,5,5
Taneice,F,100,5,0,5
Tanell,F,100,5,0,5
Tanera,F,100,5,0,5
Taneria,F,100,5,0,5
Tanganika,F,100,5,0,5
Tanger,F,100,5,0,5
Tangier,F,100,5,0,5
Tangla,F,100,5,0,5
Tanijha,F,100,5,0,5
Tanin,M,100,0,5,5
Tanisa,F,100,5,0,5
Tanjala,F,100,5,0,5
Tannisha,F,100,5,0,5
Tannyr,M,100,0,5,5
Tano,M,100,0,5,5
Tanyetta,F,100,5,0,5
Tanzi,F,100,5,0,5
Tanzy,F,100,5,0,5
Tapan,M,100,0,5,5
Taqi,M,100,0,5,5
Taquira,F,100,5,0,5
Taquisa,F,100,5,0,5
Taquoia,F,100,5,0,5
Tarak,M,100,0,5,5
Taresha,F,100,5,0,5
Tarisa,F,100,5,0,5
Tarkan,M,100,0,5,5
Tarnesha,F,100,5,0,5
Tarolyn,F,100,5,0,5
Tarone,M,100,0,5,5
Tarrant,M,100,0,5,5
Tarrick,M,100,0,5,5
Tarrie,F,100,5,0,5
Taryiah,F,100,5,0,5
Taryll,M,100,0,5,5
Tashanique,F,100,5,0,5
Tasharra,F,100,5,0,5
Tashawnda,F,100,5,0,5
Tashe,F,100,5,0,5
Tasheeka,F,100,5,0,5
Tasheia,F,100,5,0,5
Tashell,F,100,5,0,5
Tashelle,F,100,5,0,5
Tashfia,F,100,5,0,5
Tashua,F,100,5,0,5
Tashun,M,100,0,5,5
Tasiah,F,100,5,0,5
Tasmin,F,100,5,0,5
Tatayanna,F,100,5,0,5
Tateana,F,100,5,0,5
Tateanna,F,100,5,0,5
Tatelyn,F,100,5,0,5
Tatsu,M,100,0,5,5
Taundra,F,100,5,0,5
Tauras,M,100,0,5,5
Tauri,F,100,5,0,5
Taurino,M,100,0,5,5
Tauris,M,100,0,5,5
Taurius,M,100,0,5,5
Tavanna,F,100,5,0,5
Tavante,M,100,0,5,5
Taveres,M,100,0,5,5
Tavette,F,100,5,0,5
Taviona,F,100,5,0,5
Tavione,M,100,0,5,5
Tavo,M,100,0,5,5
Tavona,F,100,5,0,5
Tavonn,M,100,0,5,5
Tavonne,M,100,0,5,5
Tavontae,M,100,0,5,5
Tawnni,F,100,5,0,5
Tawon,M,100,0,5,5
Tawsif,M,100,0,5,5
Tayce,M,100,0,5,5
Tayhlor,F,100,5,0,5
Tayiah,F,100,5,0,5
Taylani,F,100,5,0,5
Tayloranne,F,100,5,0,5
Taylre,F,100,5,0,5
Taymour,M,100,0,5,5
Tayshun,M,100,0,5,5
Taytiana,F,100,5,0,5
Tayviona,F,100,5,0,5
Tayvone,M,100,0,5,5
Tayyaba,F,100,5,0,5
Teagann,F,100,5,0,5
Teaja,F,100,5,0,5
Teaka,F,100,5,0,5
Teandrea,F,100,5,0,5
Tearria,F,100,5,0,5
Teasa,F,100,5,0,5
Teaunna,F,100,5,0,5
Tecla,F,100,5,0,5
Tecola,F,100,5,0,5
Tecora,F,100,5,0,5
Teghveer,M,100,0,5,5
Tehron,M,100,0,5,5
Teiah,F,100,5,0,5
Teianna,F,100,5,0,5
Teionna,F,100,5,0,5
Tejan,M,100,0,5,5
Tejaun,M,100,0,5,5
Tejuan,M,100,0,5,5
Tekara,F,100,5,0,5
Tekira,F,100,5,0,5
Tekiyah,F,100,5,0,5
Telah,F,100,5,0,5
Telana,F,100,5,0,5
Telford,M,100,0,5,5
Teman,M,100,0,5,5
Temani,M,100,0,5,5
Temera,F,100,5,0,5
Tempess,F,100,5,0,5
Tempsett,F,100,5,0,5
Tendria,F,100,5,0,5
Teneeka,F,100,5,0,5
Teneille,F,100,5,0,5
Teneya,F,100,5,0,5
Teniah,F,100,5,0,5
Tennasyn,F,100,5,0,5
Tennia,F,100,5,0,5
Tennis,M,100,0,5,5
Tenny,F,100,5,0,5
Teola,F,100,5,0,5
Teonte,M,100,0,5,5
Teoshia,F,100,5,0,5
Teralynn,F,100,5,0,5
Tereas,F,100,5,0,5
Tereca,F,100,5,0,5
Tereska,F,100,5,0,5
Teriona,F,100,5,0,5
Teriq,M,100,0,5,5
Terise,F,100,5,0,5
Ternisha,F,100,5,0,5
Teronica,F,100,5,0,5
Terrae,F,100,5,0,5
Terraine,M,100,0,5,5
Terrencia,F,100,5,0,5
Terresha,F,100,5,0,5
Terric,M,100,0,5,5
Terronda,F,100,5,0,5
Tesean,M,100,0,5,5
Tesheena,F,100,5,0,5
Tesheka,F,100,5,0,5
Teshon,M,100,0,5,5
Tesslyn,F,100,5,0,5
Tetra,F,100,5,0,5
Teysha,F,100,5,0,5
Thadeo,M,100,0,5,5
Thadis,M,100,0,5,5
Thaer,M,100,0,5,5
Thailen,M,100,0,5,5
Thamar,F,100,5,0,5
Thanos,M,100,0,5,5
Thavy,F,100,5,0,5
Theador,M,100,0,5,5
Thearsa,F,100,5,0,5
Thedora,F,100,5,0,5
Thelda,F,100,5,0,5
Thema,F,100,5,0,5
Theophilia,F,100,5,0,5
Theres,F,100,5,0,5
Theryn,M,100,0,5,5
Thirza,F,100,5,0,5
Thonda,F,100,5,0,5
Thorsen,M,100,0,5,5
Thuyvi,F,100,5,0,5
Tiaka,F,100,5,0,5
Tiania,F,100,5,0,5
Tiari,F,100,5,0,5
Tiarre,F,100,5,0,5
Tiawan,M,100,0,5,5
Ticara,F,100,5,0,5
Tieg,M,100,0,5,5
Tiege,M,100,0,5,5
Tiena,F,100,5,0,5
Tienna,F,100,5,0,5
Tierria,F,100,5,0,5
Tiersa,F,100,5,0,5
Tiese,F,100,5,0,5
Tiessa,F,100,5,0,5
Tifanee,F,100,5,0,5
Tiffiani,F,100,5,0,5
Tiffnie,F,100,5,0,5
Tifni,F,100,5,0,5
Tigerlilly,F,100,5,0,5
Tihara,F,100,5,0,5
Tihesha,F,100,5,0,5
Tiiu,F,100,5,0,5
Tijay,F,100,5,0,5
Tikvah,F,100,5,0,5
Tilak,M,100,0,5,5
Tilar,F,100,5,0,5
Tileah,F,100,5,0,5
Timarah,F,100,5,0,5
Timarcus,M,100,0,5,5
Timbra,F,100,5,0,5
Timeko,F,100,5,0,5
Timiah,F,100,5,0,5
Timiothy,M,100,0,5,5
Timmi,F,100,5,0,5
Timmiah,F,100,5,0,5
Timote,M,100,0,5,5
Timothyjames,M,100,0,5,5
Timouthy,M,100,0,5,5
Timthy,M,100,0,5,5
Timyia,F,100,5,0,5
Tinette,F,100,5,0,5
Tiney,F,100,5,0,5
Tinka,F,100,5,0,5
Tinnley,F,100,5,0,5
Tionee,F,100,5,0,5
Tirelle,M,100,0,5,5
Tishanna,F,100,5,0,5
Tishon,M,100,0,5,5
Tisya,F,100,5,0,5
Titana,F,100,5,0,5
Titanna,F,100,5,0,5
Tityanna,F,100,5,0,5
Tivis,M,100,0,5,5
Tiyanah,F,100,5,0,5
Tkeya,F,100,5,0,5
Tkiyah,F,100,5,0,5
Tobyas,M,100,0,5,5
Tobye,F,100,5,0,5
Tocara,F,100,5,0,5
Toderick,M,100,0,5,5
Toia,F,100,5,0,5
Toinetta,F,100,5,0,5
Tolliver,M,100,0,5,5
Tolonda,F,100,5,0,5
Tomikia,F,100,5,0,5
Tommylee,M,100,0,5,5
Tomoka,F,100,5,0,5
Ton,M,100,0,5,5
Toniah,F,100,5,0,5
Tonija,F,100,5,0,5
Tonise,F,100,5,0,5
Tonoa,F,100,5,0,5
Tonua,F,100,5,0,5
Toprak,M,100,0,5,5
Torien,M,100,0,5,5
Torilyn,F,100,5,0,5
Torra,F,100,5,0,5
Torrez,M,100,0,5,5
Torria,F,100,5,0,5
Torriyah,F,100,5,0,5
Toschia,F,100,5,0,5
Toshiro,M,100,0,5,5
Totianna,F,100,5,0,5
Touger,M,100,0,5,5
Toyya,F,100,5,0,5
Tracei,F,100,5,0,5
Tracianne,F,100,5,0,5
Tracilyn,F,100,5,0,5
Tracylynn,F,100,5,0,5
Traelon,M,100,0,5,5
Traevyn,M,100,0,5,5
Tragen,M,100,0,5,5
Traiden,M,100,0,5,5
Trail,M,100,0,5,5
Tralaina,F,100,5,0,5
Tralon,M,100,0,5,5
Tramiya,F,100,5,0,5
Tramiyah,F,100,5,0,5
Tranard,M,100,0,5,5
Trandon,M,100,0,5,5
Tranecia,F,100,5,0,5
Traneisha,F,100,5,0,5
Traniece,F,100,5,0,5
Trapp,M,100,0,5,5
Trauis,M,100,0,5,5
Travante,M,100,0,5,5
Travanti,M,100,0,5,5
Traveion,M,100,0,5,5
Travien,M,100,0,5,5
Travina,F,100,5,0,5
Traviona,F,100,5,0,5
Travonda,F,100,5,0,5
Travonn,M,100,0,5,5
Travonta,M,100,0,5,5
Travus,M,100,0,5,5
Travyn,M,100,0,5,5
Traylan,M,100,0,5,5
Trayquan,M,100,0,5,5
Trcy,F,100,5,0,5
Treanthony,M,100,0,5,5
Treasea,F,100,5,0,5
Treat,M,100,0,5,5
Treaver,M,100,0,5,5
Treavion,M,100,0,5,5
Treba,F,100,5,0,5
Treble,M,100,0,5,5
Treca,F,100,5,0,5
Trechelle,F,100,5,0,5
Tredan,M,100,0,5,5
Tredyn,M,100,0,5,5
Tregan,M,100,0,5,5
Trelin,M,100,0,5,5
Tremane,M,100,0,5,5
Tremia,F,100,5,0,5
Tremiyah,F,100,5,0,5
Tremya,F,100,5,0,5
Trenace,F,100,5,0,5
Trenard,M,100,0,5,5
Trence,M,100,0,5,5
Trendan,M,100,0,5,5
Trendell,M,100,0,5,5
Trene,F,100,5,0,5
Treneka,F,100,5,0,5
Trenese,F,100,5,0,5
Trenicia,F,100,5,0,5
Trenidy,F,100,5,0,5
Treniti,F,100,5,0,5
Treniyah,F,100,5,0,5
Trennis,M,100,0,5,5
Tresaun,M,100,0,5,5
Tresca,F,100,5,0,5
Tresor,M,100,0,5,5
Tress,F,100,5,0,5
Trestyn,M,100,0,5,5
Trevares,M,100,0,5,5
Trevier,M,100,0,5,5
Trevious,M,100,0,5,5
Trevona,F,100,5,0,5
Trevyon,M,100,0,5,5
Treya,F,100,5,0,5
Treygan,M,100,0,5,5
Treymaine,M,100,0,5,5
Treymane,M,100,0,5,5
Treymon,M,100,0,5,5
Treyquan,M,100,0,5,5
Treyvonn,M,100,0,5,5
Treyvonne,M,100,0,5,5
Trichia,F,100,5,0,5
Trillion,M,100,0,5,5
Trinae,F,100,5,0,5
Trinden,M,100,0,5,5
Trinell,M,100,0,5,5
Trinere,F,100,5,0,5
Trinety,F,100,5,0,5
Trinka,F,100,5,0,5
Trinyti,F,100,5,0,5
Trisden,M,100,0,5,5
Trishan,M,100,0,5,5
Trison,M,100,0,5,5
Tristanjames,M,100,0,5,5
Tristi,F,100,5,0,5
Tristun,M,100,0,5,5
Trivia,F,100,5,0,5
Trovon,M,100,0,5,5
Truddie,F,100,5,0,5
Truely,F,100,5,0,5
Trustyn,M,100,0,5,5
Tryan,M,100,0,5,5
Trynt,M,100,0,5,5
Trynton,M,100,0,5,5
Tsubaki,F,100,5,0,5
Tsunade,F,100,5,0,5
Tuba,F,100,5,0,5
Tuesdae,F,100,5,0,5
Tuesdai,F,100,5,0,5
Tuf,M,100,0,5,5
Tulah,F,100,5,0,5
Tulsa,F,100,5,0,5
Tumeka,F,100,5,0,5
Tupac,M,100,0,5,5
Turina,F,100,5,0,5
Tuscany,F,100,5,0,5
Tusha,F,100,5,0,5
Tuson,M,100,0,5,5
Twania,F,100,5,0,5
Twayne,M,100,0,5,5
Twilia,F,100,5,0,5
Twon,M,100,0,5,5
Tyaisa,F,100,5,0,5
Tyaisha,F,100,5,0,5
Tyarra,F,100,5,0,5
Tyasha,F,100,5,0,5
Tybee,F,100,5,0,5
Tyberious,M,100,0,5,5
Tybria,F,100,5,0,5
Tycere,M,100,0,5,5
Tycie,F,100,5,0,5
Tydarian,M,100,0,5,5
Tydarious,M,100,0,5,5
Tyease,F,100,5,0,5
Tyheshia,F,100,5,0,5
Tyjanea,F,100,5,0,5
Tyka,F,100,5,0,5
Tykeya,F,100,5,0,5
Tyki,M,100,0,5,5
Tykwon,M,100,0,5,5
Tylajah,F,100,5,0,5
Tylaya,F,100,5,0,5
Tylayah,F,100,5,0,5
Tylaysia,F,100,5,0,5
Tylecia,F,100,5,0,5
Tyleik,M,100,0,5,5
Tyleisha,F,100,5,0,5
Tylena,F,100,5,0,5
Tylere,M,100,0,5,5
Tyli,F,100,5,0,5
Tymara,F,100,5,0,5
Tymeek,M,100,0,5,5
Tymiere,M,100,0,5,5
Tynaisha,F,100,5,0,5
Tynajah,F,100,5,0,5
Tyndall,F,100,5,0,5
Tyneice,F,100,5,0,5
Tynieka,F,100,5,0,5
Tynija,F,100,5,0,5
Tynita,F,100,5,0,5
Tynlie,F,100,5,0,5
Tyone,M,100,0,5,5
Tyquell,M,100,0,5,5
Tyquesha,F,100,5,0,5
Tyrane,M,100,0,5,5
Tyraya,F,100,5,0,5
Tyriece,M,100,0,5,5
Tyrielle,F,100,5,0,5
Tyryn,M,100,0,5,5
Tysheana,F,100,5,0,5
Tysheema,F,100,5,0,5
Tysheena,F,100,5,0,5
Tyshelle,F,100,5,0,5
Tyshone,M,100,0,5,5
Tyshonna,F,100,5,0,5
Tyski,M,100,0,5,5
Tyteana,F,100,5,0,5
Tyteona,F,100,5,0,5
Tyvone,M,100,0,5,5
Tywin,M,100,0,5,5
Tyyana,F,100,5,0,5
Tyyon,M,100,0,5,5
Tyyonna,F,100,5,0,5
Tyzir,M,100,0,5,5
Tzippora,F,100,5,0,5
Tzivy,F,100,5,0,5
Uhuru,M,100,0,5,5
Ulice,M,100,0,5,5
Ulla,F,100,5,0,5
Ulus,M,100,0,5,5
Umari,M,100,0,5,5
Umaya,F,100,5,0,5
Ume,F,100,5,0,5
Umut,M,100,0,5,5
Upton,M,100,0,5,5
Ura,M,100,0,5,5
Urenna,F,100,5,0,5
Urica,F,100,5,0,5
Urja,F,100,5,0,5
Urmi,F,100,5,0,5
Uryah,M,100,0,5,5
Usamah,M,100,0,5,5
Ushna,F,100,5,0,5
Utopia,F,100,5,0,5
Uzay,M,100,0,5,5
Uzayr,M,100,0,5,5
Va,M,100,0,5,5
Vaanya,F,100,5,0,5
Vachan,M,100,0,5,5
Vaibhavi,F,100,5,0,5
Vaimoana,F,100,5,0,5
Vainavi,F,100,5,0,5
Vaishvi,F,100,5,0,5
Vakesha,F,100,5,0,5
Valaysia,F,100,5,0,5
Valdene,F,100,5,0,5
Valdo,M,100,0,5,5
Valeka,F,100,5,0,5
Valentyna,F,100,5,0,5
Valere,F,100,5,0,5
Valetina,F,100,5,0,5
Valia,F,100,5,0,5
Valina,F,100,5,0,5
Valleri,F,100,5,0,5
Vallon,M,100,0,5,5
Vamika,F,100,5,0,5
Vanderbilt,M,100,0,5,5
Vandi,F,100,5,0,5
Vandon,M,100,0,5,5
Vane,M,100,0,5,5
Vanesia,F,100,5,0,5
Vanessamarie,F,100,5,0,5
Vannary,F,100,5,0,5
Vantasia,F,100,5,0,5
Vantrice,F,100,5,0,5
Vanyah,F,100,5,0,5
Varda,F,100,5,0,5
Vardan,M,100,0,5,5
Vareck,M,100,0,5,5
Varenya,F,100,5,0,5
Varna,F,100,5,0,5
Varshika,F,100,5,0,5
Vasily,M,100,0,5,5
Vasken,M,100,0,5,5
Vasudev,M,100,0,5,5
Vasudha,F,100,5,0,5
Vaune,F,100,5,0,5
Vayah,F,100,5,0,5
Veasna,M,100,0,5,5
Vedhika,F,100,5,0,5
Vedia,F,100,5,0,5
Veeta,F,100,5,0,5
Velena,F,100,5,0,5
Velika,F,100,5,0,5
Velissa,F,100,5,0,5
Velouria,F,100,5,0,5
Vence,M,100,0,5,5
Veneda,F,100,5,0,5
Venessia,F,100,5,0,5
Venora,F,100,5,0,5
Veralyn,F,100,5,0,5
Verdel,M,100,0,5,5
Verdina,F,100,5,0,5
Vereen,F,100,5,0,5
Verenda,F,100,5,0,5
Verenize,F,100,5,0,5
Verginia,F,100,5,0,5
Verina,F,100,5,0,5
Verinica,F,100,5,0,5
Verlina,F,100,5,0,5
Vernadette,F,100,5,0,5
Vernae,F,100,5,0,5
Vernay,F,100,5,0,5
Verneita,F,100,5,0,5
Vernelda,F,100,5,0,5
Vernest,M,100,0,5,5
Verneta,F,100,5,0,5
Verniya,F,100,5,0,5
Vernona,F,100,5,0,5
Versavia,F,100,5,0,5
Vertell,F,100,5,0,5
Vetra,F,100,5,0,5
Vevelyn,F,100,5,0,5
Veyah,F,100,5,0,5
Veyron,M,100,0,5,5
Viance,F,100,5,0,5
Vianet,F,100,5,0,5
Viany,F,100,5,0,5
Vicie,F,100,5,0,5
Vickilynn,F,100,5,0,5
Vicktor,M,100,0,5,5
Victorianna,F,100,5,0,5
Victorria,F,100,5,0,5
Viena,F,100,5,0,5
Vigo,M,100,0,5,5
Vihaas,M,100,0,5,5
Vikkie,F,100,5,0,5
Viky,F,100,5,0,5
Vilinda,F,100,5,0,5
Vimal,M,100,0,5,5
Vincentia,F,100,5,0,5
Vincint,M,100,0,5,5
Vinie,F,100,5,0,5
Vinn,M,100,0,5,5
Violeth,F,100,5,0,5
Violetrose,F,100,5,0,5
Viona,F,100,5,0,5
Virgin,F,100,5,0,5
Viriginia,F,100,5,0,5
Virlinda,F,100,5,0,5
Visente,M,100,0,5,5
Vision,F,100,5,0,5
Vitina,F,100,5,0,5
Viv,F,100,5,0,5
Viviette,F,100,5,0,5
Vlora,F,100,5,0,5
Vola,F,100,5,0,5
Voltaire,M,100,0,5,5
Vondalee,F,100,5,0,5
Vondra,F,100,5,0,5
Vonshae,F,100,5,0,5
Vontae,M,100,0,5,5
Vyacheslav,M,100,0,5,5
Vyktoria,F,100,5,0,5
Vylette,F,100,5,0,5
Wailyn,M,100,0,5,5
Wajd,F,100,5,0,5
Wakana,F,100,5,0,5
Wakeisha,F,100,5,0,5
Waker,M,100,0,5,5
Walberto,M,100,0,5,5
Waldy,M,100,0,5,5
Walia,F,100,5,0,5
Walida,F,100,5,0,5
Walik,M,100,0,5,5
Walkiria,F,100,5,0,5
Wan,M,100,0,5,5
Wandalee,F,100,5,0,5
Wauneta,F,100,5,0,5
Waynard,M,100,0,5,5
Wellsley,F,100,5,0,5
Wendle,M,100,0,5,5
Wendlyn,F,100,5,0,5
Wendoly,F,100,5,0,5
Wendyann,F,100,5,0,5
Wengel,F,100,5,0,5
Wenndy,F,100,5,0,5
Wenson,M,100,0,5,5
Whitli,F,100,5,0,5
Wildan,M,100,0,5,5
Wilde,M,100,0,5,5
Wilfried,M,100,0,5,5
Wilhelminia,F,100,5,0,5
Wilkinson,M,100,0,5,5
Willison,M,100,0,5,5
Willistine,F,100,5,0,5
Wilnette,F,100,5,0,5
Wimberley,F,100,5,0,5
Windham,M,100,0,5,5
Winfried,M,100,0,5,5
Winnona,F,100,5,0,5
Wintana,F,100,5,0,5
Winterrose,F,100,5,0,5
Wisin,M,100,0,5,5
Wittney,F,100,5,0,5
Wizdom,M,100,0,5,5
Wolfram,M,100,0,5,5
Woodford,M,100,0,5,5
Woodroe,M,100,0,5,5
Wraith,M,100,0,5,5
Wriley,M,100,0,5,5
Wydell,M,100,0,5,5
Wykeisha,F,100,5,0,5
Wykesha,F,100,5,0,5
Wykeshia,F,100,5,0,5
Wylde,M,100,0,5,5
Wyleigh,F,100,5,0,5
Wyline,F,100,5,0,5
Wynnston,M,100,0,5,5
Wyonna,F,100,5,0,5
Wysteria,F,100,5,0,5
Wyvonna,F,100,5,0,5
Wyvonne,F,100,5,0,5
Xabian,M,100,0,5,5
Xaeden,M,100,0,5,5
Xandrea,F,100,5,0,5
Xaniel,M,100,0,5,5
Xareny,F,100,5,0,5
Xaveon,M,100,0,5,5
Xaver,M,100,0,5,5
Xaylie,F,100,5,0,5
Xazier,M,100,0,5,5
Xea,F,100,5,0,5
Xeniyah,F,100,5,0,5
Xiang,M,100,0,5,5
Xiclali,F,100,5,0,5
Xinrui,F,100,5,0,5
Xinyan,F,100,5,0,5
Xiomari,F,100,5,0,5
Xiomary,F,100,5,0,5
Xochi,F,100,5,0,5
Xyliana,F,100,5,0,5
Xzadrian,M,100,0,5,5
Xzaiden,M,100,0,5,5
Yabdiel,M,100,0,5,5
Yabsera,F,100,5,0,5
Yacqueline,F,100,5,0,5
Yadhir,M,100,0,5,5
Yaelle,F,100,5,0,5
Yaely,F,100,5,0,5
Yaheli,F,100,5,0,5
Yahna,F,100,5,0,5
Yaidel,M,100,0,5,5
Yailet,F,100,5,0,5
Yaire,F,100,5,0,5
Yakeisha,F,100,5,0,5
Yakelyn,F,100,5,0,5
Yakob,M,100,0,5,5
Yalani,F,100,5,0,5
Yalda,F,100,5,0,5
Yaleska,F,100,5,0,5
Yalexi,F,100,5,0,5
Yalisa,F,100,5,0,5
Yami,F,100,5,0,5
Yamika,F,100,5,0,5
Yamiley,F,100,5,0,5
Yanae,F,100,5,0,5
Yanai,F,100,5,0,5
Yanali,F,100,5,0,5
Yaned,F,100,5,0,5
Yaneira,F,100,5,0,5
Yaneiry,F,100,5,0,5
Yanichel,F,100,5,0,5
Yanise,F,100,5,0,5
Yaniya,F,100,5,0,5
Yarell,M,100,0,5,5
Yaretsy,F,100,5,0,5
Yaretzie,F,100,5,0,5
Yariela,F,100,5,0,5
Yarisbeth,F,100,5,0,5
Yarismar,F,100,5,0,5
Yarissa,F,100,5,0,5
Yariza,F,100,5,0,5
Yaroslava,F,100,5,0,5
Yaschia,F,100,5,0,5
Yaselin,F,100,5,0,5
Yashwant,M,100,0,5,5
Yasmaine,F,100,5,0,5
Yasmany,M,100,0,5,5
Yasmim,F,100,5,0,5
Yasniel,M,100,0,5,5
Yasuri,F,100,5,0,5
Yazayra,F,100,5,0,5
Yazlee,F,100,5,0,5
Yazlen,F,100,5,0,5
Yazline,F,100,5,0,5
Yazmen,F,100,5,0,5
Yazmina,F,100,5,0,5
Yazziel,M,100,0,5,5
Yeabsera,F,100,5,0,5
Yeidan,M,100,0,5,5
Yejide,F,100,5,0,5
Yelaina,F,100,5,0,5
Yelonda,F,100,5,0,5
Yenis,F,100,5,0,5
Yeremiah,M,100,0,5,5
Yerin,F,100,5,0,5
Yescenia,F,100,5,0,5
Yesh,M,100,0,5,5
Yeshayahu,M,100,0,5,5
Yesika,F,100,5,0,5
Yewande,F,100,5,0,5
Yexiel,M,100,0,5,5
Yiming,M,100,0,5,5
Yinon,M,100,0,5,5
Yiorgos,M,100,0,5,5
Yira,F,100,5,0,5
Yiru,F,100,5,0,5
Yisselle,F,100,5,0,5
Yitel,F,100,5,0,5
Yixin,F,100,5,0,5
Yleana,F,100,5,0,5
Ymari,F,100,5,0,5
Ymelda,F,100,5,0,5
Yogesh,M,100,0,5,5
Yohanes,M,100,0,5,5
Yojana,F,100,5,0,5
Yola,F,100,5,0,5
Yolimar,F,100,5,0,5
Yoon,M,100,0,5,5
Yorman,M,100,0,5,5
Yosel,M,100,0,5,5
Yoshiki,M,100,0,5,5
Yosilin,F,100,5,0,5
Yosmairy,F,100,5,0,5
Yosseline,F,100,5,0,5
Yost,M,100,0,5,5
Yosvany,M,100,0,5,5
Youki,M,100,0,5,5
Youstina,F,100,5,0,5
Yovanka,F,100,5,0,5
Ysa,F,100,5,0,5
Yudit,F,100,5,0,5
Yufei,F,100,5,0,5
Yuhan,F,100,5,0,5
Yuisa,F,100,5,0,5
Yukti,F,100,5,0,5
Yule,M,100,0,5,5
Yuleidy,F,100,5,0,5
Yuleiky,F,100,5,0,5
Yulemi,F,100,5,0,5
Yuliya,F,100,5,0,5
Yumalai,F,100,5,0,5
Yunalesca,F,100,5,0,5
Yuneicy,F,100,5,0,5
Yunier,M,100,0,5,5
Yunxi,F,100,5,0,5
Yura,F,100,5,0,5
Yureimy,F,100,5,0,5
Yurika,F,100,5,0,5
Yuriria,F,100,5,0,5
Yushin,M,100,0,5,5
Yuven,M,100,0,5,5
Yuya,M,100,0,5,5
Yuyang,M,100,0,5,5
Yva,F,100,5,0,5
Yvonnda,F,100,5,0,5
Yvonnia,F,100,5,0,5
Zaaliyah,F,100,5,0,5
Zaaron,M,100,0,5,5
Zabria,F,100,5,0,5
Zabrien,M,100,0,5,5
Zacai,M,100,0,5,5
Zacarius,M,100,0,5,5
Zaccaria,M,100,0,5,5
Zacery,M,100,0,5,5
Zachaery,M,100,0,5,5
Zachariyah,M,100,0,5,5
Zackeri,M,100,0,5,5
Zackerie,M,100,0,5,5
Zackorie,M,100,0,5,5
Zacori,M,100,0,5,5
Zadian,M,100,0,5,5
Zadiel,M,100,0,5,5
Zadon,M,100,0,5,5
Zadquiel,M,100,0,5,5
Zaelah,F,100,5,0,5
Zaeya,F,100,5,0,5
Zafina,F,100,5,0,5
Zafira,F,100,5,0,5
Zaheem,M,100,0,5,5
Zaher,M,100,0,5,5
Zahida,F,100,5,0,5
Zahiya,F,100,5,0,5
Zahkeem,M,100,0,5,5
Zahran,M,100,0,5,5
Zahro,F,100,5,0,5
Zaidah,F,100,5,0,5
Zaier,M,100,0,5,5
Zaimar,M,100,0,5,5
Zainub,F,100,5,0,5
Zaiyan,M,100,0,5,5
Zaiyden,M,100,0,5,5
Zakar,M,100,0,5,5
Zakaryah,M,100,0,5,5
Zakayden,M,100,0,5,5
Zakeem,M,100,0,5,5
Zakerria,F,100,5,0,5
Zakkai,M,100,0,5,5
Zakoria,F,100,5,0,5
Zakri,M,100,0,5,5
Zakyiah,F,100,5,0,5
Zakylah,F,100,5,0,5
Zamair,M,100,0,5,5
Zamanta,F,100,5,0,5
Zamareon,M,100,0,5,5
Zamarria,F,100,5,0,5
Zamayra,F,100,5,0,5
Zamon,M,100,0,5,5
Zanaii,F,100,5,0,5
Zanari,F,100,5,0,5
Zandel,M,100,0,5,5
Zaneria,F,100,5,0,5
Zanovia,F,100,5,0,5
Zanquisha,F,100,5,0,5
Zarahy,F,100,5,0,5
Zaraiah,F,100,5,0,5
Zarelia,F,100,5,0,5
Zariona,F,100,5,0,5
Zarreah,F,100,5,0,5
Zaveah,F,100,5,0,5
Zaviyon,M,100,0,5,5
Zayanah,F,100,5,0,5
Zayannah,F,100,5,0,5
Zaybree,F,100,5,0,5
Zaybrien,M,100,0,5,5
Zaydah,F,100,5,0,5
Zaydren,M,100,0,5,5
Zayid,M,100,0,5,5
Zaymere,M,100,0,5,5
Zaysean,M,100,0,5,5
Zaysha,F,100,5,0,5
Zayuri,F,100,5,0,5
Zazil,F,100,5,0,5
Zealan,M,100,0,5,5
Zecharia,M,100,0,5,5
Zedan,M,100,0,5,5
Zedek,M,100,0,5,5
Zeenah,F,100,5,0,5
Zeev,M,100,0,5,5
Zefram,M,100,0,5,5
Zeid,M,100,0,5,5
Zeidan,M,100,0,5,5
Zeila,F,100,5,0,5
Zeilah,F,100,5,0,5
Zeily,F,100,5,0,5
Zekariah,M,100,0,5,5
Zekeriah,M,100,0,5,5
Zellah,F,100,5,0,5
Zelpha,F,100,5,0,5
Zemar,M,100,0,5,5
Zenai,F,100,5,0,5
Zenayda,F,100,5,0,5
Zendaiya,F,100,5,0,5
Zendiya,F,100,5,0,5
Zeni,F,100,5,0,5
Zephen,M,100,0,5,5
Zeplynn,F,100,5,0,5
Zer,F,100,5,0,5
Zerriah,F,100,5,0,5
Zevaeh,F,100,5,0,5
Zeyah,F,100,5,0,5
Zeylah,F,100,5,0,5
Zhalen,M,100,0,5,5
Zharya,F,100,5,0,5
Zhia,F,100,5,0,5
Zhivago,M,100,0,5,5
Zhyier,M,100,0,5,5
Ziar,M,100,0,5,5
Zichen,M,100,0,5,5
Ziclaly,F,100,5,0,5
Ziden,M,100,0,5,5
Ziena,F,100,5,0,5
Zihanna,F,100,5,0,5
Ziion,M,100,0,5,5
Zijun,M,100,0,5,5
Zikiria,F,100,5,0,5
Zila,F,100,5,0,5
Zilas,M,100,0,5,5
Zildjian,M,100,0,5,5
Zilynn,F,100,5,0,5
Zimere,M,100,0,5,5
Zinaya,F,100,5,0,5
Ziniya,F,100,5,0,5
Zinn,M,100,0,5,5
Ziporah,F,100,5,0,5
Zirui,M,100,0,5,5
Zishan,M,100,0,5,5
Ziven,M,100,0,5,5
Zivon,M,100,0,5,5
Ziyang,M,100,0,5,5
Zmari,M,100,0,5,5
Zmarion,M,100,0,5,5
Zmiyah,F,100,5,0,5
Znyah,F,100,5,0,5
Zobeida,F,100,5,0,5
Zobia,F,100,5,0,5
Zoelie,F,100,5,0,5
Zoely,F,100,5,0,5
Zoemarie,F,100,5,0,5
Zoeymarie,F,100,5,0,5
Zoilo,M,100,0,5,5
Zoja,F,100,5,0,5
Zon,M,100,0,5,5
Zonda,F,100,5,0,5
Zoree,F,100,5,0,5
Zoren,M,100,0,5,5
Zorianna,F,100,5,0,5
Zoribel,F,100,5,0,5
Zorriah,F,100,5,0,5
Zorya,F,100,5,0,5
Zoryana,F,100,5,0,5
Zsa,F,100,5,0,5
Zubaida,F,100,5,0,5
Zuhaib,M,100,0,5,5
Zuhra,F,100,5,0,5
Zuleymi,F,100,5,0,5
Zuli,F,100,5,0,5
Zuriyah,F,100,5,0,5
Zyauna,F,100,5,0,5
Zyda,F,100,5,0,5
Zyeir,M,100,0,5,5
Zyeire,M,100,0,5,5
Zyel,M,100,0,5,5
Zyelle,F,100,5,0,5
Zyera,F,100,5,0,5
Zyiana,F,100,5,0,5
Zyiona,F,100,5,0,5
Zyira,F,100,5,0,5
Zykeia,F,100,5,0,5
Zykerion,M,100,0,5,5
Zykiera,F,100,5,0,5
Zylia,F,100,5,0,5
Zymaire,M,100,0,5,5
Zyniya,F,100,5,0,5
Zyonne,M,100,0,5,5
Zyquarius,M,100,0,5,5
Zyriana,F,100,5,0,5
Zyrin,M,100,0,5,5
Zzyzx,M,100,0,5,5
